hendiadys : n, 중언법, 두 말 한 뜻(보기: death and honor=honorable)

incog : INCOGNITO:a, ad, n, 

incognita : INCOGNITO의 여성형:a, ad, 

incrassate : (약)증발등으로)액체를 농축하다(직, 동)비후한:vt, a, 

incrimination : n, 죄를 씌움:유죄를 증명하는 것

incroach : ENCROACH:vi, 

incuriosity : 호기심이 없음, 무관심:n, 

incurvate : (안으로)굽히다, 만곡시키다, 만곡된, 안으로 굽은:vt, a, 

individual medley : 개인 메들리:, 

indulge : (욕망, 환락 등에)빠지다, 탐닉하다, 마음대로 하게하다, (아이를)버릇없이 가르다(spoil), 기쁘게(즐겁게)하다, (상)지불유예를 주다, (천주교)대사를 베풀다, (욕망, 환락에)빠지다, 탐닉하다, 마음대로 하다, (구)술을 많이 마시다:vi, vt, 

infill : (비어있는 장소를 )메우다, 막다, 채우다, INFILLING:vt, n, 

ingenerate : (고)자생의, 자존의, 발생시키다, 타고난, 생득의(innate):a, vt, 

inhouse : 조직내의(에서)사내의(에서):a, ad, 

injury benefit : (영)산재 보험금(나라가 매주 지불):, 

in re : ..의 소건으로, 에 관하여:prep, 

inshallah : (이슬람교)알라신이 허락하신다면:int, 

inshore : 해안에 가까운(가까이), (연해(근해)의):a, ad, 

instantly : 즉시로, 즉석에서, ..하자마자:ad, conj, 

interchange : 서로 교환하다, 주고받다, 바꾸다, 서로바꾸어 놓다, 교대시키다, 번갈아 일어나게 하다, 교환, 교역, 교체(고속도로의)입체교차점, 철도의 바꿔타는 역:vt, n, 

intercross : (선등을)서로 엇갈리게하다, 서로 교차시키다, 이종 교배시키다, 잡종을 만들다(interbreed), 서로교차하다, 이종교배하다, 이종교배, 잡종:vt, vi, n, 

interdate : (미)종교(종파)가 다른 사람과 데이트하다:vi, 

interdigitate : 깍지끼다, 서로 맞물(리게 하)다, 서로 얽히(게하)다:vi, vt, 

interlope : (남의 일에)참견하다, 주제 넘게 나서다, 허가없이 영업하다:vi, 

interosculate : 서로섞이다(침투하다), (혈관등이)접합(연결하다), (이종생물간에)공통성을 가지다:vi, 

interplead : (법)경합권리 확인 수속을 밟다:vi, 

interstratify : 지층과 지층사이에 개재하다(시키다):vi, vt, 

interwork : 섞어 짜다, 짜넣다, 서로작용하다:v, vi, vt, 

introspect : 내성하다:vi, 

invaginate : 칼집(모양의것)에 넣다(sheathe), (발생, 의)(관, 기관등의 일부를)함입(중적)시키다, (칼집, 관등에)들어가다, 함입하다, 함입한 칼집(등)에 넣은:vt, vi, a, 

invalid : 병약한, 허약한, 환자용의, 병자, 병약자, 병약하게 하다, 병약자로서 면제(송환)하다, 상이 군인 명부에 기입하다, 병약하게 되다, 병약자 취급을 받다:a, vt, vi, 

irregardless : REGARDLESS:a, ad, 

irrupt : 돌입(침입, 난입)하다, (군중등이)분노를 폭발시키다, (개체수가)급격히 증가하다:vi, 

N.Z., N.Zeak : new zeland:x, 

narrowcast : 유선방송하다, 한정된 지역에 방송하다:vt, 

narrow gate : x, (성)좁은 문(마태 복음 7:13-14)

naysay : 거절하다, 부인하다:n, vt, 

Negrillo : 네그릴로(아프리카의 키작은 흑인):n, 

negro ant : 검은개미:x, 

Nimrod : n, 대수렵기(창세기 10:8-9)수렵애호가, 수렵광

nineball : 나인볼:n, 

nondffective : 효과없는, 전투력이 없는, 전투력이 없는 군인:a, n, 

normalize : 표준화하다(국교등을)정상화하다, (표기를)일정한 절차법으로 통일한, 표준화(정상화)되다:vt, vi, 

Norse : (고대)노르웨이 사람, 노르웨이 말, 북구의, 노르웨이(사람, 말)의:n, a, 

notarially : 공증인에 의하여:ad, 

nuclease : (생화)뉴클레아제 (핵산에 작용하는 효소):n, 

Nunc Dimittis : n, 시므온의 노래(누가복음2:29-32), 고별(departure), 별세

nutsandbolts : 실제적인, 기본적인, 세밀한(검사등):a, 

machine vision : x, 기계가 물체를 시각적으로 인식하는 일: a ~ company 유시각 산업 로봇 메이커

macron : n, 모음위의 장음부(보기: came, be)

Magi : n, 동방 박사(마태복음 2:1), 마기 승족, (고대 페르시아의)마술사

mammon : n, (악덕으로서의) 부, 배금(마태복음 6:24)

Abba : n, 아버지(기도에서의 하나님, 마가 XIV:36)

ablaut : n, 모음전환(gradation)(보기:sing-sang-sung)

angstrom(unit) : n, 옹스트롬(파장단위:1cm의1억분의 1)

antonomasia : n, 환칭(보기:a Danie=a wise judge)

apologue : n, 교훈담우화(보기: Aesop's Fables)

assonance : a, 유음, 협음, 모운(모음만의 압운:make-race 따위)

waistdown : a, 하반신의:her ~ paralysis 그녀의 하반신 마비

wakeup : n, 형기의 마지막날;(오스)조심스런(현명한)사람:be a ~ to...에 조심하고 있다

warfighting : n, 전쟁, 교전 상태, 전쟁 행위, 전투;~핵(게릴라)전, 투쟁, 싸움: class ~ 계급 투쟁/economic ~ 경제 전쟁

warmly : ad, 따뜻하게: ~clothed 따뜻하게 옷을 입고, 열심히, 열렬히;흥분하여;충심으로, 따뜻이:thank~ 심심한 사의를 표하다

wasted : a, 황폐한, 쇠약한;소용이 없는, 헛된(노력):병으로 쇠약한 아이, (미)살해된;(정신적.육체적으로)지친;마약(알코올)에 취한, 마약 중독의;(미)무일푼의

wearied : a, 피곤한;싫증난;따분한:a~brain피곤한 머리

widemouthed : a, 입이 큰, 아가리가 넓은:놀라서 입이 딱 벌린

bantam : n, a, 벤텀당닭:암팡지고 싸움 좋아하는 사람-몸집이 작은, 가벼운, 공격적인

bdellium : n, 베델리엄(수지, 보석 또는 진주일 것이라고 함, 창세기 2:12), 방향 수지(를 내는 나무)

Beulah : n, 쀼라(결혼한 부인), 이스라엘의 빛나는 미래를 상징함, 이사야 62:4, (만년의)안식의 땅, 여자 이름

Boanerges : n, 보아너게(우뢰의 아들, 예수가 제자 야고보(James)및 요한(Jhon)에게 붙인 이름, 마가복음 3:17), 목소리가 큰(열변의)연설가(설교사)

breakerven : a, 수입과지출이맞먹는:이익도 손해도 없는

therapist : n, 치료학자:치료 전문가, 요법사;임상의, 의사

thirtythree : n, 33회전반(331/3 회전의 레코드:보통 33이라고 씀)

threeevent : a, 3종목의:a ~ skier 3종목에 출전한 스키 선수

threequarter : a, 3/4:3/4 가죽 장정, 7분신의;얼굴3/4을 나타내는(full과 profile의 중간)

throated : a, (복합어를 이루어)한 목을 가진, ...한 소리가 나는:목이 하얀 새

thusness : n, 이러함:왜 이러한가

tinctorial : a, 빛깔의:착색(염색)의

tired : a, 피곤한, 지친, 싫증난, 물린, 지겨운:듣는데 신물나다, 세상이 싫어져서, (농담 등이)진부한, 케케묵은, (물건이)낡아빠진

tobe : a, (보통 복합어를 이루어;명사 뒤에서:신부 될 사람)

celebrate : vt, vi, a, (식을 올려 ...을)축하하다, (의식.축전을)거행하다, 세상에 알리다, 공표하다, (승리.용사.공훈 등을)찬양하다, 찬미하다(extol), 기념일을 축하하다, 식을 올려 기념하다, 축제 기분에 젖다, 유쾌하게 마시고 놀다, -bratory(-br5t`2:ri)vt, vi, a, 

corban : n, 봉납물(마가복음7:11)

paybox : 매표소:n, 

phalarope[f'4l5r`oup, 깝작도요무리

gainst : n, AGAINST:prep=AGAINST

Gath : n, 가드(Philistia 의 도시;거인Goliath의 출샐지;사무엘 상6:17)

geometrize : vt, 기하학을 연구하다:기하학적으로 고찰하다;기하학적으로 도형 하다

geoponic : a, 농경(농업)의 :(익살)촌스러운, 시골티나는

Glorious Fourth : x, 영광의 제4일(미국 독립 기념일:7얼 4일)

falwy : :a, 

fRench Union : x, 프랑스 연합(본국 및 영토의 연맹:1958년 French Community로 개칭)

quibble : n, vi, 둔사, 핑계, 견강 부회, 익살:둔사를 농하다, 신소리 하다

sacramentary : a, =SACRAMENTAL:SACRAMENTARIAN

saivific : a, :Good-will신의 구제 의지

salmoncolored : 연어 살색의, 누르스름한 핑크색의:a, 

Salome : n, 살로메(춤을 잘 추어 그 상으로 헤롯에게 청하여 세례 요한으로 머리를 얻은 소녀, (마태복음14:6-11)

Samaritan : n, 사마리아 사람, good ~ 친절한 사마리아인 자선가(누가복음 10:30-37)

samarium : 사마륨(회토류 원소의 하나, 기호:m)n

satelloon : 기구 위성(에코 위성 등):n, 

scarred : a, 상처 자국을 남긴:a war~country전쟁의 상처 자국울 남기고 있는 나라, a face~with sorrow 슬픔의 흔적을 남긴 얼굴

scented : a, 햐수룰 뿌린, 향료가 든, ~soaps 향수 비누, a 냄새가 좋은, b 냄새로 가득찬(with)(보통 복합어를 이루어)~한 냄새가 나는, 후각이 ~한: keen~후각이 예민한

scorching : a, 태우는, 몹시 뜨거운, (비평, 비난 등이)맹렬한, 호된, (부사 용법)타는 듯이:be~hot타는 듯이(굉장이)덥다(뜨겁다)

scoreless : a, (시합이)무득점인, 0대0인: a~game무득점의 시합

Scrabble : 스크래블(anagram 비슷한 단어 만들기 놀이, 상표명:n, 

scull : n, 고물에 달아 좌우로 지나가는 외노, 스컬노(혼자서 양손에 하나씩 쥐고 저음):n(sculler) 그것으로 짓는 경조 보트

seamed : a, 주름살 진: a deepiy~face 깊은 주름살이 진 얼굴, 상처 자국이 있는: a face~with scars

seapiant : 해초:n, 

searching : n, 수색, xkator, rjatk, dmaal:the~of heart 양심의 가책

seated : a, (보통 복합어를 이루어)앉는 부분이 ~한, 걸상이 ~한, 엉덩이가~한, 뿌리가 ~한: a deep ~ disease 고질

seating : n, 착석, (집합적) 좌석(의 설비), 수용(력):a ~ capacity 좌석수, 수용 능력, 승마의 자세(앉음새), 좌석의 배치(극장 등의), 의자의 씌우ㅐ(속)의 재료

secluded : a, (장소가)외딴(곳에 있는):~mountain cottage 외딴 곳에 있는 산장, (사람, 생활이)세상에서 격리된, 은둔한, (방에)틀어박힌

seconddegree : a, (특히 죄상, 화상이)제2급의, 제2도의:~murder 제2급 모살/a~burn제2도 열상(수포상 화상)

secondpair : a, (영)3층의: a~front(back)3층의 앞(뒷) 방

seemingly : ad, 겉으로는, 표면(외관)상(은), (무장 전체를 수식하여) 겉으로 보기에: S~he is mistaken.겉보기에는 그가 틀렸다

segregated : a, 부리된, 격리된, 인종 차별의(을 하는)특수 인종(그룹)에 한정된:~education 인종 차별(격리)교육

selah : n, 셀라(구약 시편에 나오는 헬라어 표현:감탄사 또는 으악 부호로 추측됨)

selfdestruction : n, 자멸, 자살: ~equipment 자폭 장치

selfhardening : a, 자경성의:~steel 자경강

selfrising : a, (미)(밀가루가)(효모 없이)저절로 부풀어 오르는:~flour 베이킹 파우더 등을 미리 넣은 밀가루

semi : n, 이동식 연립주택의 한채, 반 얼마간의 뜻:n, 

semidetached : a, 반쯤(일부분)떨어진, (영)(집 등이)한 쪽 벽이 옆채에 붙은, 두 가구 연립의: a~house 두채 한집, 두 가구 연립 주택

semifinalist : a, 거의 완성된, 반 제품의: a~product 반제품

seminal : a, 정액의, 종자의: a~leaf 떡잎, 발생의, 생식의(종자 같이)발달 가능성이 있는, 근본의, 장래성이 있는:in a~state 배자 상태의, 미발달(상태)의, 생산적인, 감화력이 강한

seminiferous : a, 정액을 만드는(운반하는), 종자를 낳는:~tubes 수정관

semipostal : a, (광석이)준보석의:~stone반(준)보석

Semitic : a, 셈족(인종)의, 셈 계통의, 셈어계의:the~languages셈어(족), (특히)유대인의

sempre : ad, 항상, 끊임없이:~forte 내내 강한 소리로

sennight : n, 1주간(week):Tuesday ~1주일 전(후)의 화요일

septan : a, 7일마다 일어나는(열):~fever 7일열

sermonize : vi, vt, 설교하다, 잔소리(훈계)하다:~it설교하다

seven : n, a, 일곱(의), seventy times ~ 몇번이고(마태복음18:22)

sharpness : n, 날카로움, 급함, 가파름, 격렬, 신릴: the~of a turn 급커브, 선명, 영리, 교활, 높은 가락

shelled : a, 껍질을 벗긴(깐):~nuts껍질을 깐 견과, (복합어를 이루어)..한 껍질이 있는:hard(soft)~딱딱한(부드러운)껍질의

shifting : a, 이동하는, 바뀌는, (풍향 등이)변하기 쉬운:~sand흐르는 모래, 수책을 부리는 , 협잡의

shingly : a, 널빤지로 이은, 지붕널 모양의, (영)조약돌이 많은, 자갈투성이의: a~beach 자갈 많은 해변

shipwrecked : a, 난파한, 깨어진, 파괴된:~hopes 깨어진 희망

shitless : a, ad, 대변이 나오지 않느(않을 정도로):scared~몹시 놀라서

shivery : a, 몸을 떠는, 떨기 잘 하는:오싹하는, 오한이 나는, 추운

shockabsorbing : a, 완충적(인):a~device 완충 장치

shouldered : a, (보통 복합어를 이루어)..한 어깨를 가진:broad~어깨 폭이 넓은, 어깨에 멘(짊어진):stand~어깨총의 자세를 취하다

sickening : a, 병나게 하는, 욕지기나게 하는, 넌더리나게 하는: a~sight 구역질 나는 광경

sideways : a, 옆의, 옆을 향항, 비스듬한:a~glance 곁눈질

silieic : a, 규소를 함유한, 규토(규산)의:~acid 규산

simile : n, 직유(보기: as busy as a bee)

Sinojapanese : a, 중국과 일본간의:the~War 청일 전쟁

sirree : n, (미)(yes또는no뒤에서 강조로 쓰여)=sir: yes, ~.그렇고 말고요/no, ~.(절대로) 그렇지 않습니다, 전혀 아닙니다

Socrates : a, 소크라테스(그리스 철학자:469-399 B, C, )

strait : a, 좁은, 엄중한, 해협, 궁핍, 곤란, 좁은문(마태복음 7:14), Straits Settlements 해협 식민지

Sun Yatsen : x, (1866-1925) 손일선(본명:손문, 중국의 혁명가, 정치가)

embalm : vt, 시체에)향유를 발라서 보존하다:(이름을)길이 기억에 남기다, 향기를 풍기다, 향료를 치다

