M : n , 알파벳 열세번째 문자, M(로마숫자)mille(L, =1, 000), mobilization, M, Monday, Monsieur, m, majesty, male, mark(s), masculine, medium, month, m, mmeter, mile
M.A.B. : x, Metropolitan Asylums Board
M.C.L. : x, Master of Civil Law
M.I.Chem.E. : x, Member of the Institution of Chemical Engineers
M.I.T., MIT : x, Massachusetts Institute of Technology
M.O : x, money order
M.R. : x, Master of the Rolls, municipal reformer
M.R.C.A. : x, multirole combat aircraft 다목적 전투기
M.R.S.T. : x, Member of the Royal Society of Teachers
M.V.O. : x, Member of the Victorian Order
M2 : x, M2(M1에 각종 금융기관의 정기성 예금을 합친 일국의 통화 공급량
M3 : n, M3(M2에 각종 금융기관의 예저금과 신탁의 원본을 합친 일국의 통화 공급량)
ma : x, (구) 엄마(mamma), Ma(화) masurium, mA milliampere(s), M.A. Magister Arti Assistance Advisory Group
maam : n, 부인, 마님, (여)선생 등 웃사람에 대한 호칭
maam : n, 여왕, 공주에 대한 호칭(madam의 단축)
maandpa : a, =MOM, AND, POP
maar : n, 마르(평평한 폭렬 분화구)
Mab : n, 여자 이름
Mabel : n, 여자 이름
Ma Bell : x, 벨 전화회사(the American Telephone&Telegraph Company의 별명)
mac : n, =MACKINTOSH
Mac : n , 스코틀랜드사람, 아일랜드사람, 낯선사람에 대한 호칭
MAC : Military Armistice Commission, Mac, pref (...의 아들)의 뜻(스코틀랜드 사람, 아일랜드 사람의 성에 붙음
macabre : a, 죽음의 무도의, 섬뜩한
macaco : n, (pl, ~s) 여우원숭이
macadam : n, 쇄석, 쇄석포도
macadamize : vt, ...에 밤자갈을 깔다
Macao : n, 중국 남동 해안의 포르투갈령 식민지
macaque : n, 짧은꼬리 원숭이(아시아, 아프리카산)
macaroni : n, 마카로니(이탈리아식 국수), 18세기 영국에서 이탈리아를 숭상하던 멋쟁이, 이탈리아사람
macaronic : a, 라틴어 어미를 현대어에 섞은 혼효체, 뒤범벅된
macaronic : n , 라틴어, 라틴어 어미를 현대어에 섞은 혼효체의 , 속 혼효체의 광시, 잡동사니
macaronimills : x, 제재소(sawmill)
macaroon : n, 마카롱 (흰자, 편도, 설탕으로 만든 과자)
MacArthur : n, Douglas (1880~1964) 미국의 육군 원수
macartney : n, (새)머카트니꿩
macassar : n, 마카사르 향유(머리 기름)
Macaulay : n, Babington(1800~1859) 영국의 역사가, 정치가
macaw : n, 마코 앵무새 Macb, Macbeth
Macbeth : n, Shakespeare 작의 비극(의 주인공)
Maccabaeus : n, 마카베공(유대의 애국자)
Maccabees : n, 시리아의 학정으로부터 유다국을 독립시킨 유다 애국자의 일족, 마카베오서 (Apocrypha 중의 2서)
maccaboy, , co, : n, (장미향기가 나는 )코담배의 일종
Maccbean : a, MACCABAEUS의 , MACCABEES의
maccginetta : n, 드립식 커피 포트
MacDonald : n, 맥도널드 J.R.~(영국의 정치가, 노동당 당수, 수상)
mace : n, 육두구 껍질을 말린 향료
mace : n, 갈고리 철퇴(중세의 무기), 권표, 직장 (시장, 대학 학장 등의 앞에 세운 직권의 상징) (구식) 당구봉, (M, ) 지대지 핵 유도탄, (M, )불능 화학제, 최루 신경 가스
macebearer : n, 권표를 받드는 사람
macedoine : n, 야채 (과실) 젤리 요리, 뒤범벅
Macedonia : n, 마케도니아(고대 그리스 북방의 고대국가), 마케도니아 지방의(현 그리스, 불가리아, 유고슬라비아의 각 일부를 포함한 지역)
macedonian : a, n, 마케도니아의, 마케도니아인(어)
macerate : vt, vi, 물에 담가 부드럽게 하다, (태아를) 침연시키다, 단식하여 야위게 하다, 야위다, 마르다
maceration : n, 단식하여 수척해짐, 담가서 부드럽게함
macerator : n, MACERATE하는 것, 펄프 제조장치
Mach : n , 마하(고속도의 단위) ~ one 은 20도씨에서의 음속 770마일/시에 상당)
machete : n, (중남미 원주민의) 날이 넓은 큰칼
machiaveli : n, Niccolo di Bermardo(1469~1527)책략 정치를 주장한 이탈리아의 정치가
machiavelian : a, 권모 정치를 예사로 하는
machiavellism : n, 마키아벨리주의(목적을 위해서는 수단을 가리지 않음)
machicolate : vt, 총안을 만들다
machicoulis : n, 총안(입구.통로 등의 위에 불쑥 나온 부분; 이 구멍으로 불.돌.열탕 등을 떨어뜨림)
machinate : vt, vi, (음모를) 꾸미다
machination : n, 책동, 음모
machinator : n, 책사
machine : n, 기계, 기구, 자동차, 비행기, 자전거, 타이프라이터, 인쇄기계 , 기계적으로 일하는 사람, 기구(the military ~ 군부 /the social ~ 사회 기구), (정당의) 지도부
machine age : x, 기계(의) 시대
machine art : x, 기계 예술
machine bolt : x, 머신 볼트
machine cotton : x,  (재봉틀용) 무명실
machine gun : x, 기관총
machine gunner : x, 기관총 사수
machine hour : n, 기계의 1시간당 작업량
machine intelligence : x, 인공지능
machine language : x, (컴퓨터) 기계 언어(전자계산기를 작동시키기 위한 명령어)
machinelike : a, 기계같은
machinemade : a, 기계로 만든
machineman : n, 기계공, 인쇄공
machine music : x, 컴퓨터 팝뮤직의 총칭
machine pistol : x, 자동 권총; 경기관총
machinereadable : a, (컴퓨터) (전산기가) 처리할 수 있는, 반응할 수 있는 꼴의
machineroom : n,  인쇄실
machinery : n, 기계, 기계장치, (정부 따위의) 기관, 기구, 조직, (극 따위의) 꾸밈, 초자연적사건, government ~ 정치 기구
machine screw : x, 기계 나사
machine sewed : a,  재봉틀로 박은
machine shop : x, 기계 공장
machine time : x, (컴퓨터 등의) 총 작동시(간), 작동 연시간
machine tool : x, 공작 기계
machine translation : x, 기계(자동) 번역
machine vision : x, 기계가 물체를 시각적으로 인식하는 일
machine word : x, (컴퓨터) 기계어
machine work : n, 기계로 하는 일
machin gun : vt, 기총 소사하다
machining : n, 기계 가공
machining center : 복합 공작 기계(다공정 수치 제어 공작 기계), 
machinist : n, 기계공, 기계운전자, 기계 제작(수리)공, 재봉공, 기관병조장, 간부제 지지자
machismo : n, 남자의 긍지, 남자다움
Machmeter : n, 초음속도계, 마하계
Mach number : x, 마하수
mach number : x, 마하수
macho : a, n, 사내다운, (늠름한) 사나이
machodrama : n, 남성 우위극 (영화)
mack : n, 매춘 알선자, 뚜쟁이, 포주, 굴뚝과 마스트의 기부가 겹쳐진 구조(갑판 면적 절약, 진동, 매연 감소 등의 효과가 있음)
mack : n, 이봐, 여보, 자네(남자에 대한 호칭).남자 이름
mackenzie : n, 메켄지강(케나다 서부에서 북극해로 흐르는 강)
mackerel : n, 고등어(pl, ~s, 집합적 ~)
mackerel breeze : x, 고등어 낚시에 좋은 센 바람
mackerel pike : x, 꽁치
mackerel shark : x, 악상어
mackerel sky : x, 비늘구름의 하늘
mackinaw : n, 바둑판 무늬 담요(= ~ blanket) 그것으로 만든 짧은 상의
mackintosh : n, 방수 외투, 고무 입힌 방수포
mackle : vt, vi, 얼룩, 잘못된 인쇄, 이중 인쇄, 얼룩지게 하다(얼룩지다), 잘못 인쇄하다, 이중 인쇄되다
mackman : n, 뚜쟁이
macle : n, 쌍정, (광물의) 얼룩, 변색
macleod : n, 남자 이름
Macmillan : n, Harold(1894~)영국의 정치가, 수상(wodla 1957~1963)
macon : n, 양고기 베이컨
macon : n, 프랑스산 포도주
macrame : n, 마크라메레이스 (가구 장식용 매듭실술)
macro : a, (그 종류 중에서)대형의 것, 대형의, 대규모의, 거시적인
macroanalysis : n, 거시적 분석
macrobiotic : a, 장수 (식) 의
macrobiotics : n, (단수 취급)장수식 연구, 장수법(동양의 음양설에 의한 음식물의 배합)
macrocephaly : n, 이상 대두, 대두증
macrochemistry : n, 거시 화학(현미경이나 미량 분석을 요하지 않는)
macrocosm : n, 대우주(opp, microcosm) 전체, 종합적 체계
macrocyte : n, 대적혈구(빈혈증으로 인해 발생)
macroeconomic model : x, 거시적 경제 모델
macroeconomics : n, (단수 취급)거시 경제학
macroengineering : n , 거대(프로젝트) 공학
macrogol : n, 매크로골(의약품, 화장품의 기제)
macrograph : n, 육안도
macrography : n, 육안 검사, 비정상 글씨를 크게 씀(정신 이상 때문)
macroinstruction : n, 매크로 명령
macrolinguistics : n, 대언어학 (모든 언어 현상을 대상으로 함)
macrometeorology : n, 거시 기상학
macrometer : n, 측원기(망원경을 둘 씀)
macromolecule : n, 거대 분자
macron : n, 모음위의 장음부(보기 came, be)
macroni cheese : x, 마카로니에 치즈가루를 쳐서 구운 요리
macrophysics : n, (단수 취급)거시적 물리학
macroscale : n, 대규모, 거시적 규모
macroscopic : n, 육안으로 보이는
macroscopical : a, 육안으로 보이는
macula : n, 흑점
maculae : pl, (태양, 달의) 흑점, (광물의) 흠, (피부의) 점
macular : a, 반점이 있는
maculate : vt, 반점을 묻히다, 더럽히다, 불결하게 하다
maculation : n, 반점을 묻힘, 반점이 있음, 반점, 오점, 오욕
macule : n, (피부의)반점
macy's : 메이시스(뉴욕의 대 백화점), 
mad : a, 미친, 무모한(wild), 열중한(after, about, for, on)(He is ~ about her, 그 여자에 미쳐 있다), 성난(angry) drive a person ~ 미치게 하다, go (run) ~ 미치다
madagascan : n, 마다카스카르(사람)의, 마다카르 사람
Madagascar : n, 아프리카 남동쪽의 섬나라(수도 Tannanarive)
madam : n, 부인, 아씨(미혼, 기혼에 관계없이 여성에 대한 정중한 호칭)(cf, maam)
madame : n, 여류가수, (화가) 등의 총칭
madame tussaud's : x, (london)의 터소 밀랍 인형관
mad apple : x, 가지(eggplant)
madbrained : a, 격하기 쉬운, 물불을 가리지 않는, 무모한
madcap : a, n, 무모한(사람)
madden : vt, vi, 미치게 하다, 미치다
maddening : a, 미칠 듯한
madder : n, 꼭두서니, 인조 꼭두서니, 빨간 인조물감
madding : a, 광기의, 광란의, far from the ~ crowd 속세를 멀리 떠나서
maddoctor : n, 정신과의사
made : v, make의 과거분사
made : a, 만든, 그러모은, 만들어진, 성공이 확실한, ~ dish 모듬 요리, ~ man 성공자
madefortv : a, 텔레비젼 전용으로 만들어진
Madeira : n, 마데이라 흰포도주
Madeira cake : x, 카스텔라의 일종
Madeleine : n, 마들렌(작은 카스텔라 비슷한 과자)
mademoiselle : n, = Miss(생략 Mlle, (pl) Mlles)
mademoney : x, 데이트할 때 여자가 준비하는 예비금(만일의 경우 혼자 돌아오기 위한 돈), 사천
madeover : a, 고쳐만든
madetomeasure : a, (옷, 구두를) 치수를 재어 맞춘, 성미에 딱맞는
madetoorder : a, 주문에 의해 만든, 마춤의
madeup : n, 만든, 만들어낸, 메이크업한, 꾸며낸, 결심한 (스타일 따위) 지나치게 꾸민, 부자연한
madhouse : n, 정신병원
mading : a, 미칠듯한
madison anenue : x, 미국 뉴욕시의 광고업 중심가, 광고업
madison square garden : x, 미국 뉴욕시 Eighth Avenue에 있는 스포츠 센터
madly : ad, 미쳐서, 미친듯이, 몹시, 극단으로
Madm : x, Madam
madman : n, 미친 사람
mad money : x, 데이트시 여성이 준비하는 돈(혼자 도주를 위해)
madness : n, 광기, 열광, 정신 착란, 광희
Madonna : n, (It= mylady) 성모 마리아, 그 (초)상
Madonna lily : x, 흰백합
Madras : n , 마드라스(인도 동남부에 있는 주, 그 주도), (와이셔츠 감으로 쓰는)고은 무명
madrepore : n, 녹석(돌산호과의 일종)
madrid : n, 스페인의 수도
madrigal : n, 사랑의 소곡, 합창곡 (cf, motet)
madrilene : n, 마드릴렌(토마토로 맛들인 마드리드식 콩소메)
maduro : a n, 짙은 갈색의 맛이 독한 (엽궐련)
madwoman : n, 미친 여자
madwort : n, 알리섬뜰 냉이(겨자과), 양구슬냉이의 일종
Maecenas : n, 마에케나스(옛 로마의 정치가, 문학, 예술의 보호자)
maelstrom : n, 큰 소용돌이, 혼란, 노르웨이 서부 해안의 큰 소용돌이
maenad : n, 주신을 섬기는 여자, 열광하는 여자
maestoso : ad, 장엄하게
maestro : n, 대음악가, 거장
Maeterlinck : n, 메이터링크(벨기에의 극작가, 시인)
Mae west : x, (선원, 비행사용)구명조끼, (낙하산의)중앙 조리개 (낙하 속도를 저하시키는 장치)
Mae West : x, (유방이 큰 미국의 여배우 이름에서)(비행사의) 수난 구멍 조끼, 유방
Maffei galaxy : x, 마페이 소우주(은하계를 에워싸는 국부분의 우주)
Maffia : n, 마피아단(법률과 질서를 무시한 시칠리아 섬의 폭력단), (미국등의) 범죄 비밀 결사
Maffiapm : n, 마피아단, 범죄비밀결사
maffick : vi, 야단법석을 치다
Mafiology : n, 마피아학, 마피아 연구, 범죄 조직학
mafiosi : pl, 마피아의 일원
mafioso : n, 마피아 단원
mag : n, 반 페니(화폐), 여자 이름
magadose : n, vt, (약제, 비타민 등의) 대량 투여(량), 대량 투여하다
magazine : n, 잡지, (탄약, 식량 따위의) 창고, (연발총의) 탄창, 필름 감는 틀
magazineformat : a, (텔레비젼 프로가) 잡지 형식의, 잡지식 구성의
magazinegun : x, (rifle, pistol)연발총
magcon : n, 자석 집중(현상), (달, 행성 표면에 자기 물질이 보이는 것)
Magdala : n, 막달라(팔레스티나 북부의 마을)
Magdalen : n, 막달라 마리아(누가복음 7, 8), 갱생한 창녀
magdalen home : x, 윤락 여성 갱생원
Magdalenian : a, 막달레니안기의(구석기 시대 후기의 종말)
Magdeburg hemisphere : x, 마구데부르크의 반구
mage : n, 마법사, 박식한 사람
Magellan : n, 마젤란(포루투갈의 항해자)
magenta : n, 빨간 아닐린 물감, 그 색(진홍색)
Maggie's drawers : x, 빗나간 사격
maggot : n, 구더기, 변덕, ~ in one's head 변덕
maggoty : a, 구더기 천지의, 변덕스러운
Maghreb : n, 마그레브 지방(북아프리카 서부 , Libya, Tunisia, Algeria, Morocco 를 포함)
Magi : n, 동방 박사(마태복음 2 1), 마기 승족, (고대 페르시아의)마술사
magian : a, n, 마기 승족의, 마기승, 마술사
magic : a, 마법의, 기술의, 불가사의한
magic : a, 마법, 기술, 불가사의한 힘, black ~ 악마의 힘에 의한 마술, natural ~ 자연력 응용의 마술, white ~ 착한 요정의 힘에 의한 마술
magical : a, 마술적인, 신기한
magicaly : ad, 신기하게도
magic bullet : x, 마법의 탄환(박테리아, 바이러스, 암세포만 파괴하는 약제)(문제의) 해결책
magic carpet : x, (전설상의) 마법의 양탄자
magic carpet : x, 마술의 양탄자
magiccian : n, 마법사, 요술쟁이
magic circle : x, 마술의 동그라미 (그 안 사람은 마술에 걸린다는)
magic eye : x, (라디오 따위의 동조 지시 진공관) 매직아이, (M.E.) 그 상표명
Magic Eye : (때로 m~ e~) (라디오 수신기의) 동조 지시용 진공관 (상표명), 
magic lantern : x, 환등
magic lantern : x, 환등기(오늘날의 projector)
Magic Marker : 매직펜 (상표명), 
magic mirror : x, (미래나 먼 고장의 광경을 비추는) 마법의 거울
magic mirror : x, 마술의 거울
magic mushroom : x, 독버섯의 일종(미국산)
magic number : x, 매직 넘버, 마법수
magic realism : x, 환상적 사실주의
magic spot : x, 매직 스폿(구아노신과 4-5개의 인산염 화합물)
magic square : x, 마방진 (수학유회)
magic square : x, 마방진 (가로, 세로, 대각선 수의 합이 모두 같은 숫자 배열표)
magicube : x, 입방체 플래시(Kodak 사제, 상표명)
magic wand : x, 마술 지팡이
magic words : x, 주문
magic words : x, 주문
Maginitminded : a, 현상 유지에 급급한
Maginotline : n , 마지노선(2 차 대전시 독일, 프랑스 국경의 프랑스 방어선)
magisterial : a, 행정 장관의, 위엄에 찬, 고압적인
magisterium : n, 교학권
magistracy : n, 행정 장관, 치안관의 직, 판사(magistrates)
magistral : a, 특별 처방의, 약국의 처방에 의하지 않는, 의사 처방의
magistral staff : x, 교관
magistrate : n, (사법권을 가진) 행정 장관, 치안 판사(justice of the peace)
magistrates court : x, 경범죄(예심) 법정
Maglemosian : a, 마글레모제 문화의(중석기 시대 중기의 북유럽 문화)
maglev train : x, 자기부상열차
magma : n, 마그마, 암장
magmata : pl, = magma
magnacharta : n, 대헌장(1215년 Jone 왕에 강요하여 국민의 개인적이나 정치적 자유를 승인시킨 대헌장)
magnacunlaude : n, a, 제 2 위(의 우등으로)(cf, summacumlaude)
magnalium : n, 마그날륨(마그네슘과 알루미늄의 합금)
magnanimity : n, 도량이 넓음, 아량, 관대한 행위
magnanimous : a, 도량이 넓은, 아량 있는
magnate : n, 거물, 유력자 (an oil ~ 석유왕)
magnesia : n, 산화 마그네슘
magnesite : n, 마그네사이트(마그네슘의 원광석)
magnesium : n, 마그네슘(금속 원소, 기호 Mg)
magnesium chloride : x, 염화 마그네슘
magnesium light : x, 마그네슘광(야간 촬영 따위에 쓰임)
magnesium oxide : x, 산화 마그네슘
magnet : n, 자석, 사람을 끄는 것, bar ~ 막대 자석, horseshoe ~ 말굽 자석, natural ~ 천연 자석
magnetic : a, 자기성이 있는, 매력 있는
magnetic (dipole) moment : x, 자기 쌍곡자 모멘트, 자기 모멘트
magnetically : ad, 자기적으로, 매력적으로
magnetic bubble : x, 포자구(자성재 안에 나타나는 원주꼴의 자구)
magnetic card : x, 자기 카드
magnetic circuit : x, 자기 회로
magnetic compass : x, 자기 컴퍼스(나침의)
magnetic core : x, (컴퓨터) 자기 코어(기억 소자로 쓰이는 자철의 작은 고리)
magnetic declination : x, 자기 편각
magnetic detector : x, 자기 검파기
magnetic disk : x, 자기 디스크(표면이 자성 재료로 덮힌 원판상의 기록 매체)
magnetic domain : x, (강자성체의) 자구
magnetic drum : x, 자기 드럼
magnetic equator : x, 자기 적도
magnetic exploration : x, 자기 탐광(법)
magnetic field : x, 자장, 자계
magnetic flux : x, 자속, 자광
magnetic flux density : x, 자속 밀도
magnetic force : x, 자기력
magnetic head : x, (테이프 레코더의) 자기 헤드
magnetic induction : x, 자기 유도
magnetic levitation propulsion system : x, 자기 부상 추진 시스템(linear motor에 의한 초고속 철도)
magnetic meridian : x, 자북선, 자기 자오선
magnetic mine : x, 자기 기뢰
magnetic needle : x, 자침
magnetic north : x, 자북
magnetic permeability : x, 투자율
magnetic pickup : x, (전축의)자석식 픽업
magnetic pole : x, 자극
magnetic potential : x, 자위
magnetic recorder : x, 자기 녹음기
magnetic resonance : x, 자기 공명
magnetics : n, (단수 취급) 자기학
magnetic storm : x, 자기 폭풍
magnetic stripe : x, 자기대 (크레디트 카드 등에 붙인, 폭 6미리미터 정도의 얇은 갈색 띠)
magnetic tape (recoder) : x, (녹음용) 테이프 (레코더)
magnetism : n, 자기, 자력
magnetite : n, 자철광
magnetization : n, 자화
magnetize : vt, vi, 자력을 띠게 하다, (사람을) 끌어 당기다, (사람 마음을) 움직이다, ...자력을 띠다
magneto : n, 자석 발전기
magneto bell : x, 자석식 벨
magnetodisk : ㅜ, 자기 디스크 (행성의 자기권 주변부에 있는 강력한 자력선에 의해 형성된 장원통형의 구역)
magnetoelectric : a, 자전기의
magnetoelectric, -trical : a, 전자기의
magnetoelectricity : n, 전자기, 전자기학
magnetogram : n, 자력, 기록
magnetograph : n, 기록 자력계
magnetograph : n, 자력 기록(기)
magnetohydrodynamics : n, (단수 취급) 전자 유체 역학, 자기 유체 역학 발전, 전자 유체 발전
magnetometer : n, 자력계
magnetometry : n, 자기 (자력) 측정
magnetomotive force : x, 기자력
magneton : n, 자자
magnetopause : n, 자기 권계면 (자기권의 외측 경계)
magnetoplasmadynamics : n, (단수 취급)=MAGNETOHYDRODYNAMICS
magnetoscope : n, 자력 (자기) 검출기
magnetosheath : n, 자기초, 자기권의 외피층
magnetosphere : n, (전체의) 자기권
magnetostriction : n, 자기 변형(자기에 의한 신축)
magnetotactic : a, (생체가) 주자성의, 지축을 향하는 성질을 가진, 향자극성의
magnetotail : n, 지자기 꼬리(태양 반대 방향으로 길게 뻗은 지자기권 부분)
magnetotaxis : n, (생물의) 주자성, 향자장성
magnetotelephone : n, 자석식 전화기
magnetron : n, 마그네트론, 자전관
magnet school : x, 마그넷 스쿨(백인 학생을 유도하기 위하여 뛰어난 설비와 교육 과정을 갖춘 매력적인 학교)
magnicide : n, 요인 암살
magnifiable : a, 확대할 수있는
magnific, -ical : a, 장엄한, 숭고한, 당당한, 과대한
Magnificat : n, 성모마리아 송가(저녁 기도에 부름), (일반적으로)송가
magnification : n, 확대, 과장, 찬미, 배율, 확대도
magnificence : n, 장려, 장엄, 호화, 훌륭함
magnificent : a, 장려한, 장엄한, 웅대한, 훌륭한
magnifico : n, 옛 베니스 공화국의 귀족, 귀인, 거물
magnifier : n, 확대기, 확대경
magnify : vt, 확대하다, 과장하다, 칭찬하다
magnifying glass : x, 확대경, 돋보기
magnifying power : x, 배율
magniloquence : n, 호언장담, 해풍, 과장
magniloquent : a, 호언장담하는, 과장한
magnitude : n, 크기, 중요도, 광도, 진도
magnolia : n, 태산목, 목련, 그 꽃
Magnolia State : x, Mississippi 주의 속칭
magnon : n, 매그논(spinwave를 양자화한 준입자)
magnox : n, 마그녹스로(영국이 개발한 탄산가스 냉각 원자로)
magnum : n, 2 쿼트 들이의 큰 술병, 그 양
magnum opus : x, 대작, 대표작, 주요 작품
magot : n, (도자기, 상아 등으로 만든) 괴상한 상, (꼬리 없는) 붉은털원숭이
magpie : n, 까치, 비둘기의 일종, 수다쟁이
Magsaysay : n, Ramon(1907~1957) 필리핀의 정치가
magsman : n, 사기꾼, 협잡꾼
magstripe : a, 자기판독식의
maguey : n, 용설란
magus : n, 마기족 사람, 마술사
mag wheel : x, 마그네슘 합금제 자동차 바퀴, 스포츠카의 노출된 은색 차륜
Magyar : n, a, 마자르 사람(헝가리의 주요 민족)(의), 마자르말(의)
Mahabharata : n, 마하바라다 (옛 인도의 대서사시)
mahalo : n, (하와이) 고맙습니다
maharaja : n, (인도의) 회교 군주
maharanee : n, 회교 군주의 부인
maharishi : n, (흰두)수도사
mahatma : n, (밀교의)대성, 초인
Mahayana : n, 대승불교
Mahdi : n, 구세주
Mahican : n, 모히칸족(허드슨강 상류 지방에 살던 북미 인디언)
mahjong : n, 마작
mahogany : n, 마호가니(재), 적갈색, the ~ 식탁, be under the ~ 식탁 밑에 취해 곤드라지다, with one's knees under the ~ 식탁에 앉아
Mahomet : n, = Mohammed
Mahomidan : a, n, = Mohammendan
mahout : n, 코끼리를 부리는 사람
Mahratta : n, 마라타 사람(인도의 호전적인 민족)
maid : n, 소녀, 아가씨, 미혼녀, 처녀, 하녀, ~ of work 가사 일만을 맡아 보는 하녀, ~ of honour 시녀, 신부의 들러리, old ~ 노처녀, 잔소리꾼, (트럼프의) 조커 빼기
maidan : n, (인도) 광장
maiden : n, a, 아가씨, 미혼녀, 단두대... 미혼의, 처음의, 처녀, a ~ speech 처녀 연설 / a ~ voyage 처녀 항해
maiden assize : x, (영) 심리 안건이 없는 순회 재판
maidenhair : n, 공작 고사리 속의 속칭
maidenhairtree : n, 은행나무
maidenhead : n, = MAIDENHOOD , 처녀막
maidenhood : n, 처녀성, 처녀시대
maidenish : a, 처녀티 나는, 처녀 같은, 처녀티 내는
maidenlike : a, ad, 처녀답게, 조심스러운, 조심스럽게, 처녀다운
maidenly : a, 처녀다운
maiden name : n, (여자의) 구성
maiden over : x, (크리켓) 득점 없는 오버
maidhood : n,  하녀의 신분
maidinwaiting : n, 시녀, 여관
Maid Marian : x, (morris dance의) 5월의 여왕, Robin Hood의 애인
maidservant : n, 하녀
Maidstone : n, 메이드스톤(잉글랜드 동남부 Kent 주의 주도
maieutic, -tical : a, (소크라테스의) 산파술의(마음속의 막연한 생각을 문답으로 명확히 인식시키는 방법)
maigre : a, 소밥의, 고기 없는
mail : n, 사슬미늘 갑옷
mail : n, vt, 우편낭, 우편제도(air mail 항공 우편 / first, class mail 제 1 종 우편), 우편물, by ~ 우편으로... 우송하다
mailable : a, 우송할수 있는
mail bag : x, 우편낭
mail boat : x, 우편선
mail bomb : x, (개봉하면 폭팔하는) 우편 폭탄
mail box : x, 우편함, 우체통
mail carrier : x, 우편 집배원
mailcart : n, (손으로 미는) 우편차, 유모차
mail catcher : x, 우편물 적재 장치
mail chute : x, 우편물을 빌딩 위층에서 아래층으로 떨어뜨리는 장치
mailclad : a, 쇠미늘 갑옷을 입은
mail clerk : x, 우체국 직원
mail coach : x, (옛날의) 우편 마차
mail day : x, 우편 마감일
mail drop : x, 우편함의 투입구, 극비 통신용의 수신인 주소
mailed : a, 사슬미늘 갑옷을 입은
mailed fist : x, 무력, 완력
mailer : n, 우송자, 우편이용자
mail flag : x, 우편기
mail fraud : x, 우편을 이용한 사기
mailgram : n, 메일그램(미국의 Teletype형 전자 우편)
mailing : n, 우송, 우편물, 우편 엽서 (양쪽에 뚜껑이 없는) 우편물 우송 보호통, ~ table 우편물 분리대
mailing list : x, 우편 수취자 명단
mailing machine : x, 우현물 수취인 주소, 성명(소인)인쇄기, 우편 사무 처리기
mailing tube : x, (신문, 잡지의)우송용 원통
maillol : n, Aristide(1861~1944) 마이욜(프랑스의 조각가)
maillot : n, (발레용) 타이츠, (원피스로 어깨끈 없는) 여자 수영복
mailman : n, 우편 집배원
mail matter : x, 우편물
mail messsenger : x, 우편물 운송인
mail order : x, 통신 주문, 통신 판매
mail order : x, 통신 판매
mailorder : a, 통신판매 제도의
mail order house : x, 통신 판매점
mailorder house(firm) : x, 통신 판매점
mailpiece : n, 우편물, 우송품, 봉함 우편물(보통은 mailing piece라고 함)
mail plane : x, 우편 비행기
mailplane : n, 우편 비행기
mailster : n, 우편 집배용 3륜차
mail train : x, 우편 열차
mailtrain : n, 우편 열차
maim : vt, 불구자로 만들다
main : n, 힘, 체력, 주된 것, 중요 부분, 대해(maine sea의 생략), (cf, mainland)(over land and ~ 육지와 바다에), (수도 따위의) 본관, 간선, in the ~ 주로, 대체로
main : a, 전력(온힘)을 다하는, 주요한, 제일의 by ~ force 전력을 다하여
main boom : x, mainsail의 아랫자락을 펴는 둥근 나무
main brace : x, main yard를 돌리는 밧줄, splice the ~ 선원에게 술을 특별히 내다, 술을 진탕 마시다
main chance : x, 절호의 기회, 사리
main course : x, 메인 코스, (식사의) 주요리, (횡범선의) 주범
main current : x, 주류
main deck : x, 주 갑판
maindjustive : a, 조절(조정)이 잘 안 된, 환경에 적응 못하는, 부적응의, a ~ child 환경 부적응아
main drag : x, 번화가, 중심가
maine : n, 미국 북동부의 주
main event : x, 주요 경기
main force : x, 주력
mainframe : n, 컴퓨터의 본체(cf, peripheral), 대형 고속 컴퓨터
mainframer : n, 컴퓨터 본체 메이커
main hatch : x, 주창구, 중부 승강구
main hold : x, 대선창, 중부 선창
mainland : n, 본토(부근의 섬, 반도에 대한)
main line : x, 간선
main line : x, (철도, 도로 등의) 간선, 본선, 정맥 , 마약의 정맥주사, 돈(집합적)부자, 저명 인사, (교도소의 식당)
mainline : a, 마약을 정맥에 주사하다, 간선의, 주요한
mainliner : n, 간선 운행 교통 수단, 마약을 정맥에 주사하는 사람, 엘리트
mainly : ad, 주로
mainmast : n, 큰 돛대
mainpernor : n, 보석 보증인
mainprize : N, MAINPERNOR의 보증에 의한 조건부 석방 영장
main queen : x, 친근한 여자 친구, 여성역의 동성 연애자
main rigging : x, 큰 돛대의 조범 장치
main royal : x, 큰 돛대의 로열 (돛)
mainsail : n, 주범(mainmast의 돛)
mainsheet : n, 메인시트(mainsail 조종 밧줄)
mainspring : n, (시계 등의) 큰 태엽, 주요 동기
main squeeze : x, (조직의) 중요 인물, 우두머리, 보스, 마누라, 애인, 그녀
mainstay : n, 큰 돛대의 버팀줄, 대들보
main stem : x, 한길, 주류, 간선
main stem : x, (철도의) 본선, 한길, 주류, 번화가
main store (storage) : x, 주기억 장치
mainstream : a  , (강 등의) 주류, (홀동, 사상의) 주류, 주체, (사회의) 대세, 	주류의
mainstreaming : n, 특별(차별) 교육 철폐(론)
mainstream smoke : x, (흡연에서) 직접 마시는 연기
main street : x, 중심가, (인습, 실리적인) 전형적인 지방도시인 (사회)
Main Street : x, (Sinclair Lewis의 소설에서)(소도시의) 큰거리, 중심가, (소도시의)인습적, 실리주의적 사회
mainstreet : vi, (미, 캐나다) 도시 중심가에서 선거 운동을 하다
maintain : vt, 유지하다, 지속하다, 계속하다, 부양하다, (한 집안을) 지탱하다, 간수하다, 건사하다, 주장하다, 지지하다, ~ oneself 자활하다
maintainable : a, 계속(유지, 부양, 지지, 주장)할 수 있는
maintained school : x, 공립 학교
maintainor : n, 소송 방조자
maintenance : n, 유지, 보존, 지속, 부양(료), 생계, 주장
maintop : n, 큰 돛대의 장루
maintopgallant : n, 큰 돛대의 윗 돛대, 그 돛(활대)
maintopgallantmast : n, (해) 큰 돛대의 돛대
maintopmast : n, 큰 돛대의 중간 돛대
maintopsail : n, 큰 돛대의 중간 돛대
main verb : x, 본동사, 주동사(일반 동사를 조동사와 구별하는 명칭)
main yard : x, 큰돛의 활대
main yard : x, 큰 돛대의 아래 활대
Maisie : n, 여자 이름
maisonette : n, 작은집, (종종, 이층 건물의) 아파트, 셋방
mai tai : n, 마이 타이주 (럼 칵테일)
maitre dhotel : x, 급사장
maize : n, 옥수수, 그 열매, 담황색
maj : x, majority
Maj : x, Major
majestic : a, 위엄있는, 당당한
majestical : a, 당당한
majestically : ad, 위엄있게
majesty : n, 위엄, 장엄, 주권, 폐하, 후광에 둘러 싸인 신(예수)의 상 Her Majesty the Queen 여왕 폐하, His (Her) Majesty 황제(황후) 폐하, Your Majesty 폐하(호칭)
majolica : n, (이탈리아) 마졸리카 도자기
major : a, (opp, minor) (둘중에서) 큰쪽의, 대부분의, 주요한, 장조의, 성년의, (M, ) (같은 성에서) 연장의(Brown ~ 큰 브라운)
major : n, 육군(해, 공군) 소령, (특무) 상사, (법)성년자, (논)대전제, (악)장조(A ~ 가장조), 장음계, (미) 대학의 전공과목
major : vi, (미) 전공하다
major axis : x, (원추 곡선의) 장축
Majorca : n, 마조르카(지중해 서부의 Balearic제도 중 가장 큰 섬)
major currency : x, 주요 통화(달러, 마르크, 엔 등)
majordomo : n, (왕가, 귀족의) 청지기, 집사장 (익살) 하인 우두머리(butler) 지배인(steward)(농장, 목장의) 감독자
majorette : n, = DRUM MAJORETTE
major general : x, 소장(육군, 해병, 공군의)
majoritarian : n, a, 다수결주의(자)(의), 말없는 다수의 일원(의)
majority : n, 대다수, 과반수, 다수파, (득표) 차, 성년, 소령의 지위, attain one's ~ 성년이 되다, (win) by a ~ of ...의 차로(이기다), join the ~ 죽다
majority leader : x, (상, 하의원) 다수당 원내 총무
majority rule : x, 다수결 원리
majority whip : x, (의회내 다수파 정당의) 원내 부총무
major key : x, 장조
major key : x, 장음계, 장조
major league : x, 직업 야구 대 리그(National League 혹은 American League)
major league : ㅌ, (미)메이저(대리그(2대 직업 야구 연맹의 하나 American League 또는 National League)
majorleaguer : n, (미)메이저 리그의 선수
majormedical : n, a, (미) 고액 의료비 보험(의)
major part : x, 대부분, 과반수
major party : x, 다수당, 대정당
major premise : x, 대전제
major premise(premiss) : x, (3단 논법의) 대전제
Major Prophets : x, (the ~ )(구약 성서의) 대예언서, (Isaiah, Jeremiah, Ezekiel, Daniel의 4서)(때로 the m~ p~)대예언서의 작자
major scale : x, 장음계
major scale : x, 장음계
majorship : n, 육군 소령의 직(위)
major suit : x, (카드)모두가 스페이드(하트)인 패(bridge놀이에서 득점이 많음)
major term : x, 대명사
majuscule : n, 대문자 (cf, minuscule)
make : vt, (made) 만들다, 제조하다, 건설하다, (시나 글을) 창작하다, 마련하다(arrange)(~	    a bed 잠자리를 마련하다), ...으로 만들다, ...이 되게하다(into)
make : vt, ...을 ...으로 보다(~  him a fool 우롱하다), 판단하다(~MUCH (LITTLE) of), (법률따위를) 제정하다, 구성하다(Oxygen and hydrogen ~ water 산소와 수소로 물이 된다)
make : vt, ...이 되다(She will ~ a good wife 좋은 아내가 될 것이다) , 얻다, (돈을) 벌다, 하다, 행하다( ~ a bow 절을 하다), 가다, 나아가다, 답파하다(~ one's way 나아가다 )
make : vt, 눈으로 확인하다(~ land 육지가 보이다), ...이 보이는데 까지 가다, 도착하다(The ship made port 배는 입항했다), (구) 시간에 대다(I've made it! 댔다!), 말하다
make : vt, ...을 ...으로 어림하다(I ~ the distance 5 miles 그 거리는 5 마일로 생각된다), ...에게...하게 하다( ~ him go)
make : vi, 나아가다, 행동하다(~ bold), 조수가 차다, ~ after (고) ...을 뒤쫓다, ~ against ...에 불리해지다, ...을 방해하다, ~away 도망치다, ~away with 처치하다, 죽이다
make : vi, ~(a thing) form ...을 재료로 하여 물건을 만들다, ~ it (미구)잘해내다, 성공하다, 시간을 대다, (미속) 성교하다, ~ it up with ...와 화해하다, ~ off 급히 떠나다
make : vi, ~ out (서류를) 작성하다, 입증하다, 이해하다, ...와 같이 말하다, 암시하다, (미속)애무하다, 성교하다, ~ over 양도하다, ~ up 보충하다, 메우다, 조합하다, 편성하다
make : vi, 화장(메이크업)하다, 분장하다, 결정 짓다, 호해하다, ~ up one's MIND to, ~ up to 구애하다, ...의 환심을 사다
make : n, 만듦새, 구조, 체격, 꼴, 형, 성질, (전) 접속, (at ~ 회로의 접속점에서), on the ~ (구)(성공, 승진, 이익 등을 얻으려고) 열중하여
make-and-break : a, 개폐식의
makebelieve : a, 거짓, 겉꾸밈, 가장 하는 체하기, 위장하는 체하는 사람  거짓의, ~ sleep 거짓잠
makedo : n, a, (물건) 임시변통의, 대용의
makefast : (미) 배를 매어 두는 계선 부표(말뚝), 
makegame : n, 웃음거리
makegood : n, 벌충해주는 광고(광고에 잘못이 있었을 경우, 그 보상으로 올바른 광고를 무료로 게재하는 것)
makeorbreak : a, 성패, 양단간의, 결과가 극단적인, a ~ fiscal policy성공이냐 실패냐가 분명해질 금융 정책
maker : n, 제조업자, (M)조물주, 하느님
makeready : n, (인쇄 직전의) 판고르기
makerup : n, 정판공
makeshift : n, a, 임시변통(의), 둘러 맞춤
makeup : n, 메이크업, 배우의 얼굴 분장, 화장품, 조립, 구조, 꾸밈(새), (인) 케라쇄의 종합 배열(대판 짜기)
makeweight : n, 부족한 중량의 보탬(물건), 보탬
makework : n, (미) (노동자를 놀리지 않기 위해 만드는, 또는 실업 대책으로서 시키는) 불요 불급한 일
making : n, 만들기, 제조, 구조, 조직, 형상, 제작(품), 1 회의 제작량, (성공, 발달의)수단(원인), (pl, 소질, 이익, 벌이), be the ~ of ...의 성공의 원인이 되다
mal : pref, 악, 비 따위의 뜻, 
Malabo : n, 말라보(Equatorial Guinea의 수도)
malabsorption : n, (영양분의) 흡수 불량
Malacca : n, 말라카(말레이 연방의 한 주, 이 주의 주도), the Strait of ~ 말라카 해협
Malacca cane : x, 등나무 지팡이
Malachi : n, 말라기(유대의 예언자), 말라기서
malachite : n, 공작석
malacoderm : n, 연피류, (특히)말미잘
malacology : n, 연체 동물학
maladapt : vt, (과학상의 발견등을) 잘못 응용하다, 잘못 적용시키다.부당하게 이용하다, 악용하다
maladaptation : n, 순응 불량, 부적응
maladapted : a, (환경, 조건등에) 순응(적응)이 안되는, 부적합한
maladjusted : a, 잘 조절 되지 않은, 환경에 적응 안 되는
maladjustment : n, 부적응, 조절 불량
maladminister : vt, 공무 처리를 그르치다, (정치, 경영을)그르치다
maladministration : n, 실정, 악정
maladroit : a, 서투른
malady : n, 병, 병폐
malafide : a, ad, 불성실한(하게), (opp, bonafide)
Malaga : n, 말라가 흰 포도주
Malagasy : a, n, 다가스카르(말라가시)의 (사람, 말)
malaguena : n, 말라게냐 (스페인 댄스 곡)
malaise : n, 불쾌, 불안
malamute : n, (때로 M~)ALASKAN MALAMUTE
malapert : a, n, 뻔뻔스러운 (사람)
malapportioned : a, (의석 등의) 할당이 불공평한
malapportionment : 의원 정수의 불균형
malaprop : n, (Mrs, M~)R, B, Sheridan의 희곡 The Rivals에 나오는 인물(말의 오용으로 유명한 노부인)
malapropian : a, 말을 우습게 잘못 쓰는, 얼토당토 않은, 어처구니 없는, 우스운
malapropism : n, (유사어의) 익살맞은 오용, 그와 같은 말
malapropos : a, ad, n, 시기를 얻지 못한(못하여), 부적절한(하게)
malar : n, a, 뺨(의), 광대뼈(의)
malaria : n, 말라리아, 말라리아의 독기
malarial : a, 말라리아(성)의
malarial frver : x, 말라리아 열
malarkey, ky : n, 어처구니 없는 말, 허풍
malathion : n, (주로 미) 말라티온(살충제)
Malawi : n, 아프리카 남동부의 공확국
Malay : n, a, 말레이 사람(말)(의)
Malaya : n, 말라야, 말레이 반도
Malayalam : n, 인도 남서지방 Malabar에서 쓰는 언어
Malayan : n, 말레이 사람
malaysia : n, 말레이지아, the Federation of ~ 말레이지아 연방(1963년 성립)
Malaysian : n, a, 말레이(군도)의, 말레이 사람(의)
Malcolm : n, 남자 이름
Malcolm X : n, 말콤 엑스(1925-65)(미국의 흑인 지도자)
malconformation : n, 보기 흉한 모양, 볼품 없는
malcontent : a, n, 불평 불만의, ...불평 분자
malcontented : a, 불평하는, (특히 권력, 체제에 대하여)불만인, 반항적인
maldistribution : n, 부적정 배치(배급)
Maldive : n, 스리랑카 남서의 회교 공화국
Maldives : 몰디브 (공화국)(인도양의 회교국, 수도 Male), 
male : n, a, 남성의, 수컷의, (opp, female)
Male : n, 말레 (Maldives의 수도)
male : x, (연결형) 나쁜(ill-)의 뜻
male bonding : x, (반여성, 반여성 해방에 일치된 생각을 가진)남성간의 단결(동료 의식)
male chauvinism : x, 남성 우월(중심)주의
male chauvinist : x, 남성 우월(중심)주의자, ~ piggery (집합적) 남성 우월주의자
male chauvinist pig : x, (경멸적) 남성 우월주의자
maleci acid : x, 말레산
malediction : n, 저주, 악담
maledictory : a, 저주의, 비방의, 욕의
malefaction : n, 나쁜 짓, 범행
malefactor : n, 범인, 악인(opp, benefactor)
male fern : x, 관중(구충제, 유럽산)
malefic : n, 해를 끼치는, 해로운, 흉성
maleficence : n, 유해; 나쁜 일(짓), 악행
maleficent : a, 유해한, 나쁜 짓 하는
male menopause : x, 남성의 갱년기, metapause라고도 함
male screw : x, 수나사
malevolence : n, 악의, 악심
malevolent : a, 악의 있는, 심술궂은
malfeasance : n, 불법(부정) 행위 (특히 공무원의), 나쁜 짓
malfeasant : n, 불법의, 나쁜 짓 하는, 	불법 행위자, 범죄자
malformation : n, 불구, 기형
malformed : a, 볼꼴사나운, 기형의
malfunction : vi, n, 고장나다, 기능부전을 일으키다, ... 기능부전, 고장
Mali : n, 아프리카 서부의 공화국
malic : a, 사과의
malic acid : x, (화) 사과산
malice : n, 악의, 해칠 마음, (법) 범의, ~ AFORETHOUGHT (PREPENSE)
malice aforethought(prepense) : x, (미리 계획된) 살의
malicious : a, 악의 있는, 속 검은
malicious mischief : x, 고의의 기물파괴
malign : a, vt, 유해한, 악성(악질)의(opp, benign), 악의 있는, ... 헐뜯다, 중상하다
malignance : n, 악(적)의, (병의) 악성
malignancy : n, 앙심, 적의, 격렬한 증오, (병의)악성, 불길, 흉
malignant : a, n, 유해한, 악성의, 악의를 품은, ... (영사) Charles I 시대의 왕당원
malignant melanoma : x, 악성 흑색종
malignity : n, 악의, 원한, 악성
malignly : ad, 해롭게; 악의로
malign neglect : x, 악의 있는(태만적) 무시
malihini : n, (하와이)신참자, 타관 사람
malines : n, 말린(벨기에산의 뻣뻣하고 얇은 비단 망사)
malinger : vi, (특히 병사 하인 등이) 꾀병을 부리다
malingery : n, 꾀병(특히 병사의)
malism : n, 현세 사악 우세설
malison : n, 저주
mall : n, 나무 그늘진 산책길, (the M, ) 런던의 St, James's Park의 산책길, 펠멜 구기, 펠멜용의 망치
mallard : n, 물오리, 물오리 고기
Mallarme : n, Stephane (1842~1898) 프랑스의 시인
malleability : n, 전성, 순응성
malleable : a, (금속이) 전성이 있는, 순응성이 있는
mallee : n, 유칼리 나무(남오스트레일리아산)
malleolus : n, 복사뼈
mallet : n, 나무메, (croquet 나 polo의) 공치는 방망이
malleus : n, (중이의) 추골
mallow : n, (식) 당아욱 속
malm : n, 부드러운 백악암, 백악토;백악 벽돌
Malmaison : n, 카네이션의 일종
malmsey : n, 흰 포도주의 일종(Madeira 산, 달고 독함)
malnourished : a, 영양 부족(실조)의, a ~ infant 영양 실조아
malnutrition : n, 영양 불량(실조)
malocclusion : n, 부정 교합
malodor : n, 악취, 고약한 냄새
malodorant : a, n, 악취나는(물건)
malodorous : a, 악취나는
malolactic : a, (과실주의) 말산이 유산으로 변하는
Malory : n, 맬러리 Sie Thomas ~ (1408-71) (영국의 작가)
malpighian tube : x, (생) 말피기관
malposition : n, 위치가 나쁨, (태아의) 변위
malpractice : n, (의사의) 부당치료, 직책상의 비행
malpractice insurance : x, 의료 과오 보험(의사, 병원이 의료 과오 소송에 대비한)
malpractice suit : 의료 과오 소송(환자가 의사, 병원을 상대오 내는 배상 소송), 
malpractitioner : n , 배임(위법, 부정) 행위자; 부정 요법 시행자
Malraux : n, Andre(1901~ ) 프랑스의 소설가, 정치가
malt : n, vt, vi, 맥아, 엿기름... 엿기름을 만들다, 엿기름이 되다
Malta : n, 몰타 (지중해 중앙부의 섬 및 공화국, 섬은 Maltese Island 라고도 함)
Malta fever : x, 몰타열(몰타섬 부근의 유행성 간헐열)
maltase : n, 말타아제 (맥아당을 포도당으로 분해하는 효소)
malted milk : x, 맥아 분유(분유, 맥아, 향료를 섞어 만든 분유)
maltese : a, n, 몰타(섬)의, 몰타 사람(의), 몰타말(의)
maltese cross : x, 몰타 십자 (네가닥의 길이가 같음)
Maltese dog : x, 몰타섬 토종의 애완용 개(spaniel의 일종)
maltha : n, 말사(아스팔트의 일종)
malthouse : n, 맥아 제조소 (저장소)
Malthus : n, Thomas Robert(1766, 1834) 영국의 경제학자, 인구론자
Malthusian : a, n, 맬서스 주의의, 맬서스 주의자
malthusianism : n, 맬서스주의
malting : n, 맥아 제조(법)
malt liquor : x, 맥주, 스타우트류
malt liquor : x, 맥아를 발효시켜서 만든 술(ale, beer등)
maltose : n, (화) 맥아당
maltreat : vt, 학대하다
maltster : n, 맥아 제조(판매인), 엿기름 만드는 사람
maltwoem : n, 술꾼, 주호
malty : a, 엿기름의(같은), 술을 좋아하는
malvaceous : a, 당아욱과의
malversation : n, 독직
malvoisie : n, 맘지 포도
malwa : n, 말와(수수, 잡곡으로 양조한 우간다의 음료)
mam : n, (영구, 아) = mama
mama : n, 엄마= MAMA
mama's boy : x, (미) 여성적인 사나이, 나약한 남자
mamba : n, 맘바(남아프리카산 코브라과의 큰 독사)
mambo : n, 맘보(4/4박자 춤), 그 곡
mamelon : n, 유방(종) 모양의 산
mameluke : n, 노예(회교국의), 중세 이집트의 노예 기병
Mamie : n, 여자 이름(Mary의 애칭)
mamma : n, 엄마
mamma : n, (포유 동물의) 유방
mammae : pl, 포유동물의 유방
mammal : n, 포유동물
mammalia : n, 포유류
mammalian : n, a, 포유류의(동물)
mammaliferous : a, (지층이) 포유 동물의 화석을 포함한
mammalogy : n, 포유 동물학 -gist
mammary : a, 유방의, the ~ gland 젖샘
mammary gland : x, 유선
mammee : n, 물레나물과의 교목(열대 아메리카산); 그 열매
mammiferous : a, 유방이 있는, MAMMALIAN
mammiform : a, 유방(젖꼭지) 모양의
mammilla : n, 젖꼭지 (같은 돌기)
mammock : vt, 조각, 단편, 토막내다, 분쇄하다
mammogram : n, 유방 X선 사진
mammography : n, 유방 뢴트겐선 조영법(유방의 검사등에 쓰임)
mammon : n, (악덕으로서의) 부, 배금(마태복음 6 24)
mammonism : n, 배금주의
mammoplasty : n, 유방 정형 수술
mammoth : n, a, 매머드, ... 거대한
mammy : n, = MAMMA (미남부) (아이보는), 흑인 할멈, 늙은 흑인 식모
mammy chair : 보트에 손님을 실어 올리고 내리는 광주리(의자)x, 
mammy cloth : x, (아프리카 흑인이 몸에 감는) 알록달록한 무명
mammy trader : x, (서아프리카의) 시장에서 장사하는 여자
mammy wagon(lorry, bus) : x, (서아프리카의 사람, 짐 운반용) 소형 버스(트럭)
mampara : n, 바보, 무능한 사람, (솜씨가) 무딘 흑인
man : n, (pl, men) 인간, 사람(이라는 것), 남자, 남편, 사내다운 남자, 하인(opp, master), 부하, 직공, 인부, (pl, )졸병(opp, officer), 어이, 여보게
man : n, (the or one's ~ )적격자, 상대, (체스의) 말, as one ~ 이구동성으로, be a ~, or play the ~ 사내답게 행동하다, be one's own ~ 독립하고 있다, 남의 지배를 안받다
man : n, between ~ and ~ 사내들 사이에, 남자대 남자로서, ~ about town 사교계의 활량, ~ and wife 부부, ~ of letters 문인, ~of the world 세상 물정에 밝은 사람, 속물영감
man : n, vt, the ~ in the street (전문가에 대한) 세상의 일반 사람, ~ to a ~, or to the last ~ 모조리, 마지막 한 사람까지, ...사람을 배치하다, 태우다, 격려하다
manacle : n, vt, (보통 pl, ) 쇠고랑, 속박, ...고랑을 채우다
manage : vt, (도구 따위를 손으로) 다루다, 조종하다, (말을) 어겨하다, 조교하다, (업무를)취급하다, 처리하다, (사업를)경영하다, 관리하다, 먹다, 이럭 저럭 해서 ...하다
manage : vt, vi, (He ~ d to make a mess of it, 엉망으로 만들어 버렸다), ... 처리하다, 헤쳐나가다
manageability : n, 다루기 쉬움
manageable : a, 다루기 쉬운, 통제하기 쉬운
managed currency : x, 관리 통화
managed news : x, (정부 가정에 맞게 내용을 조작한) 정부 발표 뉴스
management : n, 취급, 관리, 경영, 경영자측, 술책
management accounting : x, 원가 계산
management engineering : x, 경영(관리)공학
management information system : x, 경영 정보 시스템
managementlabor : a, 노사의, ~ dispute 노사 분쟁
managementlevel : a, 관리직(급)의
management science : x, 경영 과학, 관리 공학
management shares : x, (주로 영)임원주
management training exercise : x, 경영자 훈련
management training program : x, 관리자 훈련 계획
managenentlabor relations : x, 노사 관계
manager : n, 지배인, 경영자, 수완가, 관리인, 처리자, (영국 양원의) 교섭 위원, good ~ 살림을 잘 꾸려가는 주부, 경영을 잘 하는 사람, 두름성 좋은 사람
manageress : n, 여자 지배인; 여간사; 여자 흥행주
managerial : a, 취급(조종, 경영)의, 관리(지배)의, 감독의, 처리의
managerialist : n, 관리 정책 신봉자, 통제주의자
managership : n, MANAGER의 직위(지위, 임기)
managing : a, 처리하는, 관리하는, 잘꾸려 나가는, 간섭 잘하는, 인색한
managing director : x, (영) 전무(상무) 이사
managing editor : x, (신문사, 출판사 등의) 편집장, 편집 주간, 편집 국장
Managua : n, 마나과(Nicaragua의 수도), (Lake ~) 마나과호
manakin : n, 마나킨 새(중, 남미산)
Manama : n, 마나마(Bahrain의 수도)
Manaslu : n, 히말라야산계 제 8 위의 고봉
manatarms : n, (pl, men, at, arms) 중세의 병사
manatee : n, 해우
manavelins, -il- : n, 찌끼(특히 음식물의)
mancaused : a, 인위적인
Manchester : n, 영국서부의 도시, (견직물, 무역의 중심)
Manchester school : x, 맨체스터학파 (1830년대에 자유무역주의를 주장한)
Manchester terrier : x, 테리어종의 애완견
manchet : n, 빵의 일종
manchild : n, 남자 아이, 아들
manchineel : n, 대극과의 나무(열대 아메리카산)
Manchu : n, a, 만주의, 만주사람의, 만주말의
Manchuria : n, 만주
manchurian : n, a, 만주사람, 만주의
manciple : n, 식료품 구입 담당자, 조달인(대학, 수도원 등의)
mand : n, 맨드(듣는 이에게 어떤 행동을 취하게 하는 말, 명령 등)
mandala : n, 만다라
mandamus : n, (옛날의) 칙서
mandarin : n, 중국의 관리, (중국 옷 차림의) 머리 흔드는 인형
Mandarin : n, 중국 관화, (귤빛이 중국 관리의 옷 빛깔과 비슷했던데서) 중국 귤, 귤빛의 물감
mandarinate : n, (집합적) 중국 관료
mandarin collar : x, 만다린 칼라(폭이 좁고 곧추 선 옷깃의 총칭)
mandarin duck : x, 원앙새
mandatary : n, 수탁자, 수탁국, 위임 통치국
mandate : n, 명령, 훈령, 위임, 위임 통치령, (교황으로 부터의) 성직 수임 명령, (선거 구민이 의원에게 내는)요구
mandate : vt, 위임 통치령으로 하다
mandator : n, 명령자, 위임자
mandatory : a, n, 명령의, 위임의, ...= MANDATARY
mandatory retirement system : x, 정년제
manday : n, 인일 (한 사람이 하루에 하는 일의 양), 연...일
mandible : n, (포유 동물, 물고기의) 아래턱(뼈), 새의 부리
mandola : n, 만돌라(대형 만돌린)
mandoline : n, (악) 만돌린
mandolinist : n, 만돌린 주자
mandragora : n, (식) 맨드레이크(MANDRAKE)
mandrake : n, 흰 독말풀(그 뿌리는 마약제)
mandrel : n, 곡괭이, (주조용)섬쇠, 심축
mandril : n, 곡괭이, (주조용)섬쇠, 심축
mandrill : n, 아프리카 산의 큰 비비
manducate : vt, 씹다, 먹다
mane : n, 갈기
maneater : n, 식인 동물, 식인종
manege : n, 마술 연습소, 마술
manerting : a, 사람을 잡아 먹는
manes : n, pl, (고대 로마의) 조상(죽은이)의 영혼
Manet : n, 마네(1832-83)(프랑스의 인상파 화가)
maneuver : n, vt, vi, 전략적 행동, 기동 연습, 책략, 책동, ...연습하다, 술책을 부리다, ... 군대를 움직이다, 책략으로 움직이다(away, into, out df)
maneuverability : n, 기동성
maneuverable : a, 조종(운용, 기동) 할 수 있는
Maneuverable Reentry Vehicle : x, 기동식 핵탄두
man Friday : x, 충복
man Friday : x, (Robinson Crusoe의 충실한 하인의 이름에서) 충실한 하인, 심복, 부하
manful : a, 남자다운, 용감한
manganate : n, 망간산염
manganese : n, (화) 망간
manganese nodule : x, (심해레 부존하는) 망간 단괴
manganic : a, 망간의(을 포함한)
mange : n, (개, 소의) 옴
mangel : n, 근대의 일종(사료용)
mangelwurzel : n, 근대의 일종(사료용)
manger : n, 여물통, 구유, dog in the ~ (버릴 것이라도 남은 못쓰게 하는) 짓궂은 사람
manger board : x, 이물의 물막이 판자
mangily : ad, 옴에 걸려, 옴투성이로, 지저분하게, 더럽게
mangle : 자르다, 형편없이 만들다
mangle : n, vt, 세탁 마무리용의 압착 롤러(로 다리다)
mangler : N, MANGLE 하는 사람, 고기 써는 기구
mango : n, (식) 망고 (열매)
mangod : n, 신인
mangold(-wurzel) : n, =MANGEL(-WURZEL)
mangonel : n, 투석기
mangosteen : n, (식) 망고스틴 (열매)
mangrove : n, (식) 맨그로브(열대수)
mangy : a, 옴이 오른, 더러운
manhandle : vt, 인력으로 움직이다, 거칠게 다루다
manhater : n, 사람을 싫어 하는 사람, 남자를 싫어 하는 사람
Manhattan : n, 맨해턴, 뉴욕 시내의 섬(상업 지구)
Manhattan cocktail : x, 맨하탄(칵테일의 일종, 위스키와 베르뭇의 혼합주에 체리를 띄움)
Manhattan District : x, 원자력 연구소의 미육군 통합 기관(1942~1947)
Manhattanize : vt, (도시를) 고층화 하다
Manhattan Project : x, 맨해튼 계획(제2차 대전 중 미국 육군의 원자탄 개발 계획의 암호)
manhole : n, 맨홀(하수도, 도랑 따위에 사람이 드나들도록 만든 구멍)
manhole cover : (핫케이크, 레코드판등처럼) 원반형의 납작한 것, 
manhood : n, 인간임, 남자임, 성년, 남자다움, 인격, (한나라의) 성년 남자 전체, 남성기
manhood suffrage : x, 성년 남자 선거권
manhour : n, 인시(한 사람의 한 시간 작업량), 연...시간
manhunt : n, 범인수사
mania : n, 조병, 열광, ...열, ...광
maniac : a, n, 미친, 미치광이 
maniacal : a, = MANIAC
manic : n, 조병의, 조병 환자
manicdepressive : a, n, (의) 조울증의 (환자)
Manichaean, -che- : n, a, 마니교도(의)
Manichaeism : n, 마니교 (페르시아 사람 마니가 창도한 3, 5 세기의 이원교)
manichee : n, 마니교의 교도
manicure : n, vt, 매니큐어, 매니큐어하다
manicurist : n, 손톱 미용사, 미조술사
manifest : a, vt, n, 명백한, ... 명시하다, (감정을)나타내다, 입증하다, 적하 목록에 기재하다, ...vi, 나타나다, 의견을 발표하다, ~ oneself (유령, 징후가) 나타나다
manifestant : n, 시위, 운동 참가자, 시위자
manifestation : n, 명시, 정견 발표, 표명
manifestative : a, 표명(명시)하는
manifesto : n, 선언(서), 성명서
manifold : a, vt, 다양한, 여러가지의, 다방면의, ...복사를 뜨다
manifolder : n, 복사기, 등사기
manifold paper : x, 복사 용지
manifold writer : x, 복사기
manikin : n, 난쟁이, 인체 해부 모형= MANNEQUIN
manila : n, 마닐라 삼, 마닐라 여송연
Manila : n, 필리핀의 수도
Manila folder : x, 마닐라 폴더(서류철)
Manila hemp : x, 마닐라 삼
Manila paper : x, 마닐라 지(포장지)
Manila rope : x, 마닐라 로프
manioc : n, =CASSAVA
maniple : n, 수대 (천주교 사제가 왼팔에 걸치는) (옛 로마의) 보병 중대(60-120명)
manipulable : a, 다룰 수 있는, 조종(조작)할 수 있는
manipular : n, (옛 로마의)보병 중대의(에 대한), (옛 로마의) 보병 중대 대원
manipulatable : a, 잘 조정할 수 있는, 교묘히 다룰 수 있는
manipulate : vt, 다루다, 조종하다, 교묘히 조종하다, 잔재주를 부리다
manipulation : n, 조작, 속임, 촉진
manipulative : a, 손끝으로 다루는, 교묘하게 다루는, 속임수의
manipulator : n, 조종하는 사람, 속이는 사람
Manitoba : n, 매니토바 주(캐나다 중부의 주)
manitou, -tu : n, (북미 인디언의) 신, 영, 초자연력
man jack : x, 개인(남자)
mankind : n, 인류, 인간, 남성
manlean : a, 남자 홀로의, 여성 교제가 없는
manlike : a, 사람 비슷한, 남성 같은
manlily : ad, 사내답게
manliness : n, 사내다운, 남자 같은
manly : a, 사내다운, 남자 같은
manmachine system : x, 인간 기계계(인간 및 인간이 조작하는 장치, 기계를 구성 요소로 하는 체계), (협의로)인간과 컴퓨터와의 대화 형식에 따라 작업을 진행하는 시스템
manmade : a, 인공의, 인조의, ~ moon (satellite) 인공위성
manminute : n, 인분 (한 사람의 1분간의 작업량), 연...분
manmonth : n, 한 사람의 1개월간 작업량, 인월(작업량의 단위)
Mann : n, Thomas(1875~1955) 독일의 반나치 소설가
manna : n, 만나, (옛날 이스라엘 사람이 황야에서 신으로 부터 받은 음식), 마음의 양식, 맛 좋은 것
manna ash : x, 만나나무(남부유럽, 소아시아산 물푸레나무속, 단 진을 분비함)
manned : a, (우주선 등이) 사람이 탄, 유인의(cf, unmannned)
mannequin : n, 마네킹(걸), 모델 인형
manner : n, 방법, 방식, 태도, (pl, )예절, 풍습, 생활 양식, (문학, 미술의)양식, 작풍, 종류, all ~ of 모든 종류의, have no ~s 예의 범절을 모르다, in a ~ 얼마간, 다소
mannered : a, 틀에 박힌, 버릇이 있는
mannerism : n, 매너리즘 (문제나 태도 말투 따위가 틀에 박힌 것), 버릇
mannerist : n, 틀에 박힌 사람
manneristic : a, 독특한 버릇이 있는, 매너리즘의, 습관적인
mannerless : a, 버릇 없는
mannerly : a, 예절바른, 정중한
Mannet : n, Edouard (1832~1883) 프랑스 화가, 인상파의 비조
mannikin : n, = MANIKIN
mannish : a, (여자가) 남자 같은
mano'war bird(hawk) : x, 군함새, (frigate bird)(열대산)
manoeuvre : v, n, 책동, 전략적 행동, 기동 연습
manofallwork : n, (가정에 고용되어) 잡일 하는 사람, 잡역부
manofwar : n, 군함
manometer : n, 압력계, 기압계(유체의 압력 측정기의 총칭)
manometric : a, 압력계로 잰
manonman : a, (미, 캐나다) 상대방 선수를 1대1로 마크하는
manor : n, 장원, 영지
manor house : x, 장원 영주(lord of the manor)의 저택
manorial : a, 장원의
manostat : n, (압력차를 이용한) 가스 정류장 장치
manpack : a, 혼자서 나를 수 있는, 휴대용의, a ~ color TV set 휴대용 컬러 텔레비젼 세트
manportable : a, (특히 병기 등이) 한 사람으로 운반 (이동) 가능한
man power : x, 인적 자원, 인력
man power : x, 인력(공률의 단위로 1/10마력)
manpower : n, (육체 노동에 의한) 인력 유효 총인원, 인적 자원
manque : ㅁ, (명사 뒤에 붙여) 되다 만, 덜된
manrad : n, 인 라드(방사선 흡수량의 단위, 1인당 1 rad의 방사선량)
manrate : vt, (로켓, 우주선을) 유인 비행에 안전하다고 증명하다
manrope : n, (현문, 사다리 등의) 손잡이 밧줄
mansard : n, 2단 경사 지붕
manse : n, 목사관
manservant : n, (pl, menservants) 하인, 복종
mansfield : n, Katherine(1888~1923) 영국의 여류 단편 소설가
manshift : n, (교대 시간에서 다음 교대까지의 작업량) 한 사람의 일의 양
mansion : n, 대저택, 성수
mansion house : x, = MANOR HOUSE 런던 시장의 관저
mansize(d) : a, 어른용의, 대형의, 큰, (일이)힘드는, 어른이 필요한
manslaughter : n, 살인죄, (법) 고살죄
manslayer : n, 살인자
mansuetude : n, 유순, 온순(gentleness)
manta : (스페인 중남미에서 쓰이는) 외투, 어깨걸이, (짐, 말등에 덮는) 투박한 캔버스 천, 쥐가오리(devifish)n, 
mantailored : a, (여성복이)남성복식으로 만들어진
manteau : n, 망토, 외투
mantel : n, 벽로의 장식, 벽로 선반
mantelboard : n, 벽난로 장식 선반(위에 댄 나무판)
mantelet : n, 짧은 망토, 휴대용 탄환 막이(방패)
mantelpiece : n, 벽로의 장식
mantelshelf : n, (pl, mantel shelves) 벽로 선반
manteltree : n, 벽난로 아궁이의 상인방
mantes : pl, 사마귀, 버마 재비
mantic : a  , 예언의, 예언적인, 점의
mantic : n, 점술
mantilla : n, 만틸라 (스페인 여자 등의 머리를 덮는 베일), 케이프
mantis : n, 사마귀, 버마 재비
mantissa : n, 가수
mantle : n, vt, 망토, 여자의 소매 없는 외투, 덮개, (가스등의) 맨틀, 덮다
mantle plume : x, 맨틀 융기(지구의 맨틀에서 지표로 분출된 원통형의 용암)
mantlerock : n, 지표의 피복 암층, (토양체의) 표토
mantlet : N, MANTELET
mantoman : a, 솔직한, 개방적인, ~ defense 맨투맨 방어 (농구 등의 1대 1의 방어)
mantoux test : x, 망투 반응 (결핵이나 감염의 검사용)
mantra : n, (불교, 힌두교의) 기도, 진언, 주문
mantrap : n, 사람잡는 함정(영내 침입자를 잡기 위한), 사람에게 위험한 장소, 유혹의 장소(도박장 등), 요부
mantua : n, (17-18세기 경 유행한) 헐거운 여성용 가운
mantuamaker : n, 드레스 메이커, 양재사
manual : a, 손의, 손으로 만든, 편람, 안내서
manual alphabet : x, (벙어리가 쓰는) 수화 문자
manual labour : x, 손일, 근육 노동
manual training : x, 공작(과)
manual worker : x, 근육노동자
manucode : n, 극락조
manufactory : vt, 제조소, 제조 공장
manufactural : a, 제조업(의)
manufacture : vt, 제조하다, (문예 작품을) 남작하다, 날조하다
manufacture : n, 제작, 제조업, 제품
manufactured gas : x, (천연 가스에 대하여) 제조 (도시) 가스
manufacturer : n, 제조업자, 생산자, 공장주
manufacturing : n, a, 제조(업)의, 제조(업에 종사) 하는
manumission : n, 노예 해방, 해방 증명서
manumit : vt, (노예나 농노를) 해방 하다
manumotive : a, 손으로 운전하는, 수동의
manure : n, vt, 비료(를 주다)
manus : n, (척추 동물의)앞발, 손, (로마) 부권, 재산 소유권, 선서(자)
manuscript : a, n, 손으로 쓴, 필사한, (인쇄용) 원고
manward : ad, 인간을 향해서, 인간에 대해
manward : a, 인간에게로 향해진
manwatching : n, 인간 행동학, 인간 행동의 관찰
manweek : 인주(1인당 1주간의 작업량)n, 
manwise : ad, 인간적으로, 남자답게
Manx : a, n, Man (the Isle of Man) 의, 맨 섬 사람
Manx cat : x, (맨 섬산의) 꼬리 없는 고양이
Manxman : n, Man 섬 사람(남자)
many : a, (more, most) (수)많은, a good ~ 꽤(가) 많이(많은), a great ~ 많은, as ~ 같은 수, how ~ ? 얼마 ?, 몇개 ? ~ times or ~ a time 몇번이고
many : n, pron, 다수
manyear : n, 한 사람의 1 년간 작업량
manyheaded : a, 다두의
manyplies : n, (보통 단수 취급) 중판위 (반추 동물의 셋째 위)
manysided : a, 다변의, 다방면의
manyvalued : a, 다가의
manzanilla : n, 만자니야(스페인산의 신 셰리주)
manzanita : n, 철쭉과의 상록, 관목(미국 서부산)
Maoism : n, 모택동주의
maoist : n, a, 모택동주의자(의)
Maoize : vt, ...을 모택동의 영향하네 두다, 모택동주의로 전향시키다
Mao jacket : x, 중국의 인민복
maori : n, a, 마오리 사람(New Zealand 원주민)(말)(의)
Maoriland : a, 마오리 사람의
maotai : n, 마오타이주(밀과 수수를 원료로 한 독한 중국의 증류주)
Maothink : n, 모택동 사상
Mao Tsetung : x, (1893~1976) 마오쩌둥(중공의 전 주석)
Mao Zedong : n, 모택동(1893-1976) (중화 인민 공화국 주석(1949-59), 중국 공산당 주석(1945-76))
map : n, 지도
map : vt, 지도를 만들다, off the ~ 문제 안되는, ~ out 자세히 계획하다
maple : n, (식) 단풍 (나무)
maple leaf : x, 단풍잎 (캐나다의 표장)
maple sugar : x, 단풍당
maple syrup : x, 단풍 시럽
mapmaker : n, 
mapper : n, 제도자
mapping : n, 지도 제작, 사상, 함수
mapreader : n, 지도를 볼 줄 아는 사람
Maputo : n, 마푸토
maquette : n, (조각, 건축용의)작은 모형
maquillage : n, (메이크업용) 화장품
maquis : n, sing, & pl, (코르시카의) 악한, (M, ) 마키 (2차 대전때 반독 유격대(원))
maquisard : n, 마키 대원
MAR : n, (<memory address register) (컴퓨터) 번지 레지스터
mar : vt, 손상시키다, 흠내다, 망쳐놓다
marabou : n, 황새의 일종(서 아프리카산), 그 깃털
marabout : n, (회교의) 수도사, 은사, 그 무덤
maraca : n, 마라카스 (흔들어 소리내는 리듬 악기, 보통 양손에 하나씩 가지기 때문에 복수형으로 씀)
maraging steel : x, 마레이징강 (강도 높은 강철의 일종)
marasca (cherry) : x, 야생 버찌
maraschino : n, 마라스키노 술(일종으이 리큐르 주)
maraschino cherry : x, maraschino를 가미한 앵두
marasmic : a, 쇠약(소모)성의
marasmus : n, (전신의) 쇠약, 소모(증)
Marathon : n, Athens 북동방의 옛 싸움터
marathon race : n, 마라톤, 마라톤 경주
maraud : vt, 약탈하다
marauder : n, 약탈자
maravedi : n, 스페인의 옛 금화(동화)(11-12세기), not worth a ~ 한 푼의 가치도 없는
marble : n, 대리석, 조각, 공기돌, heart of ~ 냉혹(무정)한 마음
marble : vt, 대리석 무늬를 넣다 (책 가장자리 따위에)
marble cake : x, 대리석 무늬의 카스텔라
marbled : a, 대리석 무늬의
marbleedged : a, (제본) 책 가장자리 면을 대리석 무늬로 한
marblehearted : a, 무정한, 냉혹한
marbling : n, 대리석 무늬의 착색, 마블 염색, (책 마구리, 종이, 비누 등의)대리석 무늬, (식육의) 차돌박이
marbly : a, 대리석의(같은), 대리석질의, 굳은, 냉담한, 냉정한
Marburg disease : x, 마르부르크병(고열, 출혈 동반)
marc : n, (포도 등의) 짜낸 찌꺼기, 그것으로 만든 브랜디
MARC : n, 마크, 기계 가독 목록(컴퓨터 처리가 가능토록 한 출판물 데이터 베이스)
marcasite : n, 백철광
marcel : n, 마르셀식 웨이브(로 하다), (머리카락의) 물결 모양의 웨이브 n, vt
March : n, 3월 (생략 Mar, )
marcella : n, 마르셀라 (무늬있는 무명(삼베)), M~ 여자 이름
marcescent : a, (식물의 어떤 부분이) 지지않고 시드는, 조위하는
march : n, 행진, 행군, (악) 행진곡, 사건의 진전, 데모 행진, dead (funeral) ~ 장송 행진곡, double ~ 구보, ~past 분열식, steal a ~ on (upon) ...을 지르다, 기습하다
march : vi, vt, 행진하다(시키다), 진전하다, 끌고 가다, ~ing order 군장, ~ ing orders 출발 명령, ~ off 출발하다, ~ on ...에 밀려 돌다, ~ past 분열 행진하다
march : n, 국경지대, 경계
marcher : n, 행진하는 사람
marcher : n, 국경 지대 거주자, 변경 주민, (잉글랜드의) 국경 관할관, 변경 지방 영주
marching orders : x, 행군(진격) 명령, (영) 해고 통지
marchioness : n, 후작 부인(cf, marquis)
marchland : n, 국경 지대, 변경 지방
marchpane : n, 감복숭아 사탕 (marzipan)
marchpast : n, 분열 행진, 분열식, 퍼레이드
marconi : n, 무선 전선을 치다
Marconi : n, Guglielmo(1874~1937) 이탈리아의 무선 전신 발명자
marconigram : n, 마르코니식 무선 전신
marconigraph : n, (마르코니식) 무선 전신기
Marcos : n, 마르코스 Ferdinand(Edralin) ~ (1917-89) (필리핀 대통령(1965-86))
marc tapes : x, 마크 테이프(컴퓨터에 직접 넣을 수 있는 카탈로그 테이프)
Marcus : n, 남자 이름
Marcus Aurelius : n, 마르쿠스 아우렐리우스(121-180)(로마 황제로서 스토아 철학자)
Mardi Gras : x, (육식하는 화요일의 뜻에서) 참회 화요일(Shrove Tuesday)(사육제의 마지막 날)
mare : n, 바다, (화성, 달 표면의 어두운 부분)
mare : n, 암말, (완전 성장한 말, 나귀 등의)암컷
mare's nest : x, (대발견 처럼 보이지만) 별 게 아닌 것(물건), 실망거리
mare's tail : x, 쇠뜨기말, 말꼬리 구름
mare clarsum : x, 영해
mare liberum : x, 공해
maremma : n, 건강에 해로운 해안 습지(이탈리아 서부 등의)
marengo : a, 마렝고풍의 (기름에 튀긴 버섯, 토마토, 올리브유, 포도주 등으로 만든 소스로 버무린)
Mare Tranquillitatis : n, 고요의 바다
Marfery : n, 여자 이름
marg : n, 마가린 (margarine)
margaric : a, 진주의, 진주 같은
margaric acid : x, 마르가르산
margarine : n, 마가린 (인조 버터)
margarita : n, 마르가리타(테킬라 술과 레몬즙 칵테일)
margarite : n, 진주 운모, (유리질 화성암의) 쇄상 정자, 마가라이트
margay : n, 범고양이 (남미산)
margin : vt, 가장자리, 변두리, 한계, 난외, 여지, 여유, 판매 수익, 이문, (주식의) 증거금n
margin : vt, 방주를 털다, 증거금을 걸다, go near the ~(도덕상의) 불장난을 하다
margin account : x, 증거금 계정(신용 거래 구좌)
marginal : a, 언저리의, 가의, 한계에 가까운, 난외의
marginalia : n, pl, 방주, 난외에 써넣기
marginal land : x, (불모에 가까운) 메마른 경작지
marginal man : x, (사) (두 문화의) 경계인
marginal notes : x, 방주
marginal sea : x, 영해
marginal utility : x, 한계 효용
marguerite : n, 마거리트 (데이지의 일종)
Marianne : n, 프랑스의 속칭(의인화, cf, John Bull)
mariculture : n, 해양 생물 양식
marigold : n, 금잔화
marihuana : n, 삼(인도산), 마리화나 (그 잎과 꽃에서 뽑은 마약, 담배로 피움)
marimba : n, 목금의 일종
marina : n, (해안의) 산책길, (요트, 모터보트의) 정박소
marinade : n, 마리네드 (와인, 초, 기름, 약초 및 향미료를 섞은 양념 국물), 마리네드에 담근 생선(고기)
marinara : m, a, 마리나라(토마토, 마늘, 향신료로 만든 이탈리아 소스), 마리나라를 친
marinate : vt, 마리네드에 담그다
marine : a, 바다의, 바다에 사는, 해운의, 선박용의
marine : n, (일국의) 선박, 함대, (the Marines) (미) 해병대, the mercantile ~ 상선대, 해운력, Tell that to the (horse) ~s, (구) 거짓말도 작작 해라
marine belt : x, 영해(territorial waters)
marine biology : x, 해양 생물학
Marine Corps : x, (미) 해병대
marine court : x, 해사 심판소
marine ecology : x, 해양 생태학
marine engineer : x, 조선 기사, 선박 기관사
marine engineering : x, 선박 공학
marine geology : x, 해양 지질학
marine insurance : x, 해상 보험
marine law : x, 해상법
marine look : x, 머린 루크(세일러복처럼 바다와 관련된 복장)
marine meteorology : x, 해양 기상학
marine physics : x, 해양 물리학
marine policy : x, 해상 보험 증권
marine products : x, 해산물
mariner : n, 선원, 수부, (M), 화성, 금성 탐사용의 우주선
mariner's compass : x, 나침반
marine science : x, 해양 과학
marine snow : x, 바다눈(바다 밑에 플랑크톤의 시체가 눈처럼 침전하는 현상)
marine store : x, 선박용 물자, 중고 선구(상)
marine stores : x, 낡은 선구류
marine technology : x, 해양 공학 (기술)
Mariolatry : n, 성모 마리아에 대한 신앙, 성모 예배
Marion : n, 여자 이름, 남자 이름
marionette : n, 꼭두각시
Mariposa lily(tulip) : x, 나비나리(나리과 식물)
Marisat : n, (미) 해사 통신 위성 (미해군, 민간 공용)
marish : n, a, (의)
marital : a, 남편의, 혼인의, 부부간의
maritime : a, 바다의, 해변의, 바다에 사는
maritime climate : x, 해양(성) 기후
Maritime Provinces : n, (캐나다) 연해주
Marius : n, 마리우스 (로마의 장군, 집정관)
marjoram : n, 마요라나(조미료에 씀)
mark : n, 과녁, 목표, 표, 자국, 흔적, 표지, 특징, 중요성, 명성, 부호, 기호, (무기, 장비등의) 형, 점수, 주목, 현저, 출발선
mark : vt, vi, below the ~ 표준 이하로, beside the ~ 과녁에서 빗나간, 적절치 않은, get off the ~ (주자가) 스타트하다, (God) save (bless) the ~ 어이쿠 실례했오
mark : n, good ~ 선행점, hit the ~ 적중하다, make one's ~ 저명해지다, man of ~ 명사, miss the ~적중하지 않다, On your ~s 제자리에, toe the ~ 발가락을 출발점에 대다
mark : vt, 표를 하다, 흔적을 남기다, 드러나게 하다, 점수를 메기다, 정찰을 붙히다, (어떤 목적, 운명을 위해) 골라내다, 운명지우다, 명시하다, 주시하다, 다, ~ out 구획하다
Mark : n, 마가복음
mark : n, 마르크, 독일의 화폐단위
markdown : n, (값의) 인하, 인하액
marked : a, 기호가 붙은, 현저한, 눈에 띄는, 저명한
markedly : ad, 현저하게, 눈에 띄게
markedup : a, 가격을 올린
marker : n, (게임의) 득점 기록원(장치), 서표, 묘비, 이정표, 조명탄
marker crude : x, 기준 원유
marker price : x, 기준 가격
market : n, 장, 저자, 시장, 시장에 모인 사람들, 판로, 수요, 팔리는 곳, 거래선, 시가, 상황, 상기
market : n, be in~ 매매 되고 있다, be in the ~ 매물로 나와 있다, black ~ 암시장, bring one's eggs(hogs) to a bad (the wrong) ~ 예상이 어긋나다
market : n, corner the ~ 시장을 매점하다, 증권(상품)을 매점하여 등귀시키다, hold the ~ 시장을 좌우하다, lose one's ~ 매매의 기회를 잃다, make a ~ of ...을 이용하다
market : vt, vi, 시장에서 매매하다, 물건을 시장에서 팔다
marketability : n, 시장성
marketable : a, 시장에서 팔 수 있는, 팔리는, 판로가 있는, 매매할 수 있는, 시장성이 높은
marketable : a, 팔릴, 판로가 좋은, 시장성이 있는
market analysis : x, 시장 분석
market basket : x, 장바구니, 마켓 바스켓(생계비 변동을 산출하기 위해 지표가 되는 연도를 100으로 한 어떤 연도의 비교 구매 능력)
market boat : x, (어선에서 시장까지의) 어류 수송선, 배에 물자를 공급하는 작은 배
market commentator : x, 시장 소식통
market cross : x, (영) (중세의) 시장에서 세운 십자가
market day : x, 장날
market dive : x, (주식의) 폭락
marketeer : n, 시장 상인, (영)영국의 유럽 공동시장 가입 지지자
marketeer : n, 시장 상인, black ~ 암상인, 잠상
marketer : n, 장보러가는 사람, 시장에서 매매하는 사람(회사), 시장 경영자, 마케팅 담당자
marketer : n, 시장 상인
market garden : x, (시장에 내기 위한) 야채 재배 농원
market gardener : x, 시장에 내기 위한 채원(과수원) 경영자
market gardening : x, 시장 공급용 야채 재배
marketing : n, (시장에서의) 매매, 마케팅(제조에서 판매까지의 전과정)
marketing information system : x, 마케팅 정보 시스템
marketing manager : x, 마케팅 매니저(시장 분석, 제품 계획, 판매 촉진 등의 활동을 통제하는 업무의 담당자
marketing mix : x, 마케팅 믹스(통제 가능한 마케팅 요소를 유기적으로 통합하기)
marketing process : x, 마케팅 프로세스(과정) (마케팅 기회를 확인, 분석, 선택하여 이용하는 경영 관리 과정)
marketing research : x, 시장 조사, 시장 분석
marketing strategy : x, 마케팅 전략
market niche : x, 특정 시장, 한정 시장
market order : x, 현재 시세대로의 매매 주문(지시)
market overt : x, 공개시장
market overt : x, 공개 시장
market place : x, 장터
marketplace : n, 시장, 장터, 경제(상업)계, (지적 활동의) 경제의 장
market potential : x, 시장의 잠재 능력
market price : x, 시장가격
market price : x, 시장 가격, 시가, 시세
market research : x, 시장 조사 (어떤 상품의 수요를 위한 사전 조사)
market research : x, (제품을 매출하기 전의) 시장 조사
marketripe : x, 아직 덜 익은(시장에 나올 때에야 알맞게 익을 정도)
market segmentation : x, 시장 세분화
market share : x, 시장 점유율
market town : x, 장이서는 거리, (중세의) 특허에 의해 장이 서는 읍(시)
market town : x, 시장 설치 시, 장이 서는 읍
market value : x, 시장 가격
market value GNP : x, 시가 기준의 국민 총생산
markhor : n, 야생 염소 (히말라야 지방산)
marking : n, 표(하기), 점, (새의 깃이나 짐승 가죽의) 반문
marking gauge : x, 줄치는 자막대기
marking ink : x, (의류용) 불변색 잉크
marking iron : x, 낙인, 화인
marking pen : x, 마킹펜(사인펜의 일종)
markka : x, 마르카(Finland의 화폐 단위, 기호)
Markov(Markoff) chain : x, 마르코프 연쇄
marksman : n, 명사수, 저격병
marksmanship : n, 사격술
mark tooth : x, 말의 앞니(나이를 나타내는 오목한 자국이 있음)
Mark Twain : x, = Twain
Mark Twain : n, 마크 트웨인(1835-1910)(미국의 작가;Samuel L.Clemens 의 필명)
markup : x, 가격 인상, (상) 이윤, (인) 조판 지시
markup calculator : x, 가산율 계산기(원가에서 판매가를 정하는)
marl : n, 이회토 (비료, 시멘트용)
marlaceous : a, 이회질
Marlborough House : x, London의 영국 왕실 별저
Marlene : n, 여자 이름
marlin : n, 청새치(무리)
marline : n, 가는 밧줄
marline, -lin : n, 밧줄을 감거나 풀어서 이을 때 쓰는 뾰족한 쇠막대
marlite : n, 이회암의 일종
Marlowe : n, Christopher(1564~1593) 영국의 극작가
marlpit : n, 이회토 채굴장
marlstone : n, 이회암
marly : a, 이화암 모양의, 이회질의, 이회암으로 된
marmalade : n, 마멀레이드(오랜지, 레몬 따위의 쨈)
MARMAP : n, 해양 생물 자원 조사(계획)
marmatite : n, 철섬 아연광
Marmes man : x, 마미스 원인(1965년 Washington주에서 화석으로 발견, 11, 000년 전의 것으로 추정)
marmite : n, (금속, 도자기의) 큰 요리 냄비, (1인용) 냄비; 이 냄비에 담아 내는 수프
marmolite : n, 백온석
marmoreal : a, 대리석 같은
marmoset : n, 명주 원숭이 (중남미산)
marmot : n, 마멋 (다람쥐의 일종, 모르모트와는 다름), 수영 모자의 일종
marocain : n, 비단 또는 모직 옷감의 일종
maroon : n, a, 밤색, 밤색의, 불고의 일종
maroon : n, 탈주 흑인(의 자손) (서인도 제도 Guiana 산중의 삶), 무인도에 버려진 사람
maroon : vt, 무인도에 버리다, 고립시키다
maroon : vi, 빈둥거리다, 캠프 여행을 하다
marplot : n, 쓸데없이 덥적거려 일을 그르치는 사람, 헤살꾼
marque : n, 나포 면허장 (적선 나포를 위해 개인에게 줌), 보복(적 약탈)
marquee : n, 큰천막, (클럽, 호텔 따위의 정문 보도 위에 친) 텐트, 큰 차양
marquess : n, 후작
marquetry : n, 상감 세공, 쪽매 붙임 세공
marquis : n, 후작 (공작의 아래)
marquisate : n, 후작의 신분, 후작령
marquise : n, 후작부인
marquisette : n, 얇은 천의 일종 (커튼, 모기장 등에 씀)
marquisette : n, 얇은 천의 일종(커튼, 모기장 등에 씀)
marquois scale : x, 평행선을 긋는 기구
marram : n, (해변에 나는 사방용의) 포아풀과의 식물
marram grass : x, 물대(바닷가에 나는)
Marrano : n, 마라노(중세 스페인, 포르투칼에서 박해를 벗어나기 위하여 그리스도 교화된 유대 (무어)인)
marriage : n, 결혼, 결혼 생활, 결혼식, 밀접한 결합, (트럼프의) 같은 패의 King 과 Queen 의 짝맞추기, civil ~(종교 의식에 의하지 않는) 신고 결혼, communal ~ 잡혼
marriageable : a, 혼기에 달한; 결혼할 수 있는; ~ age 혼기, 과년
marriageable : a, 결혼할 수 있는, 혼기가 된
marriageage : a, 혼기
marriage articles : x, 혼인 재산 설정 계약서
marriage bed : x, 신혼 부부가 인연을 맺는 침상; 부부의 결합
marriagebroker : n, 결혼 중매인(특히 보수를 받고 하는)
marriage bureau : x, 결혼 상담소
marriage certificate : x, 결혼 증명서
marriage contract : x, 혼인전 계약
marriage encounter : x, 결혼 대화(몇 쌍의 부부가 모여서 부부간의 문제를 토의하여 부부 관계를 개선 하려는 방법)
marriage guidance : x, 결혼 생활 지도
marriage license : x, 결혼 허가(증)
marriage lines : x, 결혼 증명서
marriage market : x, 결혼 시장(결혼 적령기에 있는 남녀의 수요와 공급)
marriage of convenience : x, 지위, 재산 목적의 결혼, 정략 결혼
marriage penalty : x, 맞벌이 부부에게 불리한 세제
marriage portion : x, 지참금
marriage service : x, (교회에서의) 결혼식
marriage settlement : x, 혼인 재산 계약
marriage tax : 결혼세 (맞벌이 부부에 대한 세제), 
married : a, 결혼한, 부부의
married print : x, 녹음을 끝낸 영화 필름
marron : n, (유럽산의) 달고 큰 품종의 밤
marronglace : n, 마롱글라세 ( 양주와 설탕에 담가 굳게 한 밤)
marronnier : n, 마로니에 (서양 침엽수)
marrow : n, 골수, 정수, to the ~ 뼈속까지, 순수한
marrow bean : x, 강낭콩(알이 굵은)
marrowbone : n, 골수가 든 뼈, (pl, ) 무릎
marrowfat : n, 큰 완두의 일종
marrowy : a, 골수가 있는, 강한; 간결하고 힘찬
marry : vt, ...와 결혼하다, 결혼시키다 (one to another), 굳게 결합시키다
marry : vi, 결혼하다 be married 결혼하(고 있)다, get married 결혼하다, ~ beneath one 지체가 낮은 자와 결혼하다
mars : n, 마르스 (로마 군신) 마르스, 화성
Marsala : n, 마르살라 백포도주(시칠리아 섬의 지명에서)
Marseillaise : n, 라마르세예즈 (프랑스 국가)
Marseilles : n, 마르세이유 (프랑스 지중해안의 항구 도시)
marsella : N, =MARCELLA
marsh : n, 습지, 소택
marshal : n, (프랑스 등의) 육군 원수, 의전관, 사법 비서관, 연방 재판소의 집행관, 경찰서장 , Marshal of the Royal Air Force 공군 원수
marshal : vi, vt, 정렬하다(시키다), (의식을 차리며) 안내하다
marshalling yard : x, 조차장
Marshall Islands : n, 마샬 군도(서태평양의 산호섬; 미국의 신탁 통치령)
Marshall Plan : x, 마샬안 (미 국무장관 마샬안 제안의 유럽 부흥 계획 1947년) (cf, European Recovery Program)
Marshall Plan : x, 마샬 안 (미국 국무장관 G.C.Marshall의 제안에 의한 제2차 대전 후의 유럽 부흥 계획
marsh fever : x, 말라리아
marsh gas : x, 메탄
marsh gas : x, 소기, 메탄
marsh hawk : x, 개구리매
marshmallow : n, 마시맬로(과자)
marshmallow shoes : x, (주로 소녀들이 신는) 두꺼운 바닥의 뒤축 없는 구두
marsh marigold : x, 산동이나 물류
marsh marigold : x, 눈동이 나물
marshy : a, 소택이 많은, 같은
Marsokhod : n, 소련의 화성 표면 탐사차
Marsquake : n, 화성의 지진
marsupial : a, 유대류의, 주머니의, 주머니 모양의
marsupial : n, 유대 동물
marsupium : n, 육아낭(유대 동물의)
mart : n, 시장
martel : n, (무기용) 망치
martello tower : n, (옛날의) 원형의 포탑 (해안 방어용)
marten : n, 담비, 담비의 모피
martensite : n, 마텐자이트 (담금질 강철의 주요 경도 성분)
martial : a, 전쟁의, 무용의, 호전적인, (Martial 군신)
martial art : x, 무도, 무술, 격투기(동양 기원의 태권도, 유도, 쿵후 등)
martial artist : x, 격투기 선수
martialize : vt, 전쟁에 맞게 하다; 분비를 갖추게 하다; 사기를 고무하다
martial law : x, 계엄령
martial rule : x, 군정
martial spirit : x, 사기
martialy : ad, 용감하게
Martian : a, n, 군신의, 화성의, 화성인
martian : n, 화성인
Martianologist : n, 화성 학자
martin : n, 흰털발제비
martinet : n, 규율에 엄격한 사람 (특히 군인, 공무원 등)
martingale : n, (말의) 가슴걸이, (배의) 제 2 사장 (jib boom)을 고정하는 버팀줄, 곱 걸이(걸 때마다 거는 돈을 배로 해감)
martini : n, 마르티니 (진과 베르뭇의 칵테일), dry ~ 싸한 마르티니
Martinique : n, 카리브해에 있는 프랑스령 섬
Martinmas : n, 성마르틴 축일 (11월11일)
martlet : n, 흰털발제비
martyr : n, a, 순교자, ...으로 괴로워하는 사람(to), make a ~ of bonself 순교자연하다, ~ to (gout) (통풍)으로 괴로워하는 사람
martyr : vt, (신앙, 주의, 고집을 이유로) 죽이다, 박해하다
martyrdom : n, 순교, 순사, 고난, 고뇌, 고통
martyrium : n, 순교자 유품 보관소; 순교자 기념 성당
martyrize : vt, 순교자로서 죽이다, 희생시키다, 괴롭히다
martyrize : vi, 순교자가 되다; 순교자연하다
martyrolatry : n, 순교자 숭배
martyrology : n, 순교사(학); 순교자 열전, 순교록
martyry : n, 순교자의 묘소(예배당)
marvel : 경이, 놀라운 것, 경탄n, 
marvell : vi, 경탄하다(at, that), 괴이쩍게 여기다(way, how)
marvelofPeru : n, 분꽃(분꽃과)
marvelous : a, 불가사이한, 놀라운, 괴이쩍은, 훌륭한
marvelously : ad, 불가사이 하게
marvie, marvy : int, 멋있다, 근사하다
Marx : n, Karl (1818~1883) 독일의 사회주의자 (Das Kapital (1867))
Marxian : a, 마르크스(주의)의
Marxism : n, 마르크스주의
Marxism Leninism : n, 마르크스 레닌주의
marxist : n, 마르크스주의자
Mary : n, 성모 마리아, 막달라 마리아(Mary MAGDALENE), 여자 이름, ~ STUART
Mary Jane : x, 마리화나
Maryland : n, 미국 동부의 주( 생략 Md)
Marylebone : n, 런던 중서부의 한 지구(Westminster 구의)
Mary Magdalene : n, 막달라 마리아(그리스도로 인해 회개한 여자)
Marymas : n, 성모 마리아 수태고지 축일(3월 25일)
Mary Stuart : n, 메리 스튜어트(1542-87) (스코틀랜드의 여왕)
Mary Warner : ㅌ, 마리화나(marijuana)
marzipan : n, = MARCHPANE
mascara : n, 마스카라 (눈섭에 칠하는 물감)
mascon : n, 마스콘 (달의 질량 집중 지대)
mascot : n, 마스코트, 행운의 부적, 행운을 가져 오는 사람
masculine : a, 남자의, 남자다운, 남자같은
masculine ending : x, 남성 행말
masculine gender : x, 남성
masculine rhyme : x, 남성운 (disdain, complain 처럼 마지막 음절에 악센트를 둠) (opp, feminine rhyme)
masculinist : n, 남권주의자
masculinity : n, 남성 (어)
masculinize : vt, (암컷 또는 미숙한 동물을) 웅성화하다
mase : vi , 마이크로파를 증폭하다, 분자 증폭기(메이져) 역활을 하다
masefield : n, Jhon(1878~1967) 영국의 시인, 극작가, 소설가
maser : n, (microwave amplification by stimulated emissio of radiation)메이저, 분자 증폭기
Maserati : n, 마세라티(이탈리아 Maserati 회사제의 스포츠카(고급 승용차))
Maseru : n, 마세루(Lesotho의 수도
mash : n, 짓이긴 것, 엿기름물(양조용), 곡분이나 밀기울 따위를 더운물에 갠 사료, 매시, all to a ~ 아주 곤죽이 될 때까지
mash : vt, 으깨어 뭉개다, (엿기름에) 더운 물을 섞다, 반하게 하다
MASH : x, mobile army surgical hospital 육군 이동 외과 병원
masher : n, 매셔 (=potato ~)(감자 등을 으깨는 기구)
masher : n, 난봉꾼
mashie : x, (골프) 매시 (5번 아이언)
mashie iron : ㅌ, (골프) 매시 아이언 (6번 아이언)
mashie mashy : n, (골프) 아이언 5 번
mashie niblick : x, (골프) 아이언 6 번
mash note : x, (짧은) 연애 편지
mash tun(tub) : x, 엿기름 물을 만드는 통
mashy : N, =MASHIE
masjid : n, (광대의 뜻에서) 회교 사원
mask : n, (춤, 연극용의)가면, (방호용)복면, 마스크, (가제의)마스크, 탈, 가장한 사람, 구실, 핑계
mask : vt, ...에게 가면을 씌우다, 차폐하다, (사격 따위를)방해하다
mask : vi, 가면을 쓰다, 변장하다, throw off the ~ 가면을 벗다, 정체를 드러내다
mask ball : x, 가면 무도회 (masked ball)
masked : a, 가면을 쓴, 숨긴
masker : n, 가면(가장) 무도자
masking : n, 가장, 차폐(2음의 진동수의 차, 강도가 크게 다를 때 약한 음이 들리지 않는 현상), 마스킹(천연색 사진의 화학적, 물리적 색채 수정)
masking tape : x, 마스킹(보호) 테이프(그림을 그리거나 도료를 분사할 때 다른 부분을 보호하는 접착 테이프)
mask work : x, 마스크 워크(반도체 칩 표면에 인쇄되는 회로 패턴)
maslin : n, 밀과 호밀로 만든 빵
masochism : n, 피학대 음란증, 마조히즘 (opp, sadism)
mason : n, 석공, 프리메이슨(우애, 공제를 목적으로 한 비밀 결사)(의 일원)
mason : vt, 돌(벽돌)을 쌓다
Mason Dixon line : x, Maryland주와 Pennsylvania주의 경계선(노예 시대의 남북 경계선, 현재는 방언 구분선의 하나)
Masonic : a, 비밀 공제 조합의, 프리메이슨(주의)의, 석공의; 돌 세공의
Masonite : n, 압착한 목질 섬유판(건축 재료; 상표명)
masonite : n, 섬유판의 일종, (M) 그 상표
mason jar : x, (식품용) 보존병
masonry : n, 석공직, 석조 건축, (M) 프리메이슨 조합
masque : n, (16, 17 세기 영국의) 가면극(각본), 가장 무도회
masquerade : n, 가장 무도회, 가장, 구실
masquerade : v, 가장 무도를 하다, 가장하다, 체하다
masquerader : n, 가장 무도자
mass : n, 덩어리, 집단, 다수, 다량(He is a ~ of bruises 전신 상처 투성이다), 태반, 질량 in the ~ 통틀어, the (great) ~ of ...의 대부분, the ~es 대중
mass : vt, vi, 한 덩어리로 하다(되다), 집중시키다(하다)
mass : n, 미사(카톨릭교의 성체 성사), 미사곡 High Mass (분향, 주악이 있는) 대미사
Massachusetts : n, 매사추세츠(미국 북동부의 주)
Massachusetts : n, 미국 북동부의 주(생략 Mass)
Massachusetts ballot : x, 후보자 이름을 정당 표시와 함께 알파벳 순으로 배열한 투표지
Massachusetts Institute of Technology : x, 매사추세츠 공과 대학(사립 대학)
massacre : n, vt, (도살의 뜻에서) 대량 학살, (많은 사람, 동물 등을) 학살하다, (사람을) 헐뜯다, 해치우다, 압승하다
massacre : n, vt, 대학살, ... 학살하다
mass action : x, 질량 작용
massage : n, vt, (이기다, 반죽하다의 뜻에서) 마사지, 안마, 안마 치료, ...에게 마사지하다, ...의 긴장, 편견 등을) 풀어주다, 완화하다, ...의 비위를 맞추다
massage : n, 마사지(안마) 하다
massage parlor : x, 안마(마사지) 시술소
massager : n, 마사지사, 마사지 기계
massagist : n, 안마사
mass behavior : x, 대중 행동
massbell : n, 미사의 종
Mass book : x, 미사 전례서
mass circulation : x, (대량 발행하는) 일반 대중 잡지
masscirculation : a, 대량 부수 발행의
mass communication : x, 대중 전달, 매스커뮤니케이션
masscult : n, 대중 문화
masscult : n, 대중 문화
mass defect : x, 질량 결손
mass driver : x, 우주 기재 발사 장치
masse : n, 마세(큐를 수직으로 헤워 치기)
masse : n, 마세, 세워 치기
massed : a, 밀집한, 한덩어리가 된, 집중한
mass energy : x, 질량 에너지
massenergy equation : x, 질량 에너지 방정식 (A, Einstein이 정식화한 E=mc2의 공식)
masseur : n, 안마사, 마사지사
masseur : n, 마사지사, 안마사
masseuse : n, 여성 안마사
mass game : x, 집단 경기
mass grave : x, 공동 묘지 (동시에 매장된 많은 사람들의 묘지)
massicot : n, 매시콧(일산화연으로 된 광물; 안료, 건조제용)
massif : n, 중앙 산괴(산맥의 중심이 되는 봉우리), 단층 지괴
massive : a, 크고무거운(단단한), 육중한, (머리, 체격, 용모등이)큼직한, 크고묵직해보이는, (정신, 행동 등이)굳센, 당당한, 중후한, 강력한, 대규모의, 큰, 대량의, 덩어리모양의, 조직에 광범위하게 미치는
massive : a, 크고 무거운, 묵직한, 육중한, 실팍한
mass leave : x, (인도에서 항의하기 위해 많은 종업원이 하는) 일제 휴가
mass man : x, 대중적(집단) 인간 (대중 사회를 구성하는 가정된 전형적 인간으로, 개성이 상실됨)
mass media : x, 대중 전달 기관 (방송, 신문등) (sing, mass medium)
mass medication : x, (상수도에 약물을 넣는 식의) 집단 투약
mass meeting : x, (특히 정치적) 대중 집회
mass metting : x, (국민) 대회
mass movement : x, 집단 이동; 대중 운동
mass noun : x, 질량 명사 (uncountable 로서 물질 명사와 추상 명사를 포함)
mass number : x, 질량수(원자핵내의 양자와 중성자와의 총수; 기호 A)
mass obervation : x, 여론 조사
mass priest : x, 미사 맡아보는 사제; (경멸) 카톨릭 사제
massproduce : vt, vi, 대량 생산하다, 양산하다
mass production : x, 대량 생산
mass psychology : x, 군중 심리학
mass ratio : x, 질량비 (추진부를 제외한 로켓 본체에 대한 총중량의 비율, 추진약 충전율)
mass society : x, 대중 사회(산업화, 도시화된 현대 사회)
mass spectrograph : x, 질량 분석기
mass spectrometer : x, 질량 분석계
mass storage : x, 대량 기억(장치)
mass transit : x, 대량 수송 수단(철도, 전차, 지하철, 버스 등의 공공 수송 수단)
mass transport : x, (버스, 전차 등의 공공 수송 기관에 의한) 대량 수송; 대량 수송 기관
masswnergy equation : x, 질량과 에너지와의 항등식
massy : a, 무거운, 실팍한
mast : n, 돛대, 마스트, 기둥, before the ~ 돛대에, 평수부로서(수부는 돛대의 수부실에 있으므로)
mast : n, 도토리(돼지 먹이)
mastaba(h) : n, (옛 이집트) 마스타바(돌, 벽돌로 만든 귀인의 분묘)
mastectomy : n, 유방 절제(술)
masted : a, (보통 복합어를 이루어) ...돛대의, 돛대를 갖춘
master : n, 주인(opp, man), 소유주, 임자, 장, 우두머리, 가장, 선장, 교장, 선생, 명인, 대가, 도련님, 승자, 석사
master : n, (the Master)예수, be ~ of ...을 갖고 있다, ...에 통달해 있다, ...을 마음대로 할 수 있다, be one's own ~ 자유로이 행동할 수 있다
master : n, ~ of ceremonies (식, 여흥의)사회자 (생략 M, C) 의전관, 문예 부흥기의 명화가들(의 작품)
master : vt, 지배하다, 정복하다, (정렬을) 억제하다, 숙달하다
master's degree : x, (문학, 이학) 석사(학위), master's라고도 씀
master antenna : X, 마스터 안테나(대형 안테나로 전파를 수신하여 케이블을 통해 가입자에게 분배하는 케이블 텔레비전(CATV)용)
masteratarms : n, 선임 위병 하사관
master bedroom : ㅌ, 큰 침실(집안에서 가장 큰 침실; 부부용)
master builder : x, 건축 청부업자, (뛰어난)건축가
master class : x, (일류 음악가가 지도하는) 상급 음악 세미나
master clock : x, 어미 시계(전자, 전기 시계의)
masterdom : n, 학교 교사의 신분(직), MASTER의 학위, 지배(력)
master file : x, 마스터 파일(컴퓨터의 데이터 처리에서 중심이 되는 데이터 파일)
master film : x, 필름 원판, 네거티브 필름
masterful : a, 제멋대로 하는, 거드름 부리는, 남을 부리려 하는, 능란한, 명수의, 명인다운
master gland : x, 뇌하수체
master hand : x, 명인, 명기, 명인기, 전문가의 솜씨
master key : x, 겸쇠, 만능 열쇠
masterless : a, 주인 없는, (동물 등이) 임자 없는
masterly : a, ad, 대가다운; 명수의, 능란한, 훌륭한, 대가답게, 느란하게, 훌륭히
master mariner : x, (상선의) 선장
master mason : x, 석수의 우두머리; 제 3 급의 프리메이슨
master mechanic : x, 직공장, 반장, 감독 기술자, 숙련공
mastermind : n, vt, 위대한 지능(의 소유자), (계획 등의) 지도자, 입안자; (나쁜 짓의) 주모자, (계획등을)(교묘히) 입안 지도하다; (나쁜 짓의) 주모자 노릇하다
masterpiece : n, 걸작, 명작, 대표작
master plan : x, 종합 기본 계획
master policy : x, (단체 보험의) 주증권
master sergeant : x, (군) 상사
mastership : n, MASTER 의 직(지위, 권위), 지배력, 통어, 숙달, 정통
masterslave manipulator : x, 매직 핸드(방사선 물질 같은 인체에 위험한 물체 취급에 사용함)
master stroke : n, 훌륭한 솜씨, 대성공; 주선, 영묘한 필치
master touch : x, 천재의 번득임; 입신의 솜씨
masterwork : n, 대작, 걸작
mastery : n, 지배, 통어(the ~ of the seas(air) 제해(제공)력), 우위, 승리, 숙달
mastery learning : x, 완전 습득 학습
masthead : n, vt, 돛대끝, 돛대 꼭대기, 돛대꼭대기의감시원, (신문, 잡지 등의)발행인난, (선원을 벌로 돛대 꼭대기에 오르게 하다, (돛, 기등을)돛대(꼭대기)에 올리다(달다)
mast house : x, 돛대 제작소
mastic : n, 유향 수지(액), 유향수, 유향주, 마스티카(터키, 그리스의 일종의 진), (방수, 충전용) 회반죽, 담황색
masticable : a, 씹을(저작할) 수 있는
masticate : vt, 씹다
mastication : n, 씹어 삭힘
masticator : n, 씹는 사람(물건); 분쇄기, 고기 써는 기계
masticatory : a, n, 저작의, 씹는, ...씹는 것(타액 분비 촉진을 위한)
mastiff : n, (큰) 맹견의 일종
mastitis : n, (의) 유선염
masto- : x, (연결형) 유방, 유두의 뜻
mastodon : n, (고생) 마스토돈 (신생대 제 3 기의 큰 코끼리)
mastoid : a, n, 젖꼭지 모양의, ...유양 돌기
mastoiditis : n, 유양 돌기염
masturbate : vi, vt, 수음을 하다, 자위 행위를 하다
masturbation : n, 수음
masurium : n, 마수륨(technetium 의 별칭; 기호 Ma)
mat : n, vt, vi, 매트, 멍석, 신바닥 문지르는 깔개, (식기의)깔개, 엉킨 물건, leave a person on the ~ 문전에서 쫓아 버리다, ...멍석을 깔다, 얽히게 하다, ... 엉키다
mat : a, n, 광택없는, (그림의) 대지
matador : n, 투우사, (카드 놀이의) 으뜸패의 일종, (M, ) 지대지 미사일
mat board : x, 액자용 대지
match : n, 상대, 적수, 짝지움, 한쌍 중의 한쪽, 필적하는 것, 맞붙음, 시합, 배우자, 혼인, be a ~ (no ~) for 필적하다(하지 못하다), be more than a ~ for 맞설 수 없다
match : vt, vi, 결혼시키다(with), 맞붙게 하다(against), 어울리게 하다, ...어울리다, 걸맞다
match : n, 성냥, 도화선
matchable : a, 필적하는, 걸맞는, 어울리는, 대등한
matchboard : n, 은촉 물림 판자
matchboarding : n, 은촉 물림
matchbook : n, 성냥첩(뜯어 쓰게 된 종이 성냥)
matchbox : n, 성냥갑
matched order : x, 야합 매매
matcher : N, =MATCH 하는 사람
matchet : n, =MACHETE
matching : a, n, (색, 외관이) 어울리는, 조화된, 걸맞는, 매칭(나뭇결 무늬의 반복을 강조하는 무늬목의 결 배열), 정합
matching fund : x, (수익자의 출자에 응하여 정부, 단체, 개인 등이 내는) 보조금
matchjoint : n, 사개 물림
matchless : a, 무적의, 무비의
matchlock : n, 화승총
matchmaker : n, 결혼 중매인, 경기의 대진 계획을 짜는 사람, 성냥 제조업자
matchmaking : n, 성냥 제조
matchmaking : n, (적극적인) 결혼 중매, (경기의) 대진표 짜기
matchmark : n, (기계 부품 등에 표시하는) 조립 부호
match play : x, (골프) 득점 경기
match point : x, (정구, 배구 등에서)결승의 1점, (카드 놀이에서) 득점 단위
matchstick : n, 성냥개비
matchup : n, 균형(이 잡혀 있음); 짝짓기; a ~ of dissimilar fighting styles 서로 다른 파이팅 스차일의 복서 짝짓기
matchwood : n, 성냥개비
mate : n, vt, vi, 한패, 동료, (한쌍의 새의)한편, (해) 항해사(선장의 대리도 함), 조수, first ~, 1등 항해사, ... 지우다, 결혼시키다, ... 짝짓다, 한패가되다
mate : n, v, (체스) = CHECKMATE
mate : n, 마테차 나무, 마테차(의)잎, 마테차 그릇
matelasse : n, a, 일종의 견모 교직, 돋을 무늬가 있는(비단 등)
matelot : n, 수부, 선원
matelote : n, 술, 양파 등이 든 생선 요리
mater : n, 어머니(mother)
materfamilias : n, 모친, 주부
material : a, n, pl, 물질적인, 실질적인(opp, formal), 육체적인, 중요한(be ~ to), ~ evidence 물적 증거, ...재료, 원료, 감, 자료, 요소, 제재, ...용구(writing~s)
material cause : x, 질료인
material inplication : x, 질료(실질) 함의
materialism : n, 유물론, 유물주의
materialist : n, 유물론자
materialistic : a, 유물론의
materialistically : ad, 물질적으로, 크게
materiality : n, 실질이 있음, 구체성, 유형, 중요성
materialization : n, 형체를 부여하기, 실체화, 구체화, 물질화, (영혼의) 체현, 실현, 현실화
materialize : vt, vi, 구체화하다, 구현하다, 유형으로 하다, (영혼을)물질화 하다, ~ a spirit (강신술로) 영혼을 물질화 하여 눈에 나타내다, ... 유형으로 되다
materially : ad, 질료적으로, 실질적으로, 물질(유형)적으로; 육체적으로, 실질적으로, 대단히, 현저하게
material noun : x, 물질 명사
materialsintensive : a, 재료 집약적인, 원자재 대량 소비(형)의
materials science : x, 재료 과학, 재료학
material witness : x, 중요 증인(참고인)
materia medica : n, (집합적) 약물, 약종; (단수 취급) 약물학
materiel, -te- : n, 물질적 재료(설비); 군수품
maternal : a, 어머니의, 어머니다운(opp, paternal)
maternal deprivation : x, 모성적 보호의 박탈, 모성 상실
maternity : n, 어머니임, 모성, 어머니다움
maternity benefit : x, (국민 보험의) 출산 수당
maternity hospital : x, 산과 병원
maternity leave : x, 출산 휴가, 산휴
maternity nurse : x, 조산원
matey : a, 친구의, 친한, 소탈한, 허물없는, (호칭으로) 친구
math : n, (구)= MATHEMATICS(수학), 수학 선생
mathematic : a, 수학의, 수리적인, 정확한
mathematical logic : x, 수리 논리학
mathematicial : a, 매우 정확한, 엄밀한, 완전한, 명확한, 확실한
mathematician : n, 수학자
mathematics : n, 수학, applied (mixed) ~ 응용 수학, pure ~ 순수 수학
matico : n, 마티코(열대 아메리카산 후추과의 초본, 잎은 지혈용)
matilda : n, (오스)(잡목숲의 여행자, 방랑자 등의) 보따리; walk(waltz) ~ 보따리를 휴대하다, 방랑하다
matin : n, =MATHEMATICS
matin : n, 조과, 아침 일과, 아침 예배(의 시각), (시) (새의) 아침 노래
matinal : a, 아침의; 아침 기도의
matinee : n, 낮흥행, 마티네
matinee coat(jacket) : x, 마티네 코트(젖먹이용의 모직 상의)
matinee idol : x, (여자들에게 인기 있는) 미남 배우
mating : n, 교배, the ~ season 교배기
Matisse : n, Henri (1869~1954) 프랑스의 후기 인상파 또는 야수파의 화가
matman : n, 레슬링 선수
matrass : n, 목이 긴 달걀 모양의 플라스크
matri : x, (연결형) 어머니의 뜻
matriarch : n, 여자 가장, 가장의 아내
matriarchate : n, 여 가장제 사회
matriarchy : n, 여가장제, 여족장제, 모권제, 모권사회
matricentric : a, 어머니 중심의
matrices : n, matrix의 복수형
matricidal : a, 어머니 살해(자)의
matricide : n, 모친 살해(자)
matriculant : n, 대학 입학(지원)자, 신규 입회 회원
matriculate : vt, vi, 대학 입학(을 허가)하다
matriculation : n, 입학 허가, 입학
matrifocal : a, 어머니 중심의
matrilineage : n, 모계, 모계도(족보)
matrilineal : a, 모계의(사회 등)
matriliny : n, 모계제; 모계 족보를 더듬어보기
matrilocal : a, 처가 거주의
matrimonial : a, 결혼의, 부부의, a ~ agency 결혼 상담소
matrimony : n, 결혼, 결혼 생활, (카드) 으뜸패 King 과 Queen 을 짝짓는 놀이
matrix : n, 자궁, 모체, (생) 세포 간질, 자모, 지형, (컴퓨터의)행렬
matrix management : x, 매트릭스 매니지먼트(전문 스태프를 현지의 일상 업무 조언자겸 중앙 스태프가 되게 하는 조직 형태
matrix sentence : x, 모형문 (보기; The book that I want is gone.의 the book is gone)
matrix system : x, 매트릭스 시스템 (종적 조직 뿐 아니라 횡적 프로젝트 팀의 일원도 되게 하는 경영 시스템)
matron : n, (나이 지긋한) 기혼 부인, 간호 부장, 학교 여자 사감
matronage : n, 기혼 부인임; (집합적) 기혼 부인들, (간호) 부장(여사감, 보모)들
matronal : a, matron 의
matronize : vt, vi,  matron답게 만들다; matron으로서 감독(관리)하다, (젊은 여성을 따라 다니며 돌보다, matron이 되다(노릇을 하다)
matronly : a, 관록(위엄) 있는, 침착한, (젊은 여성이) 지나치게 뚱뚱한
matronship : n, MATRON임; MATRON 의 직(지위, 임무 등)
matronymic : a, n, 어머니 (모계 조상)의 이름에서 딴 (이름)
MATS : x, Military Air Transport Service 군 항공 수송부
Matsu : n, 마쭈 (섬)(중국 남동부, 대만 해협의 섬)
matt : n, 남자의 이름
mattamore : n, 지하 주거(창고_
matted : a, 매트를 깐, 텁수룩한, (머리털 등)헝클어진; ~ hair텁수룩한 머리
matted : a, 윤(광택)을 없앤
matter : n, 물질(opp, spirit, mind), 성질, 본질, (철)질료, (논)명제의 본질, 내용, 자료, 재료, (미술)재질, 마티에르, 중요함, ..., 물 (postal ~ 우편물, printed ~ 인쇄
matter : n, as a ~ of fast 실제는, 실제에 있어서, as ~s stand, OR as the ~ stands 현상태로는, for that ~ 그 일에 대해서는, in the ~ of ...에 대해서는
matter : n, no ~ 대단한 일이 아니다, no ~ how(what, when, where, who) 비록 어떻게(무엇을, 언제, 어디에서, 누가) ...한다 하더라도
matter : vi, 중요(중대)하다, (상처 따위가)곪다, Itdoes not ~ (if...) (...이라도) 괜찮다, What does it ~ ? 상관 없지 않은가
Matterhorn : a, 알프스 산맥 중 Mont Blance 다음 가는 고봉(4, 505 m)n
matterofcourse : a, 당연한, 물론인, 자연의
matterofcourse : a, 당연한, 말할 나위 없는
matteroffact : a, 사실의, 사무적인, 멋없는
mattery : a, 고름으로 가득 찬, 고름이 나는
Mattew : n, 마태 (예수의 12 제자의 하나)
matting : n, 멍석, 돗자리, 매트 재료, 거적(등)
matting : n, 윤 지우기, 윤을 지운 것(면); (그림틀의 윤을 지운) 금 테드리
mattins : n, =MATIN 1 a
mattock : n, 곡괭이의 일종
mattoid : n, (미친 사람에 가까운) 정신 이상자
mattress : n, (짚, 솜 등을 둔) 침대요, 침상
maturate : vi, vt, 익다, 화농(케)하다
maturation : n, 화농 (과일의 따위의) 익음, (재능의) 원숙
maturative : a, n, 화농을 촉진하는; 성숙시키는, 화농약, 고름을 빨아내는 약
mature : a, vt, vi, 익은, 성숙한, (심신이) 충분히 발달한, 만기가 된, 신중한, ...익(히)다, 성숙시키다(하다), 완성시키다, 만기가 되다
maturity : n, 성숙, 완성, 만기, 화농, come to ~ 성숙하다
maturity market : x, 중, 노년층 시장 (45-65세의 연령층을 대상으로 하는 미개척 시장)
maturityonset diabetes : x, 중, 노년성 당뇨병
maturityonset diabetic : x, 중, 노년성 당뇨병의(환자)
maturity stage : x, 제품 성숙 단계 (매상 속도가 떨어지고 이윤이 안정되는 것이 특징
matutinal : a, (이른) 아침의, 이른
matutinophobe : n, 조기 공포증의 사람
matzo : n, 페스오버에 유대인이 먹는 밀가루만으로 된 빵
maud : n, (스코틀랜드의 양 치는 사람이 걸치는) 회색 격자무늬의 모직 어깨걸이; 그것으로 만든 여행용 담요
Maud(e) : n, 여자 이름
maudlin : a, n, 걸핏하면 눈물짓는, 감상적인; 취하면 우는, 눈물 잘 흘림, 심약하고 감상적임
maudlin : a, n, 걸핏하면 우는, 취하면 우는, 감상적인, ...눈물 잘 흘림, 감상적인
Maugham : n, 몸 Willam Sonerset ~ (1874-1965)(영국의 소설가, 극작가)
Maugham : n, William Somerset(1874~1965) 영국의 소설가, 극작가
maugre, -ger : prep, ...에도 불구하고
Maui : n, 마우이 섬 (하와이 군도의 한 섬)
maul : n, vt, 큰 나무망치, 메, (질승 등이) 할퀴어 상처내다, (상처가 나도록) 치다, (할퀴다); 째다, 가르다, 뭇매질하다, 혼내주다, 거칠게 다루다, 혹평하다
maul : n, vt, 큰 망치, ...큰 메로 치다, 쳐서 부수다, 거칠게 다루다, 혹평하다
mauler : n, 손, 주먹, 권투(레슬링)선수
Mauler : n, 지대공 요격 미사일의 일종
mauley : n, 손, 주먹
maulstick : n, (화가의) 팔받침(수직의 화면에 가는 선을 그을 때 횐손에 들고 오른손을 지탱하는 막대기)
maulstick : n, (화가의) 팔 받침
mau mau : x, 마우마우, 케냐지방에서 유럽인 축출을 목적으로 하는
Mau Mau : x, (케냐 지방에서 유럽인 축출을 목적으로 하는) Kikuyu족의 비밀 결사
maund : ㅜ, 몬드(인도, 중동 제국 등의 형량; 9.5-37.3kg)
maunder : n, 종작(두서)없이 지껄이다, 방황하다
Maunder minimum : x, (1645-1715 년의) 태양의 불규칙 활동기(태양의 흑점이 거의 소멸한 시기)
maundy : n, 세족식 (빈민의 발을 씻어 주고 선물을 주는 의식), 세족식 날에 황실로부터 하사되는 빈민 구제금
maundy money : x, 세족 목요일에 영국 왕실이 베푸는 빈민 고제금
Maundy Thursday : x, 세족 목요일(부활절 전의 목요일)
Maundy Thursday : x, 세족 목요일, 성목요일(Easter 직전의 목요일)
Maupassant : n, Guyde (1850~1893) 프랑스의 소설가
Mauriac : n, Francois (1885~1970) 프랑스의 소설가
Mauritania : n, 아프리카 북서부의 공화국
Mauritius : n, 마다가스카르섬 동쪽 인도야의 섬 나라
Maurois : n, Andre (1885~1967) 프랑스의 소설가, 전기 작가, 평론가(본명 Emile Herzog)
mauser : n, 모제르 총
mausoleum : n, 영묘, 능, 장려한 무덤, 음침하고 큰 건물(방)
mauve : n, a, 연보라(의)
maven, mavin : n, 숙달한 사람, 프로, 명수
maverick : n, a,  낙인이 찍히지 않은 송아지; 어미 없는 새끼 동물, 무소속 정치가(예술가 등), 이단자, 낙인없는, 무리에서 떨어진
mavis : n, 개똥지빠귀류
mavourneen, -nin : n, (아일) 귀여운 사람(my darling)
maw : n, 동물의 위
mawkish : a, 구역질나는, 연약하고 감상적인
mawworm : n, 회충; 위선자
maxi : x, (최대, 최장의) 뜻의 결합사
maxi : n, 맥시(롱)스커트, 맥시 코트
maxilla : n, 위턱, 턱뼈, (척추 동물의) 상악골, (절지 동물의) 작은 턱
maxillary : n, 턱뼈, 상악골
maxim : n, 격언, 금언
maximal : a, 최대한의, 최고의
maximalist : n, 타협을 배제하고 최대한을 요구하는 자, 고격주의자
Maxim gun : x, 맥심 포(구식의 속사 기관총)
Maximilian : n, 남자 이름
maximin : n, 맥시민(어떤 한 조의 극소치 중의 최대치), 맥시민 치(게임 이론에서 최소의 득점을 최대로 하는 수법
maximize : vt, 최대한으로 증대하다
maximum : n, 최대한도
maximum dose : x, (약의) 극량
maximum permissible dosage : x, (방사능) 최대 허용 조사 적량
maximumsecurity : a, 경비(감시)가 가장 엄중한, 최대 경비의
maximum thermometer : x, 최고 온도계
Maxine : n, 여자 이름
maxiskirt : n, 맥시 스커트
maxon, dixonline : x, 메리랜드주와펜실바니아의주경계선, 노예시대의 남북 경계선, 현재는 방언 구분선의 하나
maxwell : x, 맥스웰, 자속의 단위
may : aux, v, 일지도 모른다, 해도 좋다, 하여도 상관 없다, 하는 것도 당연하다, 하기 위하여, 비록, 일지라도, 할수 있다
may : n, 5월, 청춘, 산사나무
maya : n, a, 마야사람(의), 마야말(의)
mayapple : n, 포도피름속의 식물(5월에 달걀 모양의 노란 열매를 맺음), 그 열매
maybe : ad, 아마
maybush : n, 산사나무 무리, 아가위 나무
May Day : x, 오월제(5월1일 maypole춤을 춤), 노동절, 메이데이
mayday : x, 메이데이, 국제 구조 신호
May December marriage : x, (늙은 남자와 젊은 여자의 결혼 처럼) 연령 차가 많아 어울리지 않는 결혼
Mayfair : London의 Hyde Park 동쪽의 고급 주택지; London 사교제n, 
mayflower : n, 산사나무, 암당자
may fly : x, 강날 도래, (하루살이 비슷한) 제물 낚시, 하루살이
mayhem : x, 신체상해(죄), 파괴, 난동, 혼란
maying : n, 오월제 축하, 5월의 꽃을 따러가기
May meetings : x, 5월 회의(5월에 London에서 열리는 종교, 자선 등의 회의)
mayn't : x, may not의 단축
mayonnaise : x, 마요네즈
mayor : x, 시장
mayoral : a, 시장(직)의
mayoralty : n, 시장의 직
mayoress : x, 여시장, 시장부인
maypole : n, 오월제에 세우는 기둥, 이 둘레에서 춤을 춤
maypop : n, 꽃시계 덩굴; 그 열매
may queen : x, 5월의 여왕, 오월제에 놀이에서 여왕으로 뽑힌 소녀
Maytide : n, 5월(의 계절)
May Week, Mayweek : (영)Cambridge 대학의 보트 레이스가 거행되는 주(5월 말 또는 6월 초)n, 
mazarine : n, a, 짙은 남빛; 짙은 남빛 옷(감), 짙은 남빛의
mazda : n, (조로아스터교)선의 신
maze : n, 미로, 분규
mazel : n, (미)운, 행운
mazel tov : x, 축하합니다, 행운을 빕니다(유대인의 축하와 축원의 말)
mazily : ad, 구불구불하여; 혼란하여; 당황하여
mazuma : n, 돈
mazurka, mazourka : n, (폴란드의)마주르카춤(곡)
mazut : n, 연료유
mazy : a, 구불구불한, 당황한
mbira : n, 엠비라, 므비라(나무, 금속 조각으로 된 아프리카의 악기)
MBK : X, medications and bandage kit 의약품, 붕대 세트
MBO : x, management by objectives 목표 관리
Mc.Donald's : n, 맥도널드(미국 최대의 햄버거 체인점), 맥도널드 햄버거(상표명)
Mc.Kinley : n, 매킨리(Alaska에 있는 대륙 최고봉(6, 194m))
Mc.Luhanite : n, 맥루안 이론 신봉자(지지자)
MCAT : x, Medical College Admissions Test
McCarthyism : n, 매카시주의, 좌익 추방주의
mccoy : n, a, 진짜, 본인
mcintosh : n, 붉은 사과의 일종(미국산)
mcluhanism : n , 맥투언이론, 캐나다의 학자, marshall mcluhan에 의한 매스커뮤니케이션 이론
MD : n, Dr.Pepper(청량 음료; 카운터에서의 용어)
me : pron, 나를, 나에게
Meaca : n, 메카, 순례지, 동경의 땅, 발상지
meacon : vt, 잘못 신호하다
mea culpa : x, 내탓(으로)
mead1 : n, 꿀술
meadow : n, 목초지, 강변의 낮은 풀밭
meadow clover : x, 붉은 토끼풀(콩과)
meadow foxtail : x, 큰독새풀(목초)
meadow grass : x, 왕포아풀(벼과)
meadowlark : n, 들종다리(찌르레기과; 북미산)
meadow mushroom : x, 주름버섯의 일종(식용)
meadowsweet : n, 조팝나무속의 관목
meadowy : a, 목초지의
Meaea : n, 메데아, jason의 golden fleece입수를 도운 여마법사
meager, meagre : x, 야윈, 불충분한, 빈약한, 무미건조한
meal1 : n, (옥수수 따위의)거칠게 간 곡식, 굵은 가루
meal2 : n, 식사(시간)
mealie : n, 옥수수
meal offering : x, (이스라엘 사람의) 곡물의 제물(밀가루, 소금에 기름이나 향료를 친 것)
meal pack : x, (미) 냉동 런치(팩)(가열만 하면 먹을 수 있게 된 냉동 식품)
meal ticket : x, 식권, 생계의 근거, 수입원, 의지되는 사람, 기둥감
mealtime : n, 식사시간
mealy : a, 탄 곡식 모양의, 작은 알 모양의, 가루 모양의, (얼굴이)창백한
mealybug : n, 벚나무깍지벌레 (수액을 먹는 작은 진디의 일종)
mealymouthed : x, 말솜씨 좋은
mean1 : n, 중간, 중의, 평균값, 중항, 중용, 매사(중간에서는것, 중개자의 뜻에서)
mean2 : a, (태생이)비천한, 초라한, 열등한, 인색한, 가치없는, 비열한
mean3 : vt, vi, 꾀하다, 할 셈이다, 예정하다, 의미하다
mean calitie : x, 평균 칼로리
meander : n, 강의굽이침, 꼬부랑길, 우회하는여행, 뇌문
meandering : n, a, 꼬부랑길, 만보, 만담, 두서없는
meanderingly : ad, 굽이쳐서, 지향 없이, 어정어정
mean deviation : x, 평균 편차
mean deviation : x, 평균 편차
mean distance : x, 평균 거리(극 일점 거리와 원일점 거리와의 평균); (연성의) 평균 거리
meandrous : a, 구불구불한, 물결 모양의
meanful : a, 의미심장한, 의의있는
meanie : n, 치사한 놈, 불공평한 비평가, 독설가, (극, 소설의)악역
meaning : n, 의미, 의의, 목적, 저의
meaningful : a, 뜻있는, 의미심장한, 의의 있는
meaning postulate : x, 의미 추론식, 의미 공리
meanless : a, 무의미한, 뜻이 없는, 무가치한
meanly : ad, 의미 있는 듯이, 일부러
meanness : n, 하찮은, 조악, 빈약, 천함, 야비, 비열, 인색
mean sea level : x, 평균 해면(해발 기준)
mean solar day : x, 평균 태양일
mean solar time : x, 평균 태양시, 평균시
meanspirited : a, 비열한, 천한
means test : x, (영) 수입 (자산) 조사(생활 보호등을 받는 자의)
meanstest : vt, (영)(보조금, 수당 등의) 지급에 관한 자산 조사를 하다
mean sun : x, 평균 태양(천구의 적도를 평균 각속도로 움직이는 가상 태양)
meant : v, mean3의 과거(분사)
meantime : ad, 이럭저럭하는 동안에
measd : a, 잰, 신중한, 운율이 고른, 리드미컬한
measled : a, 홍역의 (에 걸린)
measles : n, 홍역
measless : a, 헤아릴 수 없는
measly : a, 홍역에 걸린, 홍역의, (고기에)촌충이 붙은
measment : n, 측정, 용량, 치수
measurable : a, 잴 수 있는, 알맞은
measurably : ad, 잴 수 있을 정도로, 다소
measure : n, 측정, 측량, 크기, 치수, 기준, 한도, 표준, 척도, 운율, 박자, 춤, 수단, 법안, 지충, 일정한 액수(양 등), 계량의 측정법
measured : a, 정확히 잰, 표준에 의거한; 적도의, 알맞은, 고려한, 신중한, 정연한, 박자가 맞는, 율동(운율)적인
measureless : a, 무한한, 무한량의, 대단한, 엄청난
measurement : n, 측량, 측정, 양, 치수, 크기, 넓이, 길이, 두께, 깊이, 도량법
measurement goods : x, 용적(계산) 화물
measurement science : x, 계측학
measurement ton : x, 용적톤 (40 cu)
measurer : n, 측량하는 사람, 계량기
measuring cup : x, (눈금 있는)계량컵
measuring glass : x, 계량 유리컵
measuring worm : x, 자벌레
meat : n, (식용의)고기, 음식, 식사
meatandpotatoes : a, 기본적인, 중요한; 현실적인, 일상적인; 만족할 만한
meatax : n, a, vt, 고기 써는 식칼, (예산 등의) 대폭 삭감, 대암한, 가혹한, ...을 크레 삭감하다
meat bag : x, 위, 밥통
meatball : n, 고기 완자, 얼간이, 지겨운 사람
meat cleaver : x, 고기를 토막내는 큰 식칼
meateater : n, (뇌물을 요구하는) 부패한 경찰관
meat fly : x, 쉬파리 (flesh fly)
meat grinder : x, 고기 저미는 기계
meathead : n, 바보, 얼뜨기
meat hooks : x, 손, 주먹
meatman : n, 푸주한
meatmarket : n, 식육 시장; 정육점, 푸주
meatness : n, 고기가 많음; 내용 충실
meat offering : x, (옛 유대의) 제수 (밀가루와 기름으로 만든 것)
meatpacker : n, 정육업자, 전차에 손님을 밀어 태우는 사람
meatpacking : n, 정육업
meatpie : n, 고기 파이, 미트파이
meat rack : x, 동성 연애자의 집합소; 보디 빌딩 체육관
meat safe : x, (고기 넣어 두는) 찬장(쥐, 파리를 막는)
meat show : x, (나이트클럽 등의) 플로어쇼
meat tea : x, =HIGH TEA
meatus : n, 개구, 통로
meat wagon : x, 구급차; 영구차; 죄수 호송차
meaty : a, 고기가 많은, 내용이 풍부한
Mecca : n, 메카(사우디아라비아 서부의 도시; 마호멧의 탄생지), 많은 사람이 찾아가는 곳; 동경의 땅(대상), 발상(기원)지
Meccano : n, 메카노세트(강철 조립 세트의 장난감; 상표명)
mechanic : n, 직공, 기계공
mechanical : a, 기계의, 기계에 의한, 기계학의, 물리적인
mechanical advantage : x, 기계적 확대율(지레, 도드래, 수압기 등의 기기에 의한 힘의 확대율
mechanical bank : x, 기계 장치 저금통(장난감)
mechanical brain : x, 인공 두뇌
mechanical drawing : x, 제도 기화
mechanical engineer : x, 기계 공학자, 기계 기사
mechanical engineering : x, 기계공학
mechanically : ad, 기계(장치)로, 기계적으로
mechanical pencil : x, 샤프 펜슬
mechanical powers : x, 기계력, 간단한 기구류(지레, 활차, 나사, 굴대등)
mechanical scanning : x, (TV)기계적 주사
mechanical transport : x, 자동차 부대
mechanicaly : ad, 기계적으로
mechanician : n, 기계 조립공, 기계학자, 기사
mechanics : n, 기계학, 역학
mechanism : n, 기계(장치), 기구, 조직, 기교, 우주 기계론
mechanist : n, 기계론자, 기계기사
mechanistic : a, 기계학(기계론)적인
mechanization : n, 기계화 (특히 군대의)
mechanize : vt, 기계화하다
mechanochemistry : n, 기계 화학 (화학적 에너지의 기계 에너지로의 전환을 다룸)
mechanoreceptor : n, 물리적 자극의 수용기, 기계 수용기
mechanotherapy : n , 기계(적) 요법 (마사지 등)
Mechlin lace : x, 메클린 레이스(벨기에 Mechlin산 무늬가 든 레이스)
Mechs : x, 기계화 부대
Med : n, 지중해(지방)
medal : n, 메달, 상패, 기장, 훈장, 공로장(일반 시민에 수여;1942년 제정)
medal(l)ed : a, 메달을 받은; 기장을 단
medal(l)ist : n, 메달 재작(의장, 조각)가, 메달 수집가, 사패 수령자
medalet : n, 작은 메달
medallic : a, 메달의, 메달에 관한(에 새겨진)
medallion : n, 큰 메달, 원형 양각
medal play : x, (골프) 메달 플레이 (stroke play)(한 코스의 타수가 가장 적은 쪽부터 순위를 정함)
meddle : vi, 참견(간섭)하다, 주물럭거리다
meddler : n, 쓸데 없이 참견하는 사람
meddlesome : a, 참견하기 좋아하는
meddling : n, a, (쓸데없는) 간섭, 참견, 참견하는, 간섭하는
Medea : n, 메디아(Jason이 Golden Fleece를 손에 넣는 것을 도와 준 여자 마술사)
me decade : x, 자기 중심주의의 시대 (자기 편향적인 풍조가 지배했던 1970년대)
medevac : n, 부상자 구출용 헬리콥터
media1 : n, medium의 복수
media2 : n, 유성 파열음, (동맥의)중막
media blitz : x, 미디어 블리츠(매스컴을 총동원하여 집중적으로 하는 대선전)
media buyer : x, (광고 대행사의) 매체 세일느 담당자
mediacracy : n, 미디어크라시(신문, 방송 등이 큰 힘을 가지게 된 경향)
mediacy : n, 개재, 매개, 조정
mediaeval : a, =MEDIEVAL
media event : x, (매스컴 보도를 예상하여) 짜여진 사건(행사); (매스컴에 확대(과대) 보도된), 조작된 큰 사건
mediagenic : a, 매스미디어 (특히)텔레비젼에 맞는, 매스컴에 맞는
media kit : x, (광고 권유를 위한) 자료 한 벌
medial : a, 중간의, 보통의
medialand : n, 매스컴의 세계
mediaman : n, (광고 대행사의) 매체 조사원
media mix : x, 미디어믹스(필름, 테이프, 슬라이드 등을 동시에 이용하는 행사(기획)
mediamorphosis : n, 미디어에 의한 사실의 왜곡, 왜곡 보도
median : a, 중간에 위치한
median packet : x, (광고 대행사 등이 작성하는) 뉴스 매체용 PR자료
median point : x, 중점, 중심
median strip : x, (도로의)중앙 분리대
mediaperson : n, (신문, 라디오, 텔레비젼 등의) 기자, 보도원, 통신원, 리포터
media relations : x, 매체 회사와의 인간 관계
mediashy : a, 매스컴 공포증의, 매스컴 (인터뷰)을 싫어하는
mediate : a, 중간의, 중개의
mediately : ad, 간접으로
mediation : n, 조정, 중재, 중개, 매개, (선물 등의)전달, 화해, 사화
mediatize : vt, (공국을) 종속시키다; (대국이 소국을) 합병하다
mediator : n, 조정자
mediatorial : a, 중재(조정)의
mediatory : a, 중재의, 조정의
mediatress : n, =MEDIATRIX
mediatrix : n, MEDIATOR의 여성형(특히 성모 마리아)
Medibank : n, 국민 건강 보험(제도)
medic : n, 의사, 의학도, 위생병
medicable : a, 치료할 수 있는
medicaid : x, 저소득자 의료 보조
Medicaid mill : x, 으료 보조 악용 병원, 보험료 부정 청구 병원
medical : a, 의학의, 의료의, 내과적인, 개업의, 내과의, 내과 환자
medical attendant : x, 주치의
Medical Center : x, (주로 미) 의료 센터(대도시의 의과대학, 부속병원 등의 총칭)
medical certificate : x, 진단서, 의료 설명서
medical college : x, 의과 대학
Medical Corps : x, 의무대
medical examination : x, 건강진단
medical examiner : x, 검시관, (공장 등의)전속 의사
medical jurisprudence : x, 법의학
medical officer : x, 보건소원, 진료소원; 군의관
medical reactor : x, 의료용 원자로
medical treatment : x, (내과적)치료
medicament : n, 의약, 약제, 약물
medicare : x, 국민 의료 보장
medicaster : n, 가짜의사
medicate : vt, 약으로 치료하다, 약을 섞다
medication : n, 약물 치료(처리), 약물
medicative : a, 약효가 있는
medicator : n, 약물 치료 용구(면봉, 도포구 등)
Medicean : a, MEDICI가의
medichair : n, 생리 상태 측정용 sensor가 붙은 의자
medici : n, (이탈리아 르네상스기의)메디치가
medicinal : a, 의약의, 약효가 있는
medicinally : ad, 의약으로, 약으로써
medicine : n, 약, 내복약, 의술, 의학, 마술, 부적
medicine ball : x, 가죽으로 만든 무거운 공(체육용)
medicine chest(cabinet) : x, (특히 가정용) 약상자, 의료함(욕실 등에 둠)
medicine dance : x, (북미 인디언 등의 병마를 쫓기 위한) 무당춤, 주술춤
medicine man : x, (북아메리카 토인의)마법사
medicine show : x, (행상인이 연예인을 써서 하는) 의약품 선전판매 쇼(특히 19세기 미국에서 유행)
medico : n, 의사, 의학도
medicobotanical : a, 약용 식물학의
medicogalvanic : a, 전기 요법의
medicolegal : a, 법의학의
medieval : x, 중세(풍)의
medieval history : x, 중세사(서로마 제국의 멸망(476년)에서 르네상스까지)
medievalism : n, 중세풍, 중세정신(존중)
medievalist : n, 중세 연구(존중)가
medievalize : vt, vi, 중세풍으로 하다, 중세를 연구하다, 중세의 이상, 습관 등을 쫓다
Medieval Latin : x, 중세 라틴어(보통 A D 700-1500 년의 것)
Medina : n, 메디나(사우디아라비아 서부의 도시; Mohammed의 묘가 있음)
mediocracy : n, 평범한 사람(집단)에 의한 통치(지배)
mediocre : a, 보통의, 평범한, 별것이 아닌
mediocritize : vt, ...을 평범(범용)하게 하다, 시시하게 하다
mediocrity : n, 범용, 평범한사람
meditate : vi, vt, 숙고(묵상)하다, 꾀하다
meditation : n, 명상, 심사 숙고, 묵상, 명상록
meditative : a, 명상적인
meditator : n, 명상에 잠기는 사람, 사색가
mediterranean : a, 지중해의
Mediterranean fever : x, 지중해열(지중해 연안 지방에 발생하는 각종 열병, 특히 사람의 BRUCRLLOSIS)
Mediterranean fruit fly : x, 지중해 열매파리(유충이 오렌지 등을 먹어치움)
Mediterranean race : x, 지중해 연안에 사는 코카서스 인종
Mediterranean Sea : n, 지중해
medium : n, 중간, 중용, 매개(물), 매질, 매체, 배양기, 환경, 수단, 방법
medium artillery : x, 중형(중구경)포 (구경105-155 밀리)
medium bomber : x, 중형 폭격기
medium dhot : x, (TV)7분신 촬영(무릎 위를 찍는 인물 촬영법)
medium frequency : x, 중파
mediumistic : a, 무당의, 영매의
mediumize : vt, 강신의 영매로 삼다, 영매 상태로 이끌다
mediumrange ballistic missile : x, 중거리 탄도탄
mediumsized : a, 중형의, 중판의, 미디엄 사이즈의
mediumsized : a, 중형의
medium wave : x, 중파(파장이 545-200 m)
medlar : n, 서양모과(열매)
medley : n, 잡동사니, 혼합, 잡다한 집단, 잡색천
medley race : x, 혼합 경영(경주), 메들리 레이스
medow lark : x, 들종다리류
Medresco : n, 보청기의 일종
medtech : n, a, 의용 기술(의); 응용 기술(의)
Medulla : n, 수질, 골수, 척수, 모수, (나무)고갱이
medullary : a, 골수의, 척수의
Medusa : n, 마녀의 하나
meed : n, 보수, 포상
meek : a, 온순한, 유화한, 겸손한
meerkat : n, 몽구스류의 작은 육식 동물(남아프리카산)
meerschaum : x, 해포석, 해포석 파이프
meet1 : vt, vi, 만나다, 마주치다, 마중하다, (정식 소개로)아는 사이가 되다, 와 서로 만나보다
meet2 : a, 적당한, 어울리는
meeting : n, 만남, 회합, 회견, 결투, 회전, 합류(점)
meeting house : x, 교회당
meeting place : x, 집회소, 회장
meg : x, 대(큰대)의 뜻의 결합사
megabang : n, 거대 핵전력
megabit : n, 메가비트(기억용량의 단위)
megabuck : n, 100만 달러
megabuilding : n, 거대 빌딩
megabusiness : n, 거대 기업
megabyte : n, (컴퓨터)메가바이트
megacephalic : a, 거대한 두개의, 머리가 큰
megacity : n, 인구 100만 이상의 도시
megacorporation : n, 거대 기업
megacourtroom : n, 거대 법전(공해 재판 등의 일괄 심리를 위해 특설하는 큰 법정)
megacurie : n, 메가퀴리, 100만 퀴리
megacycle : n, 100만 사이클
megadeath : n, 100만 명의 죽음, 핵무기에 의한 대학살
megadyne : n, 메가다인(C.G.S. 단위계의 힘의 단위; =100만 다인)
megaflick : n, 초대작 영화
megafog : n, (몇몇 방향의 확성기에 의한) 안개 경보 장치
megafolly : n, 엄청난 바보짓
megagrowth : n, 초고도 성장
megahertz : n, 메가 헤르츠, 100만 헤르츠
megahit : n, 초대(대대적) 히트(작품)
megaindustry : n, 거대 산업
megajet : n, 초대형 제트기(점보 제트기보다 크고 빠른 것)
megajump : n, 대급증
megalith : n, 유사 이전의 거석
megalithic : a, 거석의(으로 만든), 거석 문화 시대의
megalomania : n, 과대 망상광
megalomaniac : n, a, 과장하는 버릇이 있는 사람, 과대 망상 환자, 과대 망상의
megalopolis : n, 거대 도시
megalopolitan : n, a, 거대 도시의, 거대 도시권의, 거대 도시의 주민
megalosaur : n, 거룡
megalosaurus : n, 거룡
megamachine : n, (비인간적으로 기능하는) 테크놀로지 지배의 거대 사회
megameter : n, 100만 미터
megamillionaire : n, 억만 장자, 대부호
megaphone : n, 메가폰, 확성기
megaproblem : n, 거대한 문제
megarad : n, 메가래드(100 만 래드, 방사선의 흡수선량의 단위)
megascopic : a, 육안으로 보이는, 육안에 의한, 확대된
megaspore : n, 거대 포자
megastructure : n, 거대 고층 건물
megatanker : n, (특히 20만톤 이상의) 거대 유조선
megatechnics : n, 거대 과학 기술
megaton : n, 100만 톤, 메가론(핵무기 폭발력의 계량 단위)
megatonnage : n, 메가톤 수(메가톤을 단위로 측정한 핵무기의 파괴력)
megatrend : n, 메가트렌드(현대 사회에서 진행 중인 거대한 동향)
megatron : n, 메가트론 진공관
megaversity : n, 매머드 대학
megavolt : n, 메가볼트(100만 볼트)
megawatt : n, 메가완트(100만 와트)
me generation : x, 미 제너레이션, 자기 중심 세대
megger : n, 절연 저항계
megillah, -la : n, 장광설, 장황한 이야기(설명)
Megillah, -la : n, 메길라(에스더기 the Book of Esther)가 수록된 유대의 두루마리책; Purim제에 유대 교회에서 읽음)
megilp : n, 메길프(유황용 휘발성 기름)
megohm : n, 100만 옴
megrim : n, 우울, 변덕, 편두통
meiosis : n, 세포핵의 감수 분열, 완서법
Meistersinger : n, 마이스터징거, 직장 가인(14-16세기 독일의)
mekong : n, 메콩강
melamine : n, 멜라민(수지)
melancholia : n, 우울증
melancholiac : n, a, 우울증 환자, 우울증에 걸린
melancholic : a, 우울한, 우울증의
melancholy : n, 우울(증)
melanesia : n, 멜라네시아, 태평양 중부의 섬들
Melanesian : n, a, 멜라네시아(사람, 말)의, 멜라네시아 사람, 멜라네사아 말
melange : n, 혼합(물)
melanian : a, 검은 색의, 검은 머리(살결)의, 흑색 인종의
melanic : n, a, 흑색중의, 흑색중 환자, 흑색인(종)
melanin : n, 멜라닌, 흑색소
melanism : n, 흑화, 흑색소(멜라닌) 침착, 흑성, 흑생증, 흑색소 침착증
melanize : vt, 멜라닌화하다, 흑화하다, 검게하다
melanochroi : n, (코카서스 인종 중에서)얼굴이 희고 머리가 검은 종족
melanoma : n, 흑색종
melanosis : n, 흑색증, 흑색소 침착증
melanotic : a, 흑색의, 흑색증의, 흑색증에 걸린
melanous : a, 검은 머리털과 거무스름한 피부를 가진
Melba toast : x, (바삭바삭한)얇은 토스트
Melbourne : x, 멜버른(오스트레일리아 동남부의 항구 도시)
meld1 : vt, vi, n, (손에 가진 패를)보이다(보임)
meld2 : vt, vi, 섞다, 섞이다
meled : a, 곤드레만드레 취한, 빈털터리가 횐, 파산한
melee : n, 치고 받기, 난투, 혼전
melic : a, 노래의, 가창용의(서정시)(특히 그리스 서정시)
melilite : n, 황장석, 멜릴라이트
melinite : n, 멜리나이트(프랑스에서 발명된 강력 폭약)
meliorate : vt, 개선(개량)하다
meliorative : a, 개선하는, 개량에 도움이 되는
meliorism : n, 사회 개량론, 세계 개선론
melioristic : a, 세계 개선론의
melisma : n, 선율이 아름다운 음악(가락)
melittin : n, 멜리틴(꿀벌 독침의 독액 성분)
melliferous : a, 꿀을 내는
mellifluence : n, 유창
mellifluous : a, 꿀같이 감미로운, 유창한
mellotron : n, 멜로트론(컴퓨터로 프로그래밍한 전자 건반 악기)
mellow : a, (과일이)익어 달콤한, 익은, 향기 높은, 원숙한, 풍부하고 아름다운
melodeon : n, 멜로디온(리드오르간의 일종)
melodic : a, 선율의, 선율적인, 선율이 아름다운
melodica : n, 멜로디카(하모니카 비슷한 악기)
melodics : n, 선율학(법)
melodion : n, 멜로디언(1806년 Dietz가 발명한 소형 건반악기
melodious : a, 선율이 고운
melodist : n, 성악가, 가수, 작곡가
melodize : vt, vi, ...에 선율을 붙이다, 감미로운 선율로 하다, 가곡을 연주하다(노래하다), 선율을 만들다
melodrama : x, 멜로드라마, 통속극, 권선징악의 통속극
melodramatic : a, 멜로 드라마식의, 신파조의
melodramatics : n, 멜로드라마적 언동(작품)(단수, 복수 취급)
melodramatist : n, 멜로드라마 작가
melodramatize : vt, 멜로드라마식으로 하다
melody : n, 아름다운 곡조, 해조, 선율, 곡
melomania : n, 음악광
melon : n, 멜론, 참외류
meloncutting : n, 특별 이익 (노획물)의 분배
melopomene : n, 멜포메네(비극의 여신)
melt : vi, 녹다, 녹아 없어지다, (마음이)풀리다, 가엾은 생각이 나다, (색이)녹아 섞이다
meltdown : n, (원자로의)노심 융해(냉각장치 등의 고장에 의한)
melter : n, 용해 장치(기구), 용융실, 용해업자
melting : a, n, 녹는, 녹기 시작한, 누그러지게 하는, 감동시키는, (얼굴, 표정이) 감상적인, (목소리, 말 등이)부드러운, 감동적인, 용해, 융해
melting mood : x, 감상적인 기분
melting point : x, 융해점
melting pot : x, 도가니, 온갖 인종이 융합해서 사는 곳(흔히 미국을 가리킴)
melton : n, 멜턴 나사(천)
meltwater : n, 눈이나 얼음(특히 빙하)이 녹은 물
melty : a, 녹기 시작한, 녹아가는; I like ice cream ~.아이스크림은(굳은 것보다) 녹아가는 것이 좋다
Melville : , 미국의 소설가
member : n, 일원, 구성원, 수족, 신체의 일부, 기관, 부분
member bank : x, 연방 준비 은행에 가맹한 은행, (어음 교환의) 조합 은행
membered : a, 몇 부분으로 이루어진(갈라진), (보통 복합어를 이루어)...의 회원이 있는
member nation : x, (유엔 등의) 가맹국
membership : n, 일원임, 회원 자격, 회원수
membership card : x, 회원증
membershipwide : a, 전회원 규모의; ~ vote 전원 투표
membersonly : a, 회원제의
membranal : a, (얇은) 막(모양)의, 세포막에 대한, 세포막질의
membrane : n, 얇은 막, 막피, 양피지, 문서의 한장
membranous : a, 막 모양의, 막을 형성하는
membrum (virile) : n, 남근
memcon : n, (회담등에서 적어두는) 담화 메모
memento : n, 기념물, (추억이 되는)유물
memento mori : x, 죽음의 상징(해골 따위)
Memnon : n , 멤논(트로이 전쟁에서 Achilles에게 살해된 에티오피아왕), 멤논(이집트왕 Amenhotep 3세의 거대한 상
memo : n, 메모, 비망록
memoir : x, 회상록, 실록, 전기, 연구 논문
memoire : n, 각서(외교상의)
memorabilia : n, 기억(기록)할 만한 사건, (대사건 등의) 기록, 큰 인물의 언행록
memorability : n, 잊혀지지 않는 일(사람), 인상적인 (감명을 주는) 일(사람)
memorable : a, 잊지 못할, 유명한
memorandum : n, 각서, 메모, 비망록, 정관, 매매각서, (서명 없는)비공식 서한
memorial : a, 기념하는, 추도의 기억의
memorial(decoration) day : x, 현충일, 대부분의 주에서는 5월 30일
memorialization : n, 기념함, 청원서 제출
memorialize : vt, 기념하다, 기념식을 거행하다, 청원서를 제출하다, 건의하다
memorial park : x, 묘지
memoried : a, 추억이 많은, (보통 복합어를 이루어) 기억(력)이 ...한
memoriter : a, ad, 기억(암기)에 의한(의하여)
memorize : vt, 암기하다, 기록하다
memory : n, 기억, (개인의)기억력, 추억, 죽은 뒤의 명성, (고인의)영, 기념
memory bank : x, (컴퓨터)기억 장치, 데이터 뱅크
memory card : x, 메모리 카드(자기 테이프 대신에 반도체 메모리 칩을 내장한 카드)
memory cell : x, (컴퓨터)기억소자
memory drum : x, (컴퓨터)기억드럼, 학습할 사항이 주기적으로 제시되는 회전식 장치
memory map : x, (컴퓨터)기억 배치도
memory trace : x, 기억 흔적(engram)(학습의 물질적 기초가 되는 뇌수 등이 지속적으로 나타내는 변화)
memsahib : n, (인도) 마님(인도인이 서양의 기혼 여성을 부르는 경칭)
men : n, man의 복수
men's lib(liberation) : x, 남성 해방 운동(그룹)(전통적으로 남성에게 만 과해져 온 역할에서 부터의 해방)
menace : n, 협박, 위협, 공갈, 위험한 것, 귀찮은 것, 골칫거리, 위협하다, 협박하다
menacing : a, 위협하는, 협박적인
menacingly : ad, 협박적으로
menage : x, 가정, 가사, 가족
menagerie : n, (이동)동물원, 구경거리의 동물
menarche : n, 초경, 초조
mencius : n, 맹자
mend : vt, 고치다, 수선하다, 정정하다, (행실을)고치다, (사태를)개선하다, 걸음을 빠르게 하다
mendable : a, 고칠 수 있는
mendacious : a, 허위, 거짓말하는 버릇
mendacity : n, 거짓말하기(하는 버릇, 성격), 허위, 거짓말
mendel : n, 오스트리아의 유전학자
Mendel's laws : x, 멘델의 유전(법칙)
mendelevium : n, 멘델레븀(방사성 원소)
mendelevium : n, 멘델레븀(방사성 원소; 기호 Md, Mv, 번호 101)
Mendelian : n, a, 멘델(의 법칙)의, 멘델 학설 지지자
mendelism : n, 멘델의 유전학설
mendelssohn : x, 독일의 작곡가
mender : n, 수선인
mendicancy, mendicity : x, 거지 생활
mendicant : a, n, 구결하는, 탁발하는, 거지, 빌어먹는, (천주교의) 탁발 수도사, 동냥아치
mendicity : n, =MENDICANCY
mending : n, 고치는 일; 수선, (집합적) 수선할 것, 파손품, 수선 부분
mending tape : n, 멘딩 테이프(불투명하게 코팅하여 그 표면에 글자를 쓸 수 있는 플라스틱 접착 테이프)
menelaus : n, 메넬라오스, (스파르타의 왕, helen의 남편, agamemnon의 동생)
menfolk(s) : n, , 남자들
mengovirus : n, 멩고바이러스(뇌심근염을 일으키는 바이러스)
Mengzi : n, 맹자
menhaden : n, 청어의 일종(비료 또는 기름용)
menhir : n, 멘히르, 선돌
menial : x, (비)천한, 하인의
meningeal : a, 뇌막의
meninges : n, 뇌막, 수막
meningitis : n, 뇌막염
meninx : n, 뇌막, 수막
meniscus : n, 초승달 모양(의 것)
menmilliners : x, 여성 모자류 제조 판매업자(남자), 멋쟁이, 변변찮은 일에 시경 쓰는 사람
Mennonite : n, 메노파 신도(기독교의 개신교의 일파)
menopause : n, 폐경기, 갱년기
menorah : n, (유대교의) 가지가 7(9)개 있는 장식 촛대
menorrh(o)ea : n, (정상적인) 월경, 월경 과다(증)
mensal : a, 식탁(용)의
mensal : a, 매월 (다달)의
mensch : n, 훌륭한 사람, 고결한 사람, 명사, 위인
menses : n, 월경, 멘스
menses : n, 월경
Menshevik : n, 멘셰비키(러시아 사회 민주 노동당 온건파의 일원)
Menshevism : n, 멘셰비키의 정책(사상)
mens rea : x, 범의
mens room : x, 남성용 변소
mens sana in corpore sano : x, 건전한 신체에 건전한 정신
menstrual : a, 월경의, 다달의
menstruate : vi, 월경하다
menstruation : n, 월경(기간)
menstruous : a, 월경의, 월경이 있는
menstruum : n, 용매, 용제
mensurability : n, 가측성
mensurable : a, 측정 할 수 있는
mensuration : x, 측정, 측량, 측정법, 구적법
menswear : n, 신사용품, 신사복, 남성용 의류
menswearment : n, 결과, 수단, 상태 따위를 나타내는 명사 어미
mental : a, 마음의, 정신의, 지적인, 마음으로 하는, 암산의, 정신병의
mental age : x, 정신 연령
mental arithmetic : x, 암산
mental asylum : x, 정신 병원
mental blindness : x, 심맹, 눈으로는 보아도 적당히 인식하지 못함
mental body : x, 멘탈체(육체에 겹쳐 영계 (mental plane)에 거주하는 몸(body))
mental case : x, 정신병 환자
mental cruelty : x, 정신적 학대(흔히 이혼의 근거로 인정됨)
mental culture : x, 정신수양
mental defective : x, 정신 병자, 정신 박약자
mental deficiency : x, 지능 장애, 정신 박약, 정신적(지적) 결함(moronity, inbecility, idiocy를 포함)
mental disorder : x, 정신 착란
mental faculty : x, 지능
mental healing : x, 정신 요법
mentalism : n, 유심론
mentality : n, 정신 활동, 심성, 심적 상태, 정신(능력), 지능
mentally : ad, 마음으로, 정신적으로, 지력(기질)상으로
mental patient : x, 정신병 환자
mental reservation : x, 심중 유보
mental retardation : x, 정신 지체, 정신 박약
mental specialist : x, 정신과 의사
mental telepathy : x, 정신 감응, 독심술
mental test : x, 지능 검사
mentation : n, 정신 작용(기능), 지적 활동(성); 심리(정신) 상태
menthene : n, 멘틴, 무색 유상의 탄화수소
menthol : x, 멘톨, 박하뇌
mentholated : a, 멘틀을 함유한, 박하뇌가 든; 멘틀로 처리한
menticide : n, 두뇌파괴, 두뇌 살해(고문, 세뇌, 약제 따위에 의한)
mention : vt, 언급하다, 이름을 들다, 진술하다
mentioned : a, (보통 복합어를 이루어) 언급한, 상기한
mentor : x, 경험, 신용 있는 조언자
menu : x, 식단, 메뉴
menudriven : a, 메뉴에 따라 조작하는 구조의
meow : x, 야웅(하고 울다)
meperidine : n, 메페리딘(합성 진통제, 진경제)
Mephistophelean, Mephistophelian : a, (faust를 유혹해서 혼을 팔게 한 악마) mephistopheles 같은, (간사하고)냉혹한
Mephistopheles : n, 메피스토펠레스(Faust 전설, 특히 Goethe의 Faust중의 악마), 지극히 악한(음흉한)사람, 유혹자
mephitic, -ical : a, 악취(독기) 있는
mephitis : n, (땅속으로 부터의) 독기, 악취, 메피티스(역병의 여신)
meprobamate : n, 정신 안정제의 일종
mercantile : x, 상업의, 무역의, 돈에 눈이 어두운
mercantile agency : x, 상업 흥신소
mercantile law : x, 상법, 상관습법
mercantile paper : x, 상업 어음, 약속어음, 환어음 따위
mercantile system : x, 중상주의
mercantilism : n, 중상주의
mercaptan : n, 메르캅탄, 도시가스 착취제
Mercator : n, 메르카토르
Mercator('s) projection : x, 메르카토르식 투영도법
mercenary : a, 돈을 목적으로 일하는, 고용된
mercer : n, 포목상
mercerization : n, 머서법(가공) (무명류에 광택을 내기 위한 가성소다 처리법)
mercerize : vt, 머서법으로 처리하다(광택을 냄)
merchandise : n, 상품
merchandiser : n, 상인
merchandising : n, 상품화 계획, 효과적 판매 촉진책
merchant : n, 상인, 도매상인, 무역상인, 소매상인
merchantable : a, 장사가 되는, 팔리는, 시장성 있는
merchant adventurer : x, 모험적 상인(해외 시장을 개척한 근세 초기의 무역상)
merchant bank : x, 상인 은행(환어음의 인수와 증권발행 업무 등을 하는 금융기관)
merchant fleet : x, =MERCHANT MARINE
merchantman : n, 상선, 상인
merchantman : n, 상선
merchant marine : x, 상선
merchant prince : x, 호상
merchant seaman : x, 상선 대원, 상선 선원
merchant service : x, 해상 무역, 상선
merchant ship : x, 상선
merci : int, 고맙습니다
Mercia : n, 머시아(영국 중부의 옛 왕국(7-8세기)
merci beaucoup : x, 대단히 감사합니다
merciful : a, 자비로운
mercifully : ad, 인정 많게, 자비롭게, 관대히, (문장 전체를 수식하여)고맙게도, 다행히도
merciless : a, 무자비한, 용서없는
mercuer cell : x, 수은 전지
mercurate : vt, n, 제2 수은염류
mercurial : a, 기민한, 쾌활한, 마음이 변하기 쉬운, 수은의, 수성의
mercurial gauge : x, 수은 압력계
mercurialism : n, 수은 중독(증)
mercuriality : n, 민활, 쾌활, 흥분성, 변덕, 기지가 풍부함
mercurialize : vt, 스은제로 치료하다, 수은 증기를 쏘이다, 활발(민첩, 쾌활)하게 하다
mercurial ointment : x, 수은 연고
Mercurian : , 수성을 수호성으로 하여 태어난 사람, 수성 운이 좋은 사람(활발하고 실업계, 정계에 맞음)a
mercuric : a, 수은의(을 함유한), 제2 수은의
mercuric chloride : x, 염화 제2 수은, 승홍
mercurize : vt, 수은과 화합시키다, 수은으로 처리하다
mercurochrome : n, 머큐로크롬
mercurous : a, 제1 수은의
mercurous chloride : x, 염화 제1 수은, 감홍
mercury : n, (여러신의 신부름꾼)머큐리신(상업, 웅변, 숙련, 도둑의 수호신)
mercury arc : x, 수은 아크(수은 증기 속의 아크 방전)
mercury barometer : x, 수은 기압계
mercury chloride : x, 염화 수은
mercury contamination : x, 수은 오염
mercury poisoning : x, 수은 중독
mercury pollution : x, 수은 공해(오염)
mercuryvapour lamp : x, 수은등
mercy : n, 자비, 연민, 고마움, 행운
mercy flight : x, 구급 비행(원격지의 중환자나 부상자를 비행기로 병원까지 운반하는)
mercy killing : x, 안락사(euthanasia)
mercy sakes : x, 강한 감탄을 나타내는 말(연방 통신 위원회가 금지한 four-letter word를 대신하는 표현)
mercy seat : x, 속죄소(계약의 궤의 순금 뚜껑), 하느님의 보좌
mercy stroke : x, 최후의 일격(coup degrace)(환전히 죽지 않은 사형수 등에 대한)
mere1 : a, 단순한, 명색뿐인, , 에 지나지 않는
mere2 : n, 호수, 못
Meredith : , 영국의 소설가, 시인
merely : ad, 단지, 다만
merengue : n, vi, 메렝게(아이티, 도미니카의 춤(리듬), 메렝게를 추다
meretricious : a, 야한, 매춘부 같은
merganser : n, 비오리(오리 무리)
merge : vt, 몰입케하다, 합병하다
mergee : n, 합병의 상대방(회사)
mergence : n, 몰입, 융합, 합병
merger : n, 합병, 합동
meridian : n, 자오선, 특성, 장소, 환경, 정오, 정점, 전성기
meridian altitude : x, 자오선 고도
meridional : a, 남부 유럽의, 자오선의
meringue : n, 머랭, 설탕과 달걀 흰자위로 만든 푸딩의 거죽
merino : n, 메리노양, 메리노나사
meristem : n, 분열 조직
merit : n, 뛰어남, 가치, 장점, 취할점, 공죄, 공적, 공로
merit bonus : x, 능률제 보너스
merited : a, 가치 있는, 당연한, 상응한
merit increase(raise) : x, 능률제 승급(공헌도, 실력에 따른 승급)
meritocracy : n, 수재 교육제, 실력사회, 엘리트 지배층
meritocrat : n, 엘리트, 실력자
meritorious : a, 공적 있는, 가치 있는, 칭찬할 만한
merit rating : x, 인사 고과, 근무 평정
merit shop : x, 엘리트 숍(건설 입찰에서 조합 가입과는 과계 없이, 필요 조건이 가장 미비한 응찰자와 하청 계약을 맺기)
merit system : x, (임용, 승진의) 실적(성적)제, 실력 본위 제도
merit syster : x, (공무원의)능력 본위 임용(승진)제도
merl(e) : n, 인어(여성), 여자 수영 선수
merlin : n, 쇠황조롱이(매의 일종)
Merlin : n, 멀린(Arthur 왕 이야기에 나오는 요술쟁이 영감이며 예언자)
merlon : n, 총안을 낸 보루의 돌출부
merluza : n, 메를루사(대구과의 심해어의 총칭, 야행성 육식어)
mermaid : n, (암)인어, 수영 잘하는 여자, 여자 수영 선수
Mermaid Tavern : n, 인어정(엘리자베스 여왕 시대에 문인들이 많이 모이던 옛 London의 요리집)
merman : n, 인어(남성), 남자 수영 선수
meroblast : n, 부분할(분할), 부분 할란
merohedral : a, (결정이)결면된
merolect : n, 중층 방언(상층 방언과, 하층 바언의 중간에 있는 언어 변종)
merope : n, 메토프(도리아식에서 2개의 triglyph 사이에 끼인 네모진 벽)
meropia : n, 부분맹
merovingian : a, n, (프랑스의)메로빙 왕조(486, 751)의 (왕, 사람)
merozoite : n, (포자충류의) 낭충, 메로조이트
merrily : ad, 즐겁게, 명랑하게, 흥겹게
merriment : n, 흥겹게 떠들기, 유쾌, 웃고 즐기기, 환락
merriness : n, 유쾌, 명랑
merry : a, 명랑한, 흥겨운, 유쾌한, 거나한, 즐거운
merryandrew : x, 어릿광대, 돌팔이 장사꾼의 앞잡이
merry dancers : x, 북극광
merry england : x, 즐거운 영국(영국의 미칭)
merrygoround : x, 회전목마
merrymaker : n, 마시고, 흥겹게 떠들어대는 사람
merrymaking : n, 환락, 술잔
merry men : x, 종자, 부하
merry monarch : x, 영국과 charles 2의 별칭
merrythought : n, =WISHBONE
Mersey : n , 머지 강, 아이리시 해로 흘러가는 강
Merseyside : n , 머지사이드주(1974년에 신설된 잉글랜드 북서부의 주
Mersey sound : x , 머지 사운드(1960년대에 Liverpool을 중심으로 결성된 the Beatles등 팝 그룹의 음악
Mertensian mimicry : x, 머텐스 의태(유해 동물이 무해 동물을 꼭 닮는 의태)
merthiolate : 살균 소독제 thimerosal의 상표명
mesa : n, (평원에 우뚝 솟은)대지, 봉우리가 평평한 산
mesalliance : n, 신분이 서로 다른 결혼
mescal : n, (멕시코의)메스칼 술, 선인장의 일종, 먹으면 환각 증상을 일으킴
mescal button : x, 메스칼 선인장의 정부(멕시코 인디언이 환각제로 씀)
mescaline : n, 메스칼린
mesdames : x, madame의 복수
mesdemoiselles : n, mademoiselle의 복수
meseems : vi, 생각되다
mesencephalic : a, 
mesencephalon : n, 중뇌
mesentery : n, 장간막
mesh : n, 그물코, 그물올가미, (톱니바퀴의)맞물림
meshu(g)ga, -ge : a, 머리가 돈, 미친
meshugazine : n, (주로 학생들이 취미로 편집, 발행하는) 반권위적, 풍자적인 잡지
meshwork : n, 그물 세공, 그물
meshy : a, 그물코로 된, 그물 세공의
mesial : a, 중앙의, 중간의, 정중의, 종행의; the ~ plane정중면(동물체의 좌우를 분할하는), 근심의, 중간자
mesmeric : a, 최면(술)의
mesmerism : x, 최면술을 걸다, 홀리게 하다, 매혹시키다
mesmerization : n, 최면술의 시술, 최면 상태
mesmerize : vt, 최면술을 걸다, 매혹하다, 감화하다, (꼼싹달싹 못할 정도로) 놀라게 하다
mesne : n, a, 중간의, 중간 영장의 뜻
me society : x, 자기 중심 사회
mesocyclone : n, 메조사이클론, 중형 저기압(직경 약16 km까지의 것)
mesoderm : n, 중배엽
mesolithic : x, 중석기 시대의
mesomorph : x, 중등 체형(의사람)(운동형체격)
mesomorphic : a, 중배엽혀의, 중생 식물적인, 중간상의(nenmatic과smectic의 중간 상태)
meson : n, 중간자
meson : n, 종행면, 정중면
meson factory : x, 중간자 공장, 종간자 발생 장치
mesopelagic : a, (물고기 등이) 중심해에 서식하는
mesophile : n, 중온균
mesophyll : n, 엽육
mesophyte : n, 적듄 식물, 중생 식물
Mesopotamia : n, a, 메소포타마아(아시아 남서부 Tigris, Euphrates 두 강의 하류에 있었던 고대 왕국; 현재의 이라크와 거의 같은 지역, 아라크의 옛 이름, 메소포타미아의 (사람)
mesoscale : a, (태풍, 구름 등이) 중간 규모의
mesoscaphe, -scaph : n, 중심해 잠수정
mesosphere : n , 중간층(권)(성층권과 열권의 중간)
mesothrax : n, 중흉
mesotron : n, 중간자(구칭)
Mesozoa : n, 중생 동물문
mesozoic : n, a, 중생대(의)
Mesozoic era : x, 중생대
mesquite, -quit : n, 콩과 식물의 일종(북미산)
mess : n, 잡탕, 혼합식, (군대의)회식 동료, 혼란, 북새, 한끼분, 실책
message : n, 전언, 소식, 통신, 신탁, 대통령 교서
message switching : x, (데이처 통신에서) 메시지 교환
message unit : x, (전화 요금 계산의) 통화단위, 통화도
messaline : n, (광택 있는)얇은 능직 비단
messboy : n, (배의) 식당 급사
messdeck : n, 하깁판(하급 선원들의 거실 겸 식당이 있는)
Messeigneurs, m- : n, MONSEIGNEUR의 복수
messenger : n, 사자, 심부름꾼, 전조, 선구, 연줄에 달아 바람에 울게 하는 종이
messenger RNA : x, 메신저 리보 핵산
mess hall : x, (군대, 공장등의) 식당
mess hall : x, 식당(군대, 공장 등의)
messiah : n, 메시아, 구세주, 예수
Messianic : a, 구세주의, 구세주 예수 그리스도의' 구세주적인(이상시대의)
Messianic Jews : x, 그리스도를 자기의 구세주로 여기는 유대인
messianism : n, 메시아 신앙' 메시아의 천직, (어떤 주의, 신조에의) 절대적 지지(심취, 신앙)
Messias : n, MESSIAH 1
messieurs : n, 제군, 여러분
messkit(gear) : , 휴대용 식기 세트
messmate : n, (군대, 특히 배의) 회식 동료
messtin : n, 반합, 휴대식기
messuage : n, 가옥(부속건물, 토지를 포함)
messup : n, 혼란, 혼잡, 분규, 실패, 실책
messy : a, 어질러진, 더러운
mestizo : n, 메스티소(특히, 스페인과 아메리칸 인디언의 혼혈아)
met- : prep, after beyond, with change 등의 뜻(모음 앞에서는 met-)
met1 : v, MEET의 과거, 과거 분사
met2 : a, n, METEOROLOGICAL, 일기예보, 기상청(Meteological Office)(국방성 소속)
metabasis : n, 증변, 전이, 주제 전이
metabolic : a, (신진)대사의
metabolism : n, (세포의)대사작용, 신진대사
metabolite : n, 대사 산물, 신진 대사에 필요한 물질
metabolize : vt, 물질 대사로 변화시키다, 신진 대사시키다
metaboly : n, =METAMORPHOSIS
metacarpal : n, a, 장골, 장부의
metacarpus : n, 장부, 장골
metacenter : n, 기울심, 부력
metacentric : n, (부력의) 경심
metacommunication : n, 초 커뮤니케이션(말이 아니라 시선, 동작, 몸짓, 태도 등에 의한)
metafemale : n, 초자(superfemale)(X 염색체의 수가 보통보다 많은 불임 자성생물, 초파리 등)
metafiction : n, 메타픽션(픽션을 구축함과 동시에 그 픽션의 구축 방법 자체에 대해 말하는 소설)
metagalactic : a, 전우주의
metagalaxy : n, (은하나 성운을 포함한) 전우주
metage : n, (공공 기관에서 행하는 적하의) 검량, 계량, 검량세
metagenesis : n, 순정 세대 교번
metagenetic : a, 순정 세대 교번의
metal : n, 금속, 밤자갈, 레일, 소질
metalanguage : n, 언어 분석용 언어, 실험용 언어
metal detector : x, 금속 탐지기
metal fatigue : x, 금속의 피로(도)
metalinguistics : n, 후단 언어학(민족학적 연구를 포함)
metallic : a, 금속(질)의, 엄한, 냉철한
metallic currency : x, 경화
metallicize : vt, 금속화 하다
metallic road : x, 포장 도로
metallic soap : x, 그속 비누(도료 건조네, 방수 가공용)
metallic sound : x, 금속음
metalliferous : a, 금속을 함유한(산출하는)
metalline : vt, 금속화하다, (고무를) 경화하다
metallization, -ali- : n, 금속화, 고무의 경화
metallize, -alize : vt, 금속화하다, 고무를 경화하다
metalloenzyme : n, 금속 효소
metallograph : n, 금속 현미경(금속 검사용), 금속 표면 확대도
metallography : n, 금속 조직학, 금상학
metalloid : a, n, 금속 같은, 비금속(의)
metallophone : n, 철금
metallurgical : ㅁ, 야금(술, 학)의
metallurgy : n, 야금학, 야금술
metal ski : x, 메탈 스키(경합금으로 된 스키)
metal spraying : x, 금속 용사(스프레이)(금속 용액을 표면에 뿜어 칠하는 방법)
metal tape : x, 메탈 테이프(고밀도 자기 테이프)
metalware : n, 금속 제품(특히 부엌용의)
metalwork : n, 금속 세공(물)
metalworker : n, 금속 세공인
metalworking : n, 금속 가공(업)
metamale : n, 초웅(supeermale)(상염색체 수가 보통보다 않은 생식력 없는 웅성 생물, 초파리)
metamer : n, 이성체
metamere : n, 분열편, 체절(지렁이, 곤충 등의)
metameric : a, 구조(동족)이성의, 조건 등색의(을 나타내는, 체절의
metamerism : n, 구조(동족) 이성, 조건 등색, 체절제
metamorphic : a, 변형(변태, 변용)의, 변성의, ~ rock 변성암
metamorphism : n, (암속의) 변성 작용, 변형
metamorphose : x, 변형시키다, 변질시키다
metamorphosis : n, 변형, 변태
metanalysis : n, 이분석
metapausr : n, 남성의 갱년기
metaphase : n, (세포의 유사 분열의)중기
metaphor : n, 온유
metaphorical : a, 은유의, 은유(비유)적인
metaphrase : n, 축어역, 직역
metaphrast : n, 번역자, (특히 산문을 운문으로 바꾸는) 전역자
metaphrastic : a, 직역적인, 축어적으로 번역한
metaphysic : n, (학문, 연구의) 원리 체계
metaphysical : a, 형이상학의, 공론의, 추상적인
metaphysician : n, 형이상학자
metaphysics : n, 형이상학, 추상론, 심리학
metaplasm : n, 후형질, 원형질에 포함된 성형요소
metapolitics : n, 정치 철학, 공론 정치학
metapsychic : a, 심령 연구의
metapsychics : n, (단수 취급)심령 연구
metapsychology : n, 초심리학
metasequoia : n, 메타세쿼이어(화석 식물로 생각되다가 중국에서 자생종이 발견된 낙엽 침엽 교목)
metastable : n, a, 준안정의, 준안정 원자(분자, 이온, 원자핵(등))
metastasis : n, 전이, 급전환
metastasize : vi, 전이하다
metatarsal : n, 척골
metatarsus : n, 부전부, 척골, (곤충의)척절, 경골에서 지골에 이르는 부분
metathesis : n, 자위(음위), 전환, 치환, 복분해, 환부 전위
metathoracic : a, 
metathorax : n, 후흉
metayage : n, 분익 농법
metayer : n, 분익 농부
Metazoa : n, 후생 동물
metazoan : a, 후생 동물(의)
mete1 : vt, 할당하다, 재다
mete2 : n, 경계, 경계석
metempiric : n, 초경험론, 선험철학, 초경험론자
metempirical : a, 경험을 초월한, 선험적인
metempsychosis : x, 윤회
metenkephalin : n, 메트엔케팔린(뇌에서 생기는 진통성 물질)
meteor : n, 유성
meteoric : a, 유성의, 운철(운석), 대기의, 기상상의, 유성과 같은, 유성처럼 잠시 빛났다가 사라지는
meteorite : n, 운석
meteoritics : n, (단수 취급) 유성학
meteorograph : n, 기상 자동 기록기
meteoroid : n, 유성체, 운성체
meteorolite : n, 운석
meteorological : a, 기상(학상)의
Meteorological Office : x, 기상청(the Met)(국방성 소속)
meteorological satellite : x, 기상 위성
meteorologist : n, 기상학자
meteorology : n, 기상학, 기상
meteor shower : x, 유성우(비)
meter : x, 계량기, 미터(약3자 3치), 운율, 박자
meterage : n, 계량, 미터로 측정한 양, 미터 사용료
metered mail : x, 요금 별납 우편
meter maid : x, 주차 위반을 단속하는 여경관
methacrylic acid : x, 메타크릴산
methadone : n, 메타돈, 진통제, 헤로인 중독 치료제
methadone maintenance : x, 메타돈 유치법(헤로인 중독 등의 치료 중에 대용 마약으로 메타돈을 줌)
methamphetamine : n, 메담페타민(각성제)
methane : n, 메탄
methane series : x, 메탄 열
methanogen : n, (발생적으로 박테리아, 동식물 세포와는 다른) 메탄 생성 미생물
methanol : x, 메탄올, 메틸알코올
methaqualone : n, 메타콸론(수면, 진통제, 근육 이완제)
methedrine : n, 메테드린(각성제)
metheglin : n, 메테글린, 벌꿀술(향료, 약물 등을 넣은)
methicillin : n, 메티실린(포도상 구균에 효과가 있는 합성 페니실린)
methinks : vi, ...라고 생각되다
method : n, 방법, 방식, (규칙바른)순서, 질서
methodical : a, 감리교파의
methodical : a, 조직적인, 규율바른
Methodism : n, 메서디스트파, 감리교파(의 교리)
methodist : n, 감리교도(기독교 신교의 일파), 엄격한 종교관을 가진사람, 격식 위주의 융통성이 없는 사람, 까다로운 사람
Methodist Church : x, 메서디스트(감리교)교회
methodistic, -tical : a, 메서디스트파의, 감리교파의, 규율(형식)을 중히 여기는, 엄격한
methodize : vt, 방식화하다, 순서(조직, 계통)를 세우다, 질서 있게 하다
methodological : a, 방법론의, 방법론적인
methodologist : n, 방법론 학자
methodology : n, 방법론
methotrexate : n, 메토트렉사트(급성 백혈병에 사용)
methought : vi, METHINKS의 과거
methoxyflurane : n, 메톡시플루란(전신 흡입 마취제)
meths : n, 변성 알코올
methuselah : n, 므두셀라, 969세까지 살았다는 남자
methyl : n, 메틸
methyl alcohol : x, 메틸알코올
methylate : vt, 메틸을 섞다
methylated spirit(s) : x, 변성 알코올 (마실수 없음, 램프나 해터용)
methyl blue : x, 메틸청(청색의 유기염료, 필기용 잉크나 생체 염색에 씀)
methyl chloride : x, 염화 메틸
methyl chloridep : x, 염화 메틸
methyldopa : n, 메틸도파(혈압 강화제)
methylene : n, 메틸렌
methylic : a, 메틸의, 메틸을 함유한
methylmercury : n, 메틸 수은(살충제 등에 씀)
meticulous : a, 옹졸한, 지나치게 세심한
metier : n, 직업, 전문, 장기, (작가의)수법, (화가의)메티에
metis : n, 혼혈아(특히 캐나다의 프랑스인과 아메리칸 인디언간의)
METO : x, Middle East Treaty Organization중동 조약 기구 (현재는 CENTO)
Met Office : x, 기상청, (집합적) 기상청 직원
Metol : n, 메틀(사진 현상의 주요 약물; 상표명)
Metonic cycle : x, 메톤 주기(lunar cycle)(달이 같은 위상을 되풀이하는 19년의 주기)
metonym : n, 환유어
metonymic, -ical : a, 환유적인
metonymy : n, 환유
metoo : vt, 흉내내다
metooism : n, 모방주의
metooist : n, 모방주의자
metooistic : a, 
metr- : x, (연결형)자궁, 핵, 핵심의 뜻(모음 앞에서는 metr-)
metrazol : x, 메트라졸, 정신병의 충격 요법에 쓴 강심제
metrazol : x, 강심제의 일종
Metrecal : n, 메트리컬(저칼로리의 대용 식품; 상표명)
metric : a, 미터법의, 계량의
metrical : a, 운율의, 측량(용)의, 측량법의
metricate : vt, vi, 미터법화하다, 미터법으로 이행하다(metricize)
metrication : n, (도량형의) 미터법 환산
metricize : vt, vi, 운문으로 하다, 운율적으로 하다, 미터법으로 고치다, (나타내다, 환산하다), 미터법으로 이행하다(을 채택하다)
metrics : n, (단수 취급) 운율학, 작시법
metric system : x, 미터법
metric system : x, 미터법(도량형 봅에서 단위를 meter, liter, gram으로 함)
metric ton : x, 미터톤(=1000kg)
metrist : n, 운율학자, 작시가
metro : n, (특히 파리의)지하철
metroland, M- : n, (런던의) 지하철 지구(도심부), 그 지구의 주민
Metroliner : n, 메트로라이너(특히 New York와 Washington, D.C.를 잇는 고속 철도)
metrological : a, 
metrology : n, 도량형, 도량형학
metromania : n, 작시광
metronidazole : n, 메트로니다졸(trichomoniasis의 치료제)
metronome : n, 박절기
metronomic, -ical : a, 메트로놈의, (템포가) 기계적으로 규칙바른
metronymic : a, n, MATRONYMIC
metropolis : n, (일국의)주요도시, 수도, 중심지
metropolitan : a, 수도의, 대주교(대감독)교구의
metropolitan area : x, (대)도시권
metropolitan county : x, 메트로폴리스주, 특별시(지방 제도 개혁으로 생긴 대도시를 주도로 하는 주; 1986년 폐지)
metropolitan district : x, (영) 특별시 자치구(metropolitan county의 행정구)
Metropolitan Manila : x, (Quezon City를 포함한) 수도 마닐라
Metropolitan Opera House : x, (뉴욕의) 메트로폴리탄 오페라 극장(1966년 부터는 Lincoln Center에 있음)
metropolitan police : x, 수도경찰
Metropolitan Railway : x, (연결형) 측정법(학, 술)의 뜻
Metternich : n, 메테르니히 Prince von ~ (1773-1859)(오스트리아의 정치가)
mettle : n, 기질, 성질, 용기, 정열
mettlesome : a, 위세좋은
meuniere : a, 뫼니에르로 한(밀가루를 발라 버터로 구운), sole ~ 서대 뫼니에르
mev : n, 백만 전자볼트, 메가볼트
mew : n, vi, 야옹(울다), 고양이가
mew : n, 갈매기
mewl : vi, 가냘픈 소리로 울다, 고양이처럼 울다
mews : n, (빈터 주위의) 마구간, (그 것을 개조한) 아파트, (그러한 아파트가 있는)골목 (종종 Mews로 지명에 사용됨)
Mexican : n, a, 멕시코(사람)의
Mexican brown : x, 멕시코제의 흑갈색 헤로인
Mexican Spanish : x, 멕시코의 스페인 말
Mexican War : x, 멕시코 전쟁(미국과 멕시코와의 싸움(1846-48))
Mexico : n, 멕시코(공화국)(북미 남부의 공화국; 수도 Mexico City)
Mexico City : n, 멕시코 시티(멕시코의 수도)
MEZ : x, Mitteleuropaische Zeit(G =Central European Time)  중앙 유럽 표준시
mezuzah, za : n, (유대교)메이즈자(신명기의 몇 절을 기록한 양피지 조각)
mezz : n, (미) 마리화나
mezzanine : n, 중이층, 무대 밑
mezzo : x, 반쯤, 알맞게
mezzo forte : x, 조금 강하게
mezzo piano : x, 조금 약하게
mezzorelievo : n, 방양각, 반돋을 새김
mezzosoprano : n, 메조소프라노(가수)
mezzotint : n, 그물눈 동판의 일종, 그물눈 동판술
MHG, M.H.G. : x, Middle High German중세고지 독일어
mho : n , (ohm을 거꾸로 쓴 것)모 (전기 전도율의 단위)
mi : n, 미, 장음계의 제 3음
miami : n, 미국 florida주 남동부의 해안도시, 피한지
Miamian : a, n, 마이애미의 (주민)
Miami Beach : n, 마이애미 비치(미국 Florida 주 남동부의 도시; 피한지)
miaow, -aou : n, vi, (고양이가)야옹(울다)
miasma : x, (늪에서나오는)독기, 말라리아병독
miasmal : a, 독기의(같은), 해로운, 유해한
mica : n, 운모, 돌비늘
micaceous : a, 운모(모양)의
micah : n, 히브리의 예언자, 미가서
mica schist(slate) : x, 운모 편암(점판암)
Micawberism : n, 공상적 낙천주의(Dickens의 David Copperfield에 나오는 인물 Micawber에서)
mice : n, mouse의 복수
micelle, -cell : n, 교질 입자, 미셀
michael : n, 미가엘(대천사의 한 사람), 남자의 이름
michaelmas : n, 미가엘축일, 9월 29일, 영국에서는 청산일
Michaelmas daisy : x, 갯개미취, 아스터
Michaelmas goose : x, 미가엘 축일에 먹는 거위
michelangelo : n, 이탈리아의 화가, 조각가, 건축가
Michelle : n, 여자 이름
Michelmas term : x, 가을 학기(제 1학기, 보통 10월-12월)
michigan : n, 미국 중북부의 주, 미시간호(5대호의 하나)
Michigan bankroll(roll) : x, (미)고액권을 한 장 얹은 가짜 돈 뭉치
Michigander : n, 미시간주 사람
micing faucet : x, 온수, 냉수 혼합 수도 꼭지
mick : n, (아일랜드 사람의 대표적 이름으로서)아일랜드 사람, 로마 카톨릭 교도
micketmouse : vt, (만화 영화 등에서) 배경 음악을 넣다
Mickey : n, 남자 이름
mickey, M- : n, take the ~ out of...(영) ...을 놀리다, 곯리다, 비웃다, 모욕하다
Mickey Finn, m-f- : x, 미키핀(마약이나 강한 하제를 넣은 술)
Mickey Mouse : x, 케케묵은, 싸구려의, 전동식 폭탄 투하 장치
mickle : n, a, 많음, 많은, 큰, 다량(의)
Micmac : n, (캐나다 남동부 인디언의) 미크맥족, 그들이 쓰는 알공킨 말
MICR : x, magnetic ink character reader(컴퓨터)자기 잉크 문자 판독기
micr- : x , (연결형) 소..., 미..., 100만분의1...의 뜻, (모음 앞에서 micr-)
micra : n, MICRON의 복수
micro : n, a, 매우 작은(것), 마이크로스커트
microanalysis : n, 미량 분석
microapore : n, 소포자, 작은 홀씨
microbalance : n, 미량 천칭
microbar : n, 마이크로바(100만분의 1바; 압력의 단위)
microbe : n, 미생물, 세균
microbial : a, 미생물의, 세균에 의한
microbial cell : x, 미생물의 균체
microbial transformation : x, 미생물 변환
microbiological : a, 
microbiology : n, 미생물학
microbism : n, 세균 감염(증)
micro book : x, (확대경으로 보는) 극소본, 마이크로 북
microbot : n, 초소형 로봇
microburst : n, 순간 돌풍(종종 비행기 사고의 원인이 됨)
microbus : n, 마이크로(소형)버스
microcamera : n, 현미경 사진용 카메라
microcapsule : n, (약물 등의) 미소 캡슐
Microcard : n, 마이크로카드(축사 사진 카드; 상표명)
microcephalic : a, 소두의, 이상 소두의
microcephaly : n, 소두(두개 내용량이 1350cc 미만), (이상) 소두증
microchemistry : n, 미량 화학
microchip : n, 마이크로 칩, 극미 박편(전자 회로의 구성 요소가 되는 미소한 기능 회로)
microchronometer : n, 초시계
microcircuit : n, 소형(마이크로)회로, 집적회로
microclimate : n, 소기후(한 국지의 기후), 미기후(소기후 보다 더 작은 지점의 기후)
microclimatology : n, 소(미)기후학
microclose : a, 대단히 가까운, 대단히 정밀한
micrococcus : n, 미구균, 단구균
microcode : n, 마이크로코드(마이크로 프로그래밍의 코드)
microcomputer : n, 마이크로 컴퓨터
microcontinent : n, 미소 대륙, 대륙형 소암반
microcopy : n, vt, vi, 축사하다
microcorneal lens : x, 소각막 렌즈(각막만을 덮는 콘택트렌즈)
microcosm : n, 소우주, (우주의 축도로서의)인간
microcosmic : a, 
microcosmic salt : x, 인염
microcrack : n, vi, vt, (유리 등의)미소 균열, 미소 균열이 생기다(생기게 하다)
microcrystalline : a, 미정질의
microculture : n, 협역 문화(권)(문화 단위로서의 소집단의 문화), (미생물, 세포 등의) 현미경 관찰용의 배양, 미크로 배양
microcurie :  n, 마이크로퀴리(방사능 강도의 단위 curie의 100 만분의 1)
microdissection : n, 현미 해부
microdistribution : n, 미소(마이크로) 분포
microdot : n, 마이크로도트, (전자력으로 축소한 문서의 카피), 환각제
microearthquake : n, 미소 지진
microeconomics : n, 미시 경제학
microelectrode : n, 미소 전극
microelectronic engineering : x, 마이크로 전자 공학
microelectronics : n, (단수 취급) 극소(마이크로) 전자공학
microelement : n, 미량 원소
microencapsulate : vt, (미소한 약 등을)마이크로 캡슐에 넣다
microencapsulation : n, 
microfarad : n, 백만분의 1 farad, 마이크로 패러드
microfiche : n, 마이크로피시, 여러장의 마이크로 필름을 수록한 시트 모양의 것
microfilament : n, 미사, (세포질의) 미세 섬유
microfilm : n, vt, vi, 마이크로 필름(에 찍다, 찍히다)
microform : n, vt, 마이크로폼, 미소 축사(판)(많은 정보를 극소 사이즈에 수록하는 축소 사진 인쇄(물)), 마이크로 필름으로 복사하다
microfossil : n, 미화석
microgauss : n, 마이크로가우스(100만분의 1가우스)
microgram : x, 백만분의 1g
micrograph : n, 세사기, 현미경 사진(도)
micrographics : n, (단수 취급) MICROFORM에 의한 미소 축소(업)
micrography : n, 현미경 관찰물의 촬영(묘사, 연구)(법), 현미경 검사, 세사술
microgroove : n, 가는홈, 그 lp레코드
microinjection : n, 현미 주사
microkid : n, 컴퓨터를 좋아하는 아이
microlens : n, 마이크로 렌즈, 극소 사진 촬영용 렌즈
microlith : n, 미소 석기, 소결석
micrology : n, 미물학, 꼬치꼬치 캠
micromachine : n, 마이크로 기계
micromachining : n, (실리콘의) 미세(미크로) 기계 가공
micromanipulation : n, 현미 조작(수술) (현미경을 이용한 해부, 주사 등의 조작)
micromation : n, 컴퓨터의 처리 결과를 마이크로필름에 출력하는 방법
micromechanics : n, 마이크로 공학(micromachine의 연구 개발 분야)
micromesh : a, (스타킹 등이) 그물코가 아주 작은, 극미 그물코의
micrometastasis : n, (암세포의) 미소한 전이
micrometeorite : n, 유성진
micrometeoroid : n, 미소 유성체, 유성진(micrometeorite)
micrometeorology : n, 미기상학
micrometer : n, 마이크로미터, 측미계, 거리측정기
micrometer caliper : x, 측미 캘리퍼스, 측미기(정밀 측정기)
micrometer screw : x, 측미 나사
micrometry : n, 측미법(술)
micromicron : n, micron의 100만분의 1
microminiature : a, (전자부품이)초소형의
microminiaturize : vt, (전자 장치 등을)초소형화하다
microminicomputer : n, 마이크로 미니 컴퓨터(16비트 이상의 마이크로 프로세서를 쓴 미니 컬퓨터)
micromodule : n, (인공 위성 등의) 초소형 전자 회로
micromorphology : n, (토양의) 미소(미세) 구조, 미소 형태학
micron : n, 미크롱
microneedle : n, (현미경 조작에 사용되는) 현미 침
Micronesia : x, 미크로네시아, 적도 이북, 필리핀 동쪽의 군도
Micronesian : n, a, 미크로네시아(사람, 말)의, 미크로메시아 사람, 미크로네시아 말
micronize : vt, (미크론 정도로)미소화하다
micronucleus : n, (다핵성 원생동물, 특히 섬모충의) 소핵, 부핵
micronutrient : n, a, 미량 영양소(비타민 등), 무기 염류, 미량 영양소(원소)의
microorganism : n, 미생물(박테리아 등)
micropaleontology : n, 미고생물학
microphobia : n, 미생물(미소물) 공포증
microphone : n, 마이크(로폰)
microphone boom : x, 마이크로폰 붐(마이크로폰을 매다는 틀)
microphotograph : n, 마이크로 필름, 축소 사진, 현미경 사진
microphysics : n, (단수 취급) 미시적 물리학
microphyte : n, 미소 식물, 박테리아
micropoint : a, 아주 가는 펜끝의, 가는 글씨용의
micropolis : n, (대도시의 시설을 갖춘) 소형 도시
micropopulation : n, (특정 환경 내의) 미생물 개체군, 협역 생물 집단
microporous : a, 미소한 구멍이 있는, 미공성의
microprint : n, 축사사진
microprism : n, 마이크로 프리즘(초점 스크린 위에 있는 미소 프리즘; 초점이 안 맞으면 상이 흐려 보임)
microprobe : n, 마이크로 프로브(전자 빔을 이용한 시료의 미량 분석용 장치)
microprocess : vt, (데이터를) 마이크로 프로세서로 처리하다
microprocessing unit : x, 초소형 연산 처리 장치
microprocessor : n, 마이크로프로세서
microprogram : n, vt, 마이크로 프로그램(마이크로 프로그래밍에서 쓰는 루틴(routine), (컴퓨터에)마이크로프로그램름을 짜넣다
microprogramming : n, microprogram하기
micropublication : n, 마이크로 출판물
micropublish : vi, vt, 마이크로폼으로 출판하다
micropublishing : n, (마이크로폼에 의한) 마이크로 출판, 마이크로폼 간행
micropulsation : n, 자자기 미맥동, 초단 맥동
microquake : n, 미소 지진
microreader : n, 마이크로리더, 마이크로필름을 확대, 투사하는 장치
microrevolution : n, 마이크로 혁명(미세 기술의 대변혁)
microrocket : n, 마이크로 로켓(실험용 극소형 로켓)
microsample : n, (실험 등에 쓰는) 물질의 극소 표본, 현미 시료(표본)
microscience : n, 마이크로 사이언스(물질의 미세 구조를 연구하는)
microscope : n, 현미경의, 극히 미세한
microscopic, ical : a, 현미경의(에 의한), 현미경적인, 현미경 같은, 극히 미세한, 극미의, 극히 작은, 초소형의
microscopist : n, 현미경 (숙련) 사용자
microscopy : n, 현미경 검사(사용법)
microsecond : n, 마이크로 초(시간의 단위; 100만분의 1초)
microsection : n, 검경용의 얇은 조각, 현미 절편
microseism : n, (지각의)미진동, 맥동(지진 이외의 원인에 의한)
microseismograph : n, 미진계
microseismometry : n, 미진 측정법
microskirt : n, 마이크로스커트, 미니스커트보다 짧음
microsleep : n, 마이크로 수면(깨어 있을 때의 순간적인 잠)
microslide : n, 미소(마이크로) 슬라이드(초미생물의 현미경 검사용)
microsome : n, (세포질 속의) 미립체, 마이크로솜
microspectroscope : n, 현미 분광기
microsphere : n, 마이크로스피어(중심 소체를 둘러싼 투명한 부위), 미소 구체
microstate : n, 미소 국가(특히 최근에 독립한 아시아, 아프리카의)
microstructure : n, 미세(마이크로) 구조(현미경 없이는 복 수 없는 생물(조직), 금속, 광물 등의 구조)
microstudy : n, (어떤 분야의) 극소 부분의 연구, 특수 연구
microsurgery : n, 현미 외과(수술)
microteaching : n, 마이크로 티칭(교습생이 수명의 학생을 5-20분간 가르치는 것을 녹화하여 평가함)
microtektite : n, 미소 텍타이트 (해저 침전물 중의 미세한 우주진의 일종)
microtext : n, 마이크로텍스트(MICROFORM으로 만들어 놓은 텍스트)
microtexture : n, (암석, 금속 등의) 미소 구조
microtheory : n, 마이크로 이론(개개의 작은 현상을 설명하는)
microtome : n, 마이크로톰, 검경용의 얇은 조각을 써는 절단기, 검경용 메스
microtransmitter : n, (추적 등에 쓰는) 초소형 전자 송신기
microtubule : n, (세포내에 있는) 미소관
microvillus : n, 미융모, 융모양 돌기(동물 세포 표면에 있는 세포질의 가는 털 모양의 돌기)
microwave : n, 극초단파
microwave oven : x, 전자 레인지
microwave sickness : x, 극초단파 병(극초단파를 항상 몸에 쬠으로써 생기는)
microworld : n, (현미경 밑에 펼쳐지는) 미소한 세계
microzyme : n, 효모균, 발효 미생물
micrurgy : n, 현미 조작(법), 현미 해부
micturate : vi, 방뇨(배뇨)하다, 오줌누다
micturition : n, 요의 빈번, 방뇨(작용)
Mid-Atlantic : a , (대서양의 중간의 뜻에서)(영어가) 영어와 미어의 중간적 성격의, (상품이) 영미 양국에 두루 쓰이게 만든
Mid-Lent Sunday : x, 사순절(Lent)의 넷째 일요일
mid-Victorian : a, n, 빅토리아 왕조 중기의, 구식의, 근엄한, 빅토리아 왕조 중기의 사람, 그 시기의 이상과 취미를 가진 사람, 구식인(근엄한) 사람
mid1 : a, 중앙의, 중간의, 중부의
midafternoon : n, 이른오후(3시 전후)
midair : n, a, 공중, 중천, 공중의
Midas : n, 미다스, 손에 닿는 모든 것을 황금으로 변하게 하는 힘을 부여받았던 프리지아의 왕
midbrain : n, 중뇌
midcontinent : n, 대륙의 중심부
midcourse : a, n, (우주선의)궤도 중간의, 중간 궤도
midcourse correction : x, 중간 궤도 수정
midcult : n, 중간 문화
midday : n, a, 정오(의)
midden : n, 쓰레기 더미, 똥 무더기, 패총
Middld Way : ㅌ, =MIDDLE PATH
middle : n, a, 중앙(의), 중간(의), 중부(의), 중명사(사람의)몸통, 허리
middle age : x, 중년(40, 60)
middleaged : a, 중년의, 중년에 알맞은
middleaged : a, 중년의
middleaged spread : x, 중년이 되어 허리가 굵어지는 일
middle ages : x, 중세(기)
middle america : x, 중앙 아메리카, 중미
middle article : x, (신문, 잡지의)중간 기사
middle atlantic states : x, 미국 중부 대서양 연안의 주
middlebrow : a, n, 지식(교양)이 중간쯤 되는 (사람), 어느 정도 교양이 있는(사람)
middle C : x, 중앙 다(1점 다; 이 음을 내는 건반)
middle class : x, 중류사회(중산 계급)의
middle classes : x, 중산 계급, 중류 사회
middle course : x, 중도
middle distance(ground) : x, (그림의)중경, 중거리(경주)
middle distillate : x, 중간 유분(등유나 경유)
Middle Dutch : x, 중세(중기) 네덜란드 말
middle ear : x, 중이
middle earth : n, (천국과 지옥 사이의) 이승, 지구
middle east : x, 중동
Middle Eastern : x, 중동의
middle echelon : x, 중간 관리직 계층
Middle Empire : x,  =MIDDLE KINGDOM 2
Middle English : x, 중세(중기) 영어(약 1100-1500년)
middle finger : x, 가운데 손가락
Middle Flemish : x, 중세(중기) 플랑드르말(14-16세기)
Middle French : x, 중세(중기) 프랑스어(14-16세기)
middle game : x, (체스 등 board game의) 중반전
Middle Greek : x, 중세(중기) 그리스어
middle ground : x, 중됴, 중도
middlegrounder : n, 중용을 택하는 사람, 중도파
middle guard : x, (미) 미들 가드
Middle High German : x, 중세(중기) 고지 독일어(12-15세기)
middle kingdom : x, 중기 고대 이집트 왕국, 중국
middle life : x, 중년, 중류의 생활
Middle Low German : x, 중세(중기) 저지 독일어(12-15세기)
middleman : n, 중간 상인(생산지화 소매상 혹은 소비자와의 중간에 있는), 브로커, 중매인, 매개자, 중용을 취하는 사람
middleman : n, 중매인, 매개자
middle management : x, 중간 관리자층
middle manager : x, 중간 관리자
middlemost : a, 한복판의, 한 가운데의
middlemost : a, 한가운데의
middle name : x, 중간 이름
middle of the road : x, 중용의, 중도의
middle of the roader : n, 중도파(중간 노선)의 사람
middle passage : x, (아프리카 서해안과 서인도 제도를 연결하는) 대서양 중앙 항로
middle path : x, 중도
middleroader : n, =MIDDLE OF THE ROADER
middlescence : n, (사람의) 중년기
middle school : x, 중학교(junior high school)
Middlesex : n, 미들 섹스(잉글랜드 남동부의 옛 주; 1965년 Greater London에 편입)
middlesex : n, 이전의 잉글랜드 남부의 주
middle sized : x, 중형의
middle states : x, 중부 여러 주
middle term : x, 중명사, 중항
Middletown : n, 마들타운(가공의 전형적인 미국 중류 도시)
middle voice : x, (그리스 말 등에서의)중간태
middle watch : x, 야간 당직(오전 0시 부터 4시까지)
middleweight : n, a, 평균 체중을 가진 사람, (레슬링)미들급 선수, 평균 체중을 가진, (레슬링)미들급의(66.7-72.6kg)
Middle West : x, 미국 중서부
middling : a, 중등의, 보통의
middy blouse : x, (소녀가 입는) 세일러식의 깃이 달린 블라우스
Mideastern : a, 중동의
midengined : a, 엔진이 차체의 중앙부(운전석 바로 뒤)에 달린
midfield : n, a, (경기장의)중앙부, 필드 중앙부(의)
Midgard : n, 인간계, 이 세상(this world)
midge : n, 모기, 파리매, 꼬마
midget : n, a, 난쟁이, 꼬마, 극소형의(물건), 아주 작은
Midgetman : n, 미지트맨(핵탄두가 하나인 이동식 미사일)
midget submarine : x, (2인승의)특수 잠수함
Mid Glamorgan : n, 미드 글라모건(1974년에 신설된 웨일스 남부의 주)
midgut : n, 중장
midheaven : n, 중공, 중천, 자오선
midi : n, 중간 길이의 스커트(드레스)
midinette : n, (파리의) 여자
midiron : n, (골프)2번 아이언, 중거리용 클럽
midiskirt : n, 미드스커트
midland : a, (나라의)중부의, 내지의, 영국 중부 지방의, 육지로 둘러싸인
Midland dialect : x, 영국 중부 지방의 방언, 내륙 지방의, 중부 지방의, 육지로 둘러싸인, 잉글랜드 중부 지방의, 미국 중부 지방의
Midland sea : n, 지중해
midleg : n, 다리의 중간 부분, 곤충의 둘째번 다리, 다리의 중간 부분까지
midlife : n, 중년(middle age)
midlife crisis : x, 중년의 위기(청년기가 끝남을 자각함으로써 생기는)
midline : n, (신체 등의) 중심선
Midlothian : n, 미들로디언(스코틀랜드의 옛 주)
midmashie : n, (골프) 미드 매시(3번 아이언)
midmorning : n, 오전의 중반(해돋이 부터 정오까지의 시간)
midmost : a, ad, 한복판의, 중심부에, 한복판에
midnight : n, a, 자정(의), 한밤중(의)
midnight sun : x, 한밤중의 태양(극권내에서 한여름에 볼 수 있는)
midnoon : n, 정오, 한낮
midocean ridge : x, 중앙 해령, 대양 산령
mid off : x, (크리켓)투수좌측 외야수
mid off : x, (크리켓) 투수의 왼쪽에 있는 야수의 위치
mid on : x, (크리켓)투수우측 외야수
mid on : x, (크리켓) 투수의 오른쪽에 있는 야수(의 위치)
midpoint : n, (선, 공간의) 중심점, 중앙; (시간, 활동의) 중간(점)
midrib : n, (잎의)  주맥, 중륵
midriff : n, 횡경막
midsection : n, 중앙부, 중간부, 동체의 중간부
midsemester : n, a, (미)학기 중간(의)
midship : a, 배의 중앙부의
midshipman : n, 해군 소위 후보생
midsize : a, n, 중형의, 중형차
midst : n, 중앙, 한가운데
midstream : n, 중류
midsummer : n, 한여름(하지무렵)
midsummer daisy : x, 프랑스 데이지
midsummer day : x, 세례자 요한 축일, 6월 24일
Midsummer Eve(Night) : x, Midsummer Day의 전날 밤
midsummer madness : x, 극도의 광란
midterm : a, 중간의, (학기, 대통령 임기 등의)중간의, 중간 시험
midtown : n, downtown과 uptown의 중간 지대
midway : a, ad, n, 중도의(에), 중간쯤에, (미) (박람회 등의) 오락장(여흥장)거리, 복도, 통로
Midway Islands : n, 미드웨이 제도(Hawaii의 북서쪽에 있음; 미국령)
midweek : a, n, 주일 중간쯤, 수요일(퀘이커파 교도의), 주일 중간쯤의
midweekly : a, ad, 주의 중간쯤의(에)
Midwest : n, (미)=MIDDLE WEST
Midwestern : a, (미) 중서부의
midwife : n, 조산원, 산파
midwifery : n, 조산술, 조산학
midwinter : n, 한겨울
midyear : a, n, 1년의 중간쯤의, 학년 중간의, 1년의 중간 쯤, 학년의 중간, 중간 시험
mien : n, 풍채, 태도
miff : n, 부질 없는 싸움, 분개
miffy : a, 화를 잘재는
mig : n, 공기돌의 일종, (단수 취급) 공기놀이
MIG : x, 미그기, 소련의 제트 전투기
might : , may의 과거
might1 : n, 힘, 정신적, 육체적
might have been : n, 그렇게 되었을지도 모를 일, 더 훌륭(유명)해졌을는지도 모를 사람
mightily : ad, 힘차게
mighty : a, ad, 힘센, 강대한, 위대한, 굉장한, 거대한
mignon : a, 작고 예쁘장한, 우아(섬세)한
mignonette : n, 목서초, 쑥색, 가는 실로 뜬 레이스
migraine : n, 편두통
migrant : a, 이주하는, 이주민, 철새
migrate : vi, (해외로)이주하다, (새, 물고기가)이동하다
migrating : a, 이주하는, 이동하는
migration : n, 이주, (분자내의)원자 이동
migrator : n, 이주자, 후조, 철새
migratory : a, 이주하는
mike1 : n, 마이크
mike2 : vi, n, (영)게으름 피우다, 빈둥거리다, 게으름, 빈둥거림
Mike3 : n, 남자 이름
mike fink : x, 갖가지 큰일을 해낸 영웅적 뱃사공
mike fright : x, 마이크 공포증
mil : n, 밀, 1인치의 천분의 1, 전신의 직경을 재는 단위
milady : n, 마님, 영국 귀부인에 대한 호칭
Milan : n, 밀라노(이탈리아 북부 Lombardy의 한 주, 그 중심 도시)
Milanese : x, (이탈리아의)밀라노사람(의)
milch : a, (소, 산양 등이)젖이 나는
milch cow : x, 젖소, 돈줄
mild : n, 유순한, 온화한, (밧이)순한, 달콤한, (기후가)온화한, (병이)가벼운
mild and bitter : n, 단맛 쓴맛이 반반인 맥주
mildcured : a, 얼간한(베이컨, 햄등)
milden : vt, vi, 온화하게 하다(되다)
mildew : n, 곰팡이, 백분병균, 곰팡나(게 하)다
mildewy : a, 곰팡이 난
mildly : ad, 온화하게, 부드럽게, 상냥하게, 다소, 약간
mild man nered : a, 태도가 부드러운
mildness : n, 온후, 온화, 온난
Mildred : n, 여자 이름
mild steel : x, 연강
mile : n, 마일, 1, 760야드, 1, 609km
mileage : n, 마일수(에 의한 운임), (마일수 계산에 의한) 여비 수당
mileage surcharge : x, 항공 운임 할증금
mile marker : x, 주간 간선 도로변에 있는 번호가 붙은 마일 표지
mileometer : n, (자동차의) 마일 주행 거리계
mile post : x, 이정표, 획기적 사건
miler : n, 1마일 경주 선수(말)
Milesian : a, n, 아일랜드의, 아일랜드 사람
milestone : n, (돌로 된) 마일 표, 이정표, 획기적인(중대한) 사건(역사, 인생 등의)
Miletus : n, 밀레토스(소아시아의 옛 도시; Ionia지방의 교역, 학문의 중심)
milfoil : n, 서양톱풀(엉거시과)
miliaria : n, 땀띠, 한진, 속립진
miliary : a, 좁쌀 모양의, 좁쌀만한
milieu : n, 주위, 환경
milieu therapy : x, (생활 환경을 바꾸는) 환경 요법
militancy : n, 투지, 교전 상태
militant : a, n, 싸우고 있는, 투쟁적인, 호전적인(사람), 투사
Militant Tendency : x, (영)노동당내의 마르크스주의자 그룹
militaria : n, 군수품 수집물(화기, 군복, 기장 등)
militarily : ad, 군사적으로, 군사적 입장에서
militarism : n, 군국주의
militarist : n, 군국주의자, 군사 전문가(연구가)
militaristic : a, 군국주의(자)의
militarization : n, 군국화, 군대화, 군국주의 고취
militarize : vt, 군국화하다, 전시 체제로 하다
military : a, 군(인)의, 군인다운, 군용의, 군인의 경력이 있는
military academy : x, 육군 사관 학교, 군대식 사립 고교
military affairs : x, 군사
military age : x, 징병 연령
military attache : x, (대(공)사관부)육군 무관
military band : x, 군악대
military chest : x, 군대 금고, 군자금
Military Cross : x, 전공 십자 훈장
military deserter : x, 탈주병
military engineering : x, 군사 공학, 공병학
military government : x, 군사 정부, 군정
military hospital : x, 육군 병원
military in dustrial complex : x, 군, 산업 복합체
military intelligence : x, 군사 정보; (육군) 군사 정보국(부)
military law : x, 군법
military march : x, 군대 행진곡
military police : x, 헌병대
military policeman : x, 헌병
military school : x, 군대 조직의 사립 학교, 육군 사관 학교
military science : x, 군사학(과학);(대학 등의) 군사 교련(교육 과정)
military service : x, 병역
military testament : x, 군인의 구도, 유언
military top : x, (군함의) 전투 장루
militate : vi, 작용하다, 크게 힘이 되다
militia : n, 의용군, 국민군
militiaman : n, 민병, 국민병, 향군
militiawoman : n, 여자 국민병
milium : n, 비립종
milk : n, 젖, 우유, 젖 모양의 액체, 유체
milk-ranch : n , 낙농장
milk and water : a, 김빠진, 멕없는, 몹시 감상적인
milk bar : x, 밀크바, 우유, 샌드위치 따위를 파는 가게
milk can : x, 우유통(운반용)
milk chocolate : x, 밀크 초콜릿
milker : n, 젖 짜는 사람, 착유기, 젖소, 젖을 내는 가축
milk fever : x, 젖몸살, 수유열
milk float : x, 우유배달차
milk glass : x, 젖빛 유리
milkiness : n, (액체의) 유상(성), 불투명, (외관, 구성이) 젖 같음, 유약
milking machine : x, 착유기
milk jelly : x, 과일이 든 밀크젤리
milk leg : x, (산후의) 고간백종
milklivered : a, 소심한
milk loaf : x, 밀크빵(단맛 있는 흰 빵)
milkmaid : n, 젖 짜는 여자, 낙농장에서 일하는 여자
milkman : n , 젖 짜는 남자, 우유 장수, 우유 배달인
milk powder : x , (영) 분유(dry milk)
milk pudding : x, 밀크 푸딩(쌀이나 타피오카 등을 우유에 넣어서 구운 푸딩)
milk punch : x, 밀크 펀치(우유, 술, 설탕 등을 셕은 음료)
milk round : x, (영) 우유 배달원의 배달 구역
milk run : x, (매일 이른 아침에 행하는) 폭격(정찰)비행
milk shake : x, 밀크 셰이크
milkshed : n, (특정 도시 등에 대한) 우유 공급 낙농지
milk sickness : x, 우유병(독초를 먹은 소의 젖을 마셔서 일어나는 병)
milk snake : x, 회색의 독없는 뱀
milksop : n, 유약한 사람
milk sugar : x, 유당, 락토오스
milk toast : x, 밀크 토스트(뜨거운 밀크에 담근 버터 바른 토스트)
milktoast : a, 나약한, 과단성 없는, 활기 없는, 미온적인
milk token : x, 우유표(필요한 매수를 현관 앞에 놔두면 그 매수만큼 우유가 배달됨)
milk tooth : x, 젖니
milk train : x, (지선의) 새벽 완행 기차
milk vetch : x, 자운영
milk wagon : x, 죄수(체포자) 호송차
milkwalk : n, (영) 우유 배달 구역
milkweed : n, 유액을 분비하는 식물
milk white : x, 유백색(젖빛)의
milkwood : n, 유즙을 분비하는 각종 열대 식물의 총칭
milkwort : n, (소 젖을 많이 나게 한다고 믿었던 데서)영신초, 애기풀
milky : a, 젖 같은, 젖의, 무기력한
Milky Way : n, 은하(수), (은하계 이외의) 성운, 은하 소우주
mill : x, john stuart(1806, 73)영국의 경제학자, 사상가
mill1 : n, 물방앗간, 제분소, 제분기, 분쇄기, 공장, 권투 경기, 치고 받기
mill2 : n, 1센트의 10분의 1
millage : n, 달러당 1000분의 1의 과세율(특히 부동산 매매에 쓰이는)
millboard : n, 마분지, 서적 표지용 판지
milldam : n, 물방아용 둑
millefeuille : n, 크림이 든 여러 층의 파이
millenarian : a, n, 지복 천년의, 지복 천년설을 믿는(사람)
millenarianism : n, 천년 왕국설(의 신앙), 지복 천년설, (정의와 행복이 충만한) 황금 시대
millenary : a, 천개의, 천년의, 지복 천년의, 그 설을 믿는
millennial : x, 천년의, 지복 천년의
millennium : n, 천년의 기간, 지복 천년(예수가 재림해서 지상을 지배하는)
millepede : n, 노래기
millepore : n, 의혈산호
miller : n, 물방앗간 주인, 제분업자, 공장주, (흰점이 있는) 나방의 일종
miller'sthumb : n, 둑중개(민물 고기)
millerite : n, 침상 니켈광
millesimal : n, a, 천분의 1(의)
millet : n, jean francols(1814, 75)프랑스의 화가
millet grass : x, 나도겨이삭
millhand : n, 제분공, 물방앗간의 일꾼, 직공(특히 방직공)
millhorse : n, 연자매 말
millhouse : n, 프레이즈반을 설치한 공장, 제분소
milli : x, 천분의 1의 뜻
milliampere : n, 밀리암페어(1000분의 1바)
milliard : n, 10억
millibar : n, 밀리바, 기압의 단위
millicurie : n, 밀리퀴리(1퀴리의1/1000 기호 mCur)
millicycle : n, 밀리사이클(1사이클의 1/1000; 기호 mc)
milligram(me) : n, 밀리그램
milliliter : x, 밀리 리터
millimeter : x, 밀리미터
millimicron : n, 밀리미크론, 천분의 1미크론
milline : n, 밀라인(발행 부수 100만부 당 1agate line의 스페이스 단위)
milliner : n, 부인 모자상(점)
milline rate : x, 1milline 당의 광고료
millinery : n, 부인용 모자류(장신구류), 그 판매업
milling : n, 백만, 무수, 백만 달러
milling cutter : x, 프레이즈반용 커터
milling machine : x, 프레이즈반, 축융기
million : n, 100만, 100만 파운드, 수백만, 다수, 무수, (사람, 사물이) 훌륭하여, 멋지게
million(n)aire : n, 백만 장자
millionfold : a, ad, 100만 배의 토
millionocracy : n, 재벌(부호)정치
millirem : n, 방사선의 생체 실효 선량단위, 1렘의 천분의 1
millpond : n, 물방아용 저수지
millrace : n, 물방아용 물줄기(도랑)
mills bomb9grenade) : x, 난형 고성능 수류탄
millstone : n, 맷돌
millstone grit : x, 마석 경사암
millstream : n, =MILLRACE
milltail : n, 물방아를 거쳐 나간 물, (물방아의)배수로
mill wheel : x, 물방아 바퀴
mill wheel : x, 물레바퀴
millwork : n, 물방아(제조소)의 기계(작업), (집합적)(공장의) 목공 제품(문, 창틀 등)
millwright : n, 물방아(풍차) 목수(장인), (공장의) 기계 수리(설치) 기술자
milo : n, 마일로(곡식용 수수의 일종)
milometer : n, =MILEOMETER
milor(d) : n, 각하, 나리(프랑스 사람이 영국의 귀족, 신사에게 씀), 영국 신사
milquetoast : n, 무기력 한 사람, 겁쟁이
milreis : n, 밀레이스(브라질의 옛 경화; 그 화폐 단위), 밀레이스(옛 포르투갈 금화)
MILSTAR : n, 전략, 전술, 중계용 통신 위성 계획
milt : n, (물고기의)이리, 비장
milter : n, 산란기의 물고기 수컷
milton : x, john(`1608, 74)영국의 시인
miltonian : x, millton풍의
miltonic : n, (고대 그리스, 로마의)몸짓 익살극, 그배우, 몸짓으로 연극을 하다
Miltown : n, 밀타운(진정제 메프로 바메이트, 상표명)
Milwaukee : n, 밀워키(미국 Wisconsin 주 남동부 Michigan 호반의 도시)
Milwaukee goiter : x, 맥주배, 밀워키 갑상선종
mim : a, 말이 적은, 삼가는, 시침 떼는
MIM : x, mobile interceptor missile 지상 이동식 대공 미사일
mime : n, vi, vt, (무언의) 흉내내기 연극, (팬터)마임, (옛 그리스, 로마) 무언극, 무언의 광대극, 그 배우, 광대, 흉내쟁이, 무언극을 하다, 광대짓을 하다, 무언의 몸짓으로 나타내다, 흉내내다
mimeo : n, 등사판 인쇄물
mimeograph : n, vt, 등사판, 등사판으로 인쇄하다
mimesis : x, 의태
mimetic : x, 모방의, 의태의, 의사의
mimetic diagram : x, (공장 기계의 작동 상태 등을 램프의 명멸 등으로 표시하는) 모식도, 모식 표시판
mimic : a, 흉내내는, 모방의, 가짜의
mimic board : x, 미믹 보드(컴퓨터를 이용하여 복잡한 시스템을 램프의 명멸 등으로 도식화하여 나타내는 표시판)
mimicker : n, 흉내내는 사람
mimicry : n, 흉내, 모조품, 의태
miminy piminy : x, 점잔빼는, 지나치게 세련된
mimmem : a, (외국어 학습이) 모방 기억 반복 연습(방식)의(에 의한, 에 관한)
mimosa : x, 함수초(의 무리), 자귀나무 따위
Min, Pler : x, Minister Plenipotentiary
minacious : a, 위협(협박)적인
minacity : n, 위협(threat)
minar : n, 등대의 뜻에서)(인도 건축 등의) 작은 탑
minaret : n, (회교 교당의) 뾰족탑
minatory : a, 위협하는
mince : vt, (고기 따위를)잘게 다지다, 조심스레 말하다, 맵시를 내며 종종 걸음으로 걷다
mincemeat : x, 잘게 썬 고기
mince pie : x, 민스 파이(mincemeat가 든 파이)
mincer : n, 잘게 써는 사람(기계)
mincing : a, 점잔빼는, 거드럭거리는, 짐짓...체하는, 점잔빼며 걷는, 종종걸음치는
mincing machine : x, 고기 써는 기계
mind : n, 마음, 정신, 기억(력), 의견, 생각, 의지, 지력, 기질, 기분
mind's eye : x, 마음의 눈, 심안, 상상; in one's ~ 마음속으로, 상상으로
mindbender : n, 환각제, 환각제 사용자, 깜짝 놀라게 하는 것, 회유하는 사람
mindbending : a, 환각을 일으키게 하는, 정신을 착란시키는, 깜짝 놀라게 하는, 압도적인, 굉장히 어려운
mindblow : vt, (...에게)극도의 충격을 주다, 흥분시키다
mind blower : x, 환각제(사용자); 황홀한 체험
mindblowing : a, 환각 작용을 하는; 환각제의, 몹시 자극적인, 압도하는
mindboggling : a, 경탄스러운, 믿기 어려울 만큼 놀라운
mind cure : x, 정신 요법
minded : a, 할 마음이 있는
minder : 지키는 사람, n, 
mindexpanding : a, (약이)의식을 확대시키는, 정신 확장의, 환각 상태가 되게 하는
mindexpsnder : n, 환각제
mindful : a, 주의 깊은, 마음에 두는
mindless : a, 분별 없는, 부주의한
mindon : n	, 정신소(텔레파시 등의 정신 전달을 관장하는 물질의 가상명)
mind reader : x, 남의 마음을 읽어 내는 사람, 독심술을 하는 사람
mind reading : x, 독심술
mind reading : x, 독심술
mindset : n, (습성이 된) 심적 경향 (태도), 사고 방식
mindshattering : a, 기상천외의
mind spacer : x, (미)환각제
mine1 : n, 광산, 광갱, 보고, 철광, 기뢰, 지뢰
mine1 : , 나의 것
mine detector : x, 지뢰(광물)탐지기
mine disposal : x, 지뢰(지뢰) 처리
mine field : x, 지(기)뢰원, 관석 매장지
mine layer : x, 기뢰 부설함
miner : n, 갱부, 지뢰 공병
mineral : n, 광물, 무기물
mineral charcoal : x, 천연 목탄
mineralization : n, 광화작용
mineralize : vt, vi, 광물화하다, 광물을 함유시키다, 광물을 채집하다, 채광하다, 광물이 되다
mineralizer : n, 광소, 조광소, 탐광자, 광물 채집자
mineral jelly : x, 미네랄 젤리(석유에서 채취하는 점성 물질, 폭약 안정제용)
mineral kingdom : x, 광물계
mineralogical : a, 광물학(상)의, 광물학적인
mineralogist : n, 광물학자
mineralogy : n, 광물학
mineral oil : x, 광유, 석유따위
mineral pitch : x, 아스팔트, 천연의
mineral right : x, 채굴권
mineral spring : x, 광천
mineral tar : x, 광물 타르
mineral vein : x, 광맥
mineral water : x, 광천수, 탄산수
mineral wax : x, 광람, 지랍
mineral wool : x, 광물면(전기 절연체, 건축용)
minerva : n, 미네르바, 지혜의 여신, 그리스신화의 athena
minestrone : n, (수프의 뜻에서)(채소 등을 넣은) 진한 수프
mine sweeper : x, 소해정
minesweeper : n, 소해정
mine sweeping : x, 수해(작업)
minesweeping : n, 소해(작업)
mine thrower : x, 박격포
minever : n, =MINIVER
mine water : x, 갱내수
mine worker : x, 광산 노동자, 광부
Ming : n, (중국의) 명나라, 명조
minge : n, (영)여성의 성기; 여자
mingle : vt, vi, 섞다, 섞이다, 사귀다, 어울리다
minglemangle : n, 혼합
mingy : a, 인색한
mini : a, n, (썩)작은(것), 미니스커트(드레스, 코트 등), 소형 자동차, 미니카, 아주 작은
miniate : vt, 붉은 색을 칠하다, 금자로 장식하다
miniature : x, 모형, 축소화, 축도, 미세화법
miniature camera : x, (35밀리 이하의)소형 카메라
miniature pinscher : x, 미니어쳐 핀셔(소형의 애완견)
miniaturize : vt, 소형화하다, 소형으로 제작하다
miniatutist : n, 세밀화가
minibike : n, 소형 오토바이
minibikini : n, 초소형 비키니
miniblackhole : n, 미니 블랙홀(10만분의 1 그램 정도의 질량인 극소형 블랙홀)
minibudget : n, 소형 추가 경정 예산
minibus : n, 마이크로 버스
minicab : n, 콜택시
minicalculator : n, 휴대용 전자 계산기
minicam : n, =MINIATURE CAMERA
minicar : n, 초소형 자동차
minicell : n, 미니세포(염색체 DNA가 없는 작은 박테리아 세포)
minicomputer : n, 소형 컴퓨터
minicourse : n, (대학 등의) 단기 강좌(강습)
minidose : n, (소립의) 복용약
minidress : n, 미니 드레스
minifestival : n, (주로 미)(대개 야외에서 열리는) 소규모 연회(기념제)
minify : vt, 작게 하다, 축소하다, 중요성을 낮추다, 낮게 평가하다
minikin : n, 작은 것(생물), 미물, 작은, 소형의, 꼬마의, 점잔 빼는
minim : n, a, 미님(액량의 단위;=1/60 DRAM), 미량, 미세(한 것), 시시한 것
minimagazine : n, (특정 독자만을 위해 발행되는)미니 잡지
minimal : a, 최소향(수)의, 극소의
minimal art : x, 미니멀 아트, 최소한의 조형 수단으로 제작된 그림, 조각
minimal brain dysfunction : x, 미소 뇌기능 장애 (아동의 학습 장애의 하나)
minimal pair : x, 최소 대어(bet와 bed 처럼 같은 위치의 한 가지 소리만 다른 한 쌍의 낱말)
minimax : n, 미니맥스(어떤 1조의 극대치 중의 최소치); (게임 이론에서) 미니맥스(추정되는 최대의 오차(손실)를 최소로 하는 기법)
Mini Metro : x, 미니 메트로(영국 BL 사제의 소형 승용차)
minimill : n, 소공장, 고철 재생 공장
miniminded : a, 생각이 모자라는, 철 없는, 무지한, 어리석은
minimine : n, 미니민(벌의 독에서 추출한 유독 물질)
minimize : vt, 최소로하다, 최저로 어림잡다, 경시하다
minimum : n, 최소량, 극소
minimum competency testing : x, 최소한 능력 테스트(미국의 고교 기초 학력테스트)
minimum dose : x, 최소 투약량
minimum lending rate : x, (영)(잉글랜드 은행의) 최저 대출 금리
minimum purchase : x, (미) (가솔린의) 1회의 최저 판매량(구매량)
minimum thermometer : x, 최저 온도계
minimum wage : x, 최저 임금
minimus : a, n, (영)최연소자의, 가장 나이가 어린(이름이 같은 학생이나 형제 중에서), 최연소의 것, 새끼손가락
mining : n, 채광, 광업
mining engineer : x, 광산 기술자
mining engineering : x, 광산(공)학
mining geology : x, 광산 지질학
mininuke : n, (미) 소형 핵무기
minion : n, 총애 받는 사람(아이, 여자, 하인 등), 앞잡이, 부하
minipants : n, 미니팬츠, 짧은 바지
minipark : n, (도시의) 소공원
minipig : n, 미니 돼지(실험용)
minipill : n, 작은 알의 경구 피임약
miniplanet : n, 소행성
miniscule : a, n, =MINUSCULE
miniseries : n, (TV)미니 시리즈(보통 4-14회 정도)
minish : vt, vi, 줄이다, 줄다
miniski : n, (특히 초심자용) 짧은 스키
miniskirt : n, 미니스커트
ministate : n, 극소 국가
minister : n, 성직자, 장관, 대신, 각료, 공사, 대리인, 하인
ministerial : a, 대리의, 대행의, 장관(각료)의, 정부측의, 공사의, 목사의, 종속적인
ministering angel : x, 구원의 천사(친절한 간호사 등)
minister plenipotentiary : 전권 공사, x, 
minister plenipotentiary : x, 전권 공사
minister resident : x, 변리 공사
ministrant : a, 봉사하는, 보좌의
ministration : n, (목사의) 직무, 봉사, 보조
ministrative : a, =MINISTRANT
ministress : n, MINISTER의 여성형
ministry : n, 성직, (장관 관할의)부, 성내각, 복사들, 각교, 직무, 봉사
minisub : n, (해저 탐사용의) 소형 잠수함
minitank : n, 미니 탱크, 경량의 고속 전차
minitanker : n, 소형 탱커
minitrack : n, 미니 트랙, 인공 위성 추적 장치
minium : n, 연단, 광명단, 연단색
minivan : n, 미니밴(van과 station wagon의 특징을 절충한 차)
miniver : n, (귀족 예복의)흰 모피
minivet : n, 할미새사촌
miniwar : n, 소규모 전투
mink : n, 밍크(족제비류)
minkowski world(universe) : x, 민코프스키 공간, 4차원의 좌표에 따라 기술되는 시공
Minneapolis : n, 미니애폴리스(미국 Minnesota 주 남서부의 도시)
minnesinger : x, (중세 독일의) 음유시인
minnesota : n, 미국 중북부의 주
Minnesota Multiphasic Personality Inventory : x, 미네소타 다면 인격 목록(미네소타 대학이 개발한 성격 검사법)
Minnesotan : a, n, 미네소타주(사람)의, 미네소타주 사람
minnow : n, 황어, 피라미, 작은 물고기
Minoan : a, n, 미노스(크레타)문명의(기원전3000-1100년경), 고대 크레타 사람, 미노아 사람
minor : a, 작은 쪽의, 소, 중요하지 않은, 2류의, 손아래의, 부전공과목의
Minorca : n, 미노르카(지중해 balearic군도 중의 스페인령섬), 미노르카 닭
minor coin : x, 비금속경화
Minorite : n, 프란체스코회의 수도사
minority : x, 미성년(기), 소수(파), 소수당
minority carrier : x, 소수담체(반도체의)
minority group : x, 소수민족(한나라의)
minority leader : x, 소수당의 원내총무
minority program : x, 저시청율의 프로
minority whip : x, 소수당의 원내 부총무
minor key : x, 단조, 음침한 기분
minor league : x, 마이너리그, 2류의 프로 야구 연맹
minor offense : x, 견범죄
minor orders : x, (신품) 소품(수문, 강경, 구마, 시종의 제 품)
minor planet : x, 소행성
minor premise : x, 소전제
Minor Prophets : x, 소예언자, 소선지(소예언)서
minor scale : n, 단음계
minor suit : x, (브리지에서) 다이아몬드(클럽)의 짝패(득점이 적음)
minor term : x, 소명사
minor tranquilizer : x, 마이너 트랜퀼라이저(불안, 긴장, 신경증 치료용)
Minos : n, 미노스(크레타(Crete) 섬의 왕)
Minotaur : n, 사람 몸에 쇠머리를 가진 괴물
MINS : n, (미)감독이 필요한 미선년자
minster : n, 수도원 부속 교회당, 대성당
minstrel : n, (중세의) 음유시인, 가수, 시인
minstrelshow : n, (흑인으로 분장한)가극단
minstrelsy : n, 음유시인의 연예, 음유 신인들
mint1 : n, 조폐국, 거액, (발명, 음모등의)근원
mint2 : n, 박하, 박하사탕
mintage : n, 조폐, 주조 화폐
mintfresh : a, 갓 만든, 아직 사용하지 않은
mint julep : x, (미)민트 줄립(위스키(브랜이)에 설탕, 박하를 탄 칵테일)
mintmark : n, (화폐면의) 조폐소를 나타내는 각인
mintmaster : n, 조폐국장
mint sauce : x, 민트 소스(박하, 설탕, 식초를 섞은 것으로 새끼 양의 불고기에 침)
minuend : n, 피감수
minuet : n, 미뉴에트, 3박자의 느린 춤
minus : , 마이너스한, ...을 뺀, ...을 잃고
minuscule : n, a, (글자가)소문자(의), 작은
minute1 : n, 분(시간, 각도의 단위), 잠시, 간단한 메모, 의사록
minute2 : x, 자세한, 미소한, 정밀한
minute bell : x, 분시종(죽음, 장례식을 알리기 위해 1분마다 울리는)
minute book : x, 기록부, 의사록
minute gun : x, 분시포, 1분마다 쏘는 조포, 조난 신호포
minute hand : x, (시계의) 분침
minutely : a, ad, 일분마다(의)
minuteman : n, 3단계 대륙간 탄도탄
minute steak : x, (즉시 구울 수 있도록) 얇게 저민 스테이크
minutiae : x, 상세(한 사정), 세목
minx : n, 말괄량이, 바람난 처녀
miocene : n, a, 제3기 중신세(의)
miracle : n, 기적, 불가사의한 물건(사람, 일)
miracle drug : x, 특효약, 영약
miracle fruit : x, 적철과의 관목(의 과일)(이것을 먹고 나서 신 것을 먹으면 단맛이 남)
miracle man : x, 기적을 행하는 사람, 경이적인 기량을 가진 사람
miracle play : x, 기적극, 예수 또는 성도의 사적을 제재로 한 중세의 극
miracle rice : x, 기적의 벼(재래종의 2-3배의 수확량이 나오는 새 품종)
miraculous : a, 기적적인, 놀랄만한, 불가사의한
miraculously : ad, 기적적으로
mirage : n, 신기루, 망상
Miranda : n, a, 여자 이름, 천왕성의 제 5위성, (피의자의) 인권 옹호적인
Miranda card : x, (1963년 판결을 받은 멕시코계 이주민 이름에서)(미) 미랜더 카드(체포시에 피의자에게 알려야 할 헌법상의 권리를 인쇄한 카드)
Miranda rule : x, (미)미랜더 준칙(원칙)(위법 수집 증거 배제 원칙)
mire : n, 진흙, 진창, 수렁, 궁지
miro : x, joan(1893, 1930)미로, 스레인의 초현실파 화가
mirror : n, 거울, 모범, 전형
mirror image : x, 경상(겨울에 비쳤을 때 좌우가 반대로 된 상)
mirror writing : x, 역서, 거울 문자(거울에 비추면 바르레 보이게 쓰기)
mirth : n, 환락, 유쾌, 명랑
mirthful : a, 유쾌한, 명랑한, 즐거운
mirthless : a, 즐겁지 않은, 서글픈
MIRV : n, 다탄두 각개 록표 재돌입 미사일
miry : a, 진창인, 진흙투성이의, 더러운
mis : , 잘못하여, 나쁘게, 불리하게
misadministration : n, 실정
misadventure : n, 불운
misadvise : vt, 나쁜 권고를 하다, 그릇된 충고를 하다
misalliance : n, 어울리지 않는 결혼, 잘못된 결합
misally : vt, 부적당하게 결합(결혼)시키다
misanthrope : n, 인간을 싫어하는 사람, 염세가
misanthropic : x, 사람 싫어하는, 염세적인
misanthropist : n, 사람이 싫은 사람, 염세가
misanthropy : x, 사람을 싫어함, 인간 불신
misapplication : n, 오용, 남용, 악용
misapplied : a, 악용된
misapply : vt, 오용, 악용
misapprehend : 오해하다, vt, 
misapprehension : n, 오해
misapprehensive : a, 오해하기 쉬운
misappropriate : vt, (남의 돈을) 악용하다, 횡령하다
misappropriation : n, 악용, 남용, 배임 횡령
misarrange : vt, 잘못 배치(배열)하다
misbecome : vt, ...에 맞지 않다, ...에 어울리지 않다, ...에 적합하지 않다
misbecoming : a, 어울리지 않는, 적합하지 않은
misbegotten : a, 서출의, 사생아의 불운한 태생의, (경멸, 익살)(사람이) 꼴사나운, 멸시한 만한, 쓸모없는, (계획, 생각 등이) 덜된, 형편없는
misbehave : vi, 무례한 행동을 하다, 방정치 못한 짓을 하다
misbehaved : a, 버릇없는, 품행이 나쁜
misbehavior : x, 비행
misbelief : n, 그릇된 신념(신앙), 사교
misbelieve : vi, vt, 잘못 믿다, 이교를 믿다, 의심하다
misbeliever : n, 이교도
misbelieving : a, 이단의
misbeseem : vt, =MISBECOME
misbestow : vt, 부당하게 수여하다
misbirth : n, 유산
misbrand : vt, 틀린 낙인을 찍다, 구릇된(가짜) 상표 (라벨)를 붙이다
misbranded drug : x, 부정 표시 의약품
miscalculate : vt, vt, 오산하다, 잘못 예측하다
miscalculation : n, 오산, 계산 착오, 그릇된 계산(추측)
miscall : vt, 틀린 이름으로 부르다, 잘못 부르다(일컫다)
miscarriage : n, (편지의)불착, 유산, 실패
miscarry : vi, 실패하다, 유산(조산)하다, 편지가 도착하지 않다, 잘못 배달되다
miscast : vt, (아무에게)부적당한 임무를 맡기다, 배역을 잘못하다
miscegenation : n, 이종족 혼교, 잡혼(특히 백인과 흑인과의)
miscellanea : n, (종종 단수 취급) 잡찬, 잡록(특히 문학 작품의)
miscellaneous : a, 잡다한, 가지가지의
miscellanist : n, 잡록(잡보) 기자, 잡문가
miscellany : x, 잡록, 논문집, 잡동사니
mischance : x, 불행, 재난
mischief : n, (정신, 도덕적인)해, (물질적인)손해, 위해, 재난의 씨, 고자, 장난, 익살
mischief maker : x, 이간질하는 사람
mischiefmaking : a, n, 이간질(하는)
mischievous : a, 유해한, 장난치는
miscibility : n, 혼화성
miscible : a, 섞일(혼화할) 수 있는
miscite : vt, ...을 잘못 인용하다
misconceive : vt, vi, 오해하다, 오인하다, 잘못 생각하다
misconception : n, 잘못된 생각, 오인
misconduct : n, 품행 불량, 간통
misconstruction : n, 그릇된 조립(구문), 오해, 곡해
misconstrue : vt, 뜻을 잘못 해석하다, 오해하다, 그릇읽다
miscount : vt, vi, n, 오산(하다)
miscreant : a, 극악 무도한, 이단의
miscreated : a, 잘롯 만들어진, 불구의
miscue : n, vi, 공을 잘못 치기, 미스 대사의 큐를 잘못 받기, 에러, 잘못 치다, (스포츠)에러를 범하다, 대사의 큐를 잘못 받다
misdate : vt, 날짜(연대)가 틀리다
misdeal : vt, vi, (카드)패를 잘못 도르다(도르기)
misdeed : n, 범죄, 못된 짓
misdeem : vt, vi, 잘못 판단하다, 오해하다, 잘못 보다
misdemeanant : n, 경범자, 비행자, 소행이 나쁜 사람
misdemeanor : n, 비행, 경범죄
misdescribe : vt, 잘못 기술(묘사)하다
misdescription : n, 미비한 기술, (계약의) 오기
misdiagnose : vt, 오진하다
misdialing : n, 전화 번호를 잘못 돌림
misdirect : vt, 그릇 지시하다, 잘못 겨냥하다, (편지의)수취인 주소를 잘못 쓰다
misdirection : n, 잘못된 지시, 잘못 기리키기, 주소 성명을 잘못 씀, (판사의) 부당 지시, 그릇된 방향
misdo : vt, vi, n, 잘못하다, 실수하다, ~er 나쁜 짓을 하는 사람
misdoing : n, 나쁜 짓, 범죄
misdoubt : vt, n, 의심하다, 밋ㅁ쩍어하다, 의심, 미심쩍은 생각
mise : n, 협정, 협약, 토지 권리 소송영장에 있어서의 쟁점
mise en scene : x, 무대 장치 연출
misemploy : vt, n, 오용하다, ~ment오용
misentry : n, (장부의) 오기
miser : n, 구두쇠, 수전노
miserable : a, 비참한, 불쌍한, 초라한
miserably : ad, 비참하게, 불쌍하게, 초라하게, 비참할 만큼, 형편없이, 지독히
Miserere : n, (시편 제51편)미제레레의 기도, 애원
misericord(e) : n, 수도원의 면계실, 특면, (중세의) 단검(마짐막 숨을 끊어 버리는), 교회 성가대 석의 접의자 아래에 댄 가로대(의자를 접고 일어서 있을 때 기대는)
miserly : a, 인색한, 욕심 많은
misery : n, 불행, 비참, 빈곤, 고통
misery index : x, 궁핍 지수
misesteem : vt, n, ...을 부당하게 얕보다, 경시
misestimate : vt, ...을 부당(부정확)하게 평가하다, 평가를 잘못하다
misestimation : n, 잘못된(부당한) 평가
misevolution : n, (세포나 바이러스 입자 등의) 이상 증식
misfeasance : n, 불법 행위
misfeature : n, (미) 고생(실패)의 원인이 되는 특성
misfile : vt, 잘못 철하다(정리하다)
misfire : x, (총 따위가)불발(하다)
misfit : n, 맞지 않는 것(옷, 신 따위)
misfortune : n, 불운, 불행, 재난
misfuel : vt, vi, (자동차에)(종류가 다른 휘발유를) 잘못 급유하다
misgive : vt, 의심을 일으키다, 불안하게하다
misgiving : n, 불안, 의심
misgovern : 악정을 하다, vt, 
misgovernment : n, 악정, 실정
misguidance : n, 그릇된 지도
misguide : vt, 잘못 지도하다, 잘못 생각하게 하다
misguided : a, 오도된
mishandle : vt, 심하게 다루다, 학대하다
mishap : n, 재난, 불행(한 사고)
mishear : vt, vi, 잘못 듣다, 못 알아듣다
mishegoss : n, 바보짓, 미친 짓
mishit : vt, n, (공을) 잘못 치다, 잘못 치기, 범타
mishmash : n, 뒤범벅
Mishnah, -na : n, 미슈나(유대교의 구전 율법)
mishugah : a, 머리가 돈, 미친
misinform : vt, 오보하다, 오해시키다
misinformant : n, 오보자
misinformation : n, 오보, 오전
misinformed : a, 잘못 알고 있는, 정보를 잘못 들은
misinterpret : vt, 그릇 해석하다
misinterpretation : n, 오해, 오역
misjudge : vt, vi, 그릇 판단하다, 오해하다
mislay : vt, 놓고 잊어 버리다, 잘못 놓다
mislead : vt, 그릇 인도하다, 잘못하게 하다, 현혹시키다
misleading : a, 오도하는, 오해하게 하는, 현혹시키는
mislike : vt, 싫어하다, ...의 비위를 거스르다
mismanage : vt, 잘못 관리(취급)하다, 잘못 처리하다
mismanagement : n, 그릇된 처리(단속, 관리), 실수
mismatch : vt, 짝을 잘못 짓다
mismate : vt, vi, 짝을 잘못 짓다, 어울리지 않는 결혼을 시키다(하다)
misname : vt, 이름을 잘못 부르다
misnomer : n, 잘못된 이름, 명칭이 오용, 잘못 부름
miso : n, (혐오)의 뜻의 결합사
misogamist : n, 여자를 싫어하는 사람
misogamy : x, 여자를 싫어함
misoguny : n, 여자를 싫어함
misology : n, 이론을 싫어함
misoneism : n, 새 것을 싫어함, 보수주의
misorient : vt, 그릇된 방향으로 돌리다, 오도하다
misplace : vt, 잘못 놓다, (애정, 신용을)부당한 사람에게 주다, 때와 장소를 틀리다
misplacement : n, 잘못 두기
misplay : n, vt, (경기, 게임, 연주 등의) 실수, 미스, 에레, 반칙 플레이, (놀이, 연주 등을) 잘못하다, (공을) 잘못 처리하다
misprint : n, 오식
misprision : n, (공무원의)비행, 범죄 은닉
mispronounce : vt, vi, 잘못 발음하다
mispronunciation : n, 틀린 발음
misquotation : n, 잘못된 인용
misquote : vt, 잘못 인용하다
misread : vt, 오독하다, 그릇 해석하다
misreckon : vt, vi, 잘못 세다
misremember : vt, vi, 잘못 기억하다, 못 외다
misreport : vt, n, 잘못 보고하다, 그릇 전하다, 오보, 호위 보고
misrepresent : vt, 잘못 전하다, 바르게 나타내지 않다
misrepresentation : n, 왜곡한 진술, 오전
misroute : vt, 틀린 루트로 부치다
misrule : n, vi, 악정(을 하다)
miss1 : n, , 양, , 씨, 아가씨(하녀, 점원 등이 부르는 호칭), 처녀
miss2 : vt, (과녁 따위에)못 맞히다, 잘못하다, (기회를)놓치다, 길을 잃다, 만나지 못하다, 모면하다
missal : n, (카톨릭)미사전서
missel : n, 큰 개똥지빠귀
missense : n, 미스센스(DNA암호가 바뀌어 본래와 다른 아미노산을 지정하게 되는 돌연변이 암호)
missense mutation : x, 미스센스 돌연 변이
misshape : vt, 보기 흉하게(기형으로) 만들다
misshapen : a, 보기 흉한, 기형의
missile : n, a, 날아 가는 무기(팔매돌, 화살, 탄환 따위)(로서 쓰이는), 미사일(의)
missileman : n, (집합적) 미사일 설계(제작, 조각)자
missilery : n, 없는, 모자라는, 보이지 않는, 행방 불명의
missing : a, 있어야 할 곳에 없는, 없어진, 보이지 않는, 분실한, 행방 불명인
missing link : x, 잃어버린고리, 유인원과 사람 사이에 존재했다고 가상되는 동물
mission : n, 사절(단), 전도(단), 사명, 천직, 해외 대(공)사관, 비행임무
missionary : a, n, 전도의, 선교사
missionary position : x, (성교의) 정상 체위
missionary salesman : x, 순회 판매원(생산 회사의 판촉 세일즈맨)
mission control : x, (지상의) 우주 비행 관제 센터
missioner : n, =MISSIONARY
missionize : vt, vi, ...에 전도(선전)하다, 선교사로 복무하다
mission school : x, 전도 학교, 선교사 양성소
mission specialist : x, 우주선에 탑승하는 과학자
missis : n, 마님(하녀등의 용어), (자기의)아내, 마누라, (일가의)주부
missish : a , 얌전빼는, 새침부리는
mississippi : n, 미국 남부의 주, 북아메리카에서 가장 긴 강
missive : n, 공식서한, 편지
missouri : n, 미국중부의 주
misspeak : vt, vi, 잘못 말하다, 잘못 발음하다
misspell : vt, , 의 철자를 틀리다
misspent : a, 낭비한
misstate : vt, 허위(잘못)진술하다
misstep : n, vi, 실족, 과실, 실수, (여자가) 몸을 그르침, 잘못(헛) 디디다, 잘못을 저지르다
missy : n, 아가씨
mist : n, 안개
mist1 : n, 금액의 단위, 소액, 적으나마 성의있는 기부, 조금, 아주작은것, 어린아이
mistakable : a, 틀리기 쉬운
mistake : vt, vi, 틀리다, 잘못 생각하다
mistaken : v, mistake의 과거분사
misteach : vt, 잘못 가르치다
mister : n, 군, 씨, 귀하, 님, 선생님, 나리, 여보시오, 형씨
Mister Big : x, (숨은) 큰 보스, 거물
Mister Charley(Charlie) : x, 백인
Mister Right : x, (여성의) 이상적 남편감
Mister Tom : x, 백인 사회에 동화한(하려고 하는) 흑인
mistery : n, MYSTER
mistful : a, 안개가 짙은(자욱한)
misthread : vt, (녹음 테이프를) 제자리가 아닌 데에다 틀다
mistily : ad, 안개가 짙게, 어렴풋이, 몽롱하게
mistime : vt, 부적당한 때에 행하다(말하다), 시기를 놓치다
mistimed : a, 시기를 놓친, 때가 좋지 않은
mistle thrush : x, 지빠귀의 일종(유럽산)
mistletoe : x, 겨우살이, 기생목
mistook : v, mistake의 과거
mistral : n, 미스트랄(프랑스 등지의 지중해 연안에 부는 찬 북서풍)
mistranslate : vt, 오역하다
mistreat : vt, 학대하다
mistreatment : n, 학대
mistress : n, 여주인, 주부, 부인, 여교사, 애인, 정부, 여지배자
mistrial : n, 오판, 무효심리(절차상 과오에 의한)
mistrust : vt, 신용하지 않다, 의심하다
mistrustful : a, 의심 많음
misty : a, 안개 짙은, 안개가 자욱한, 눈물 어린, 희미한, 몽롱한, 분명치 않은, 막연한
mistyeyed : a, (눈물로) 눈이 흐릿한, 곧잘 눈물을 글썽거리는, 감상적인
misunderstand : 오해하다, vt, 
misunderstanding : n, 오해, 불화
misunderstood : v, misunderstand의 과거(분사)
misusage : n, 오용, 학대, 혹사
misuse : vt, 오용하다(어구를), 학대하다
misvalue : vt, 잘못 평가하다, 과소 평가하다
misword : vt, 잘못 표현하다, 부적당한 말로 나타내다
Mitbestimmung : n, (서독 등에서의 노동자의) 경영 참가(권)
mitch, mich : vi, 학교를 빼먹다
Mitchell : n, 남자 이름, 미첼
mite2 : n, 진드기
miter : n, 주교관
miter box : x, 연귀이음통(톱의 각도를 고정시키는)
mitered : a, 주교관을 쓴
miter joint : x, 연귀이음, 사접(액자 모서리처럼 2등분각으로 잇기)
mithraism : n, 미트라교, 고대 페르시아의 종교
Mithraist : n, 미트라신 예배자
mithridate : n, 마능 해독제
mithridatism : n, 면독성, 내독성
mithridatize : vt, (독을 조금씩 마시어)면독성을 기르다
mitigate : vt, 누그러뜨리다, 완화(경감)하다
mitigating circumstances : x, (형기 등의) 경감 사유, 참작할 정상
mitigation : n, 완화(제)
mitigative : a, 완화적인
mitigator : n, 완화시키는 사람, 완화제
mitigatory : a, =MITIGATIVE
mitochondria : n, 미토콘드리아, 세포질 속의 입상의 소체
mitomycin : n, 마이토마이신(제암 작용이 있는 항생 물질)
mitose : vi, 유사 분열하다
mitosis : x, 유사 분열
mitotic : a, 유사 분열의, 간접 핵분열의
mitral : 주교관 모양의, a, 
mitt : n, (여성용)손가락 없는 긴 장갑, (야구의)미트
mitten : n, 벙어리 장갑, 권투 글러브
mittimus : n, 수감 영장, 소송 기록 이송 영장, 해고 통지
Mitty : n, (J.Thurber의 단편 소설의 주인공 이름에서) 몽상가, 자기를 대단한 영웅으로 꿈꾸는 소심자
mix : vt, 섞다, 혼합하다, 사귀게하다
mix, u : n, 혼란, 난투
mix and match : n, 균형이 맞지 않는 것 끼리의 짝지움
mixed : a, 섞인, 남녀 혼합의
mixed bag : x, 뒤범벅, 잡다한 것(사람)
mixed blessing : x, 이해가 엇비슷한 것(일), 유리하지만 불리함도 따르는 사태
mixed boat : x, 화객선
mixed chalice : x, (교회에서) 의식용으로 포도주에 물을 탄 성배
mixed chorus : x, 혼성 합창
mixed doubles : x, (테니스) 남녀 혼합 복식
mixed drink : x, 합성주
mixed economy : x, (자본주의, 사회주의 병존의)혼합 경제, 영국에서 볼 수 있음
mixed farming : x, (목축을 겸한)혼합농업
mixed fertilizer : x, 배합 비료
mixed grill : x, 간, 소시지 등의 육류와 토마토, 버섯 등을 볶은 요리
mixed market economy : x, 혼합 시장 경제
mixed marriage : x, (다른 종족, 종교간의) 잡혼
mixed media : x, 혼합 매체, 영상, 그림, 음악 등의 종합적 예술 표현
mixed metaphor : x, 혼유
mixedness : n, 뒤죽 박죽, 혼합, 혼성
mixed number : x, 대분수
mixed tithe : x, (가축류에서의 수익에 대한) 10분의 1의 세
mixed train : x, (객차와 화차의) 혼성 열차
mixedup : a, 머리가 혼란한, 불안정한, 노이로제 기미의
mixeduse : a, 다목적 이용의
mixer : n, 혼합하는 사람, 바텐더, 혼합기, (콘크리트 등의) 믹서, 교제가, 사교가
mixi : n, 믹시(미니, 미디, 맥시를 합친 앙상블)
mixing : N, (녹음 재생이 있어서 음성과 음악 등의) 혼성, 믹싱, (라디오, TV)음량(영상)조정
mixing bowl : x, 하이웨이의 클로버형 인터 체인지
mixology : n, (미, 익살) 칵테일 만드는 기술
mixoploidy : n, 혼합 염색체질
mixture : n, 혼합물(약), (감정의)교차, 혼합, 첨가물, 혼방직물
mixup : n, 혼란, 혼전, 난투
miz(z)en : n, 뒷 돛대의 가로돛
miz(z)enmast : x, 뒷 돛대
miz(z0entop : n, 뒷 돛대의 장루
mizzle : n, vi, 이슬비(가 내리다)
mnemon : n, 기억소(뇌, 신경계 정보의 최소 단위)
mnemonic : a, 기억의, 기억을 돕는, 기억술의
mnemonics : n, 기억술
mnemonic symbol : x, 간략 기억 기호
Mnemosyne : n, 므네모시네(기억의 여신, 뮤즈 신의 어머니)
moa : n, 공조, 멸종된 뉴질랜드산의 타조 비슷한 큰 새
Moab : n, 모압(사해 동쪽에 있었던 시리아의 옛 왕국)
Moabite : n, a, 모압 사람(유대 사람과 싸웠던 고대 셈족, 모압 사람의
moan : vi, vt, 신음하다, 끙끙거리다, 한탄하다
moanful : a, 신음하는, 슬픈듯한
moat : m, vt, (성 둘레에)해자(를 두르다)
moated : a, 해자를 두른
mob : n, 군중, 폭도, 오합지졸
mobbish : a, 폭도와 같은, 무질서한, 떠들썩한
mobcap : n, (18, 19세기경의)여자용 실내 모자의 일종
mobile : a, 자유로 움직이는, 변하기 쉬운
mobile communication : x, 이동 통신(자동차, 선박, 비행기 등 이동체의 무선 통신)
mobile gas(oil) : x, 자동차용 휘발유
mobile home : x, 트레일러 주택, 이동주택
mobile library : x, 이동 도서관
mobile phone(telephone) : x, 이동 전화, 자동차 전화
mobile station : x, 이동(무선)국
mobile unit : x, 텔레비전 카메라 조정 모니터 장치, 송신 장치를 비치한 대형 트럭
mobility : n, 가동성, 기동성, 감격성
mobilization : n, 동원, 유통시킴
mobilize : vt, 동원하다, 가동성을 부여하다, 유통시키다
mobilize : n, 가동성, 기동성, 감격성
mobius strip : x, 뫼비우스의 띠, 장방형의 띠를 180도 회전시켜서 양끝을 붙인 곡면, 면이 하나뿐임
mob law : x, 폭민 정치, 사형
mobocracy : n, 폭민 정치, (지배자로서의)폭민
mob psychology : x, 군중 심리
MOBS : n, 다수 궤도 폭탄
mobsman : n, 폭도(군중)의 한 사람
mobster : n, 갱의 한사람
mocamp : n, 트레일러 캠프장(여행자들에게 텐트 장소, 트레일러 보관소 등을 마련해 주는)
moccasin : n, 북미 토인의 신발, 독사의 일종
moccasin flower : x, 참개불알꽃(난초과)
mocha : n, 모카
mock : vt, vi, 조소하다, 흉내내어 우롱하다, 무시하다, 조소의 대상, 우롱, 모방, 모조의(mock gravity 진지한 체하고서)
mock, up : n, 실물 크기의 모형(mockup stage 실험 단계)
mock auction : x, 짬짜미 경매
mocker : n, 조소하는 사람
mockery : n, 조롱, 조소의 대상, 흉내, 헛수고(make a mockery of 우롱하다, 놀리다)
mockfighting : n, 모의 전투
mockheroic : a, n, 영웅인 체하는, 영웅시를 본뜬(해학시)
mockingbird : n, (북미남부와 서인도 일대에 있는) 앵무새, 지빠귀류의 새, 지 빠귀의류의 새
mockingly : ad, 조롱하는 듯이, 희롱하여
mock moon : x, 환월
mock orange : x, 고광나무
mock sun : x, 환일
mock sun(moon) : x, 환일(환월)
mock turtle(soup) : n, (송아지 머리로 만든) 가짜 자라 수프
mock turtle soup : x, 가짜 거북 수프(거북 대신 송아지 머리로 만든)
mockup : n, 실물 크기의 모형
mockup stage : x, 실험 단계
mod : n, gael사람들의 시와 음악의 집회
modacrylic : x, 모드(수정) 아크릴 섬유
modal : a, 형태(형식)상의
modal auxiliary : x, (서)법 조동사(may, can, must, would, should 등)
modality : n, 형태, 양식, (판단의)양식, (의무, 재산 처리의)실행 방법n
mode : n, 양식, 하는 식, 식, 유행, 선법(out of mode 유행에 뒤떨어져, 한물 지나고)
model : n, 모형, 원형, 본, 설계도, 모델, 마네킨, 모범, 모범적인, 모형의, 모양을 마들다(점토 따위를 어떤 형으로)뜨다, 설계하다, ...을 본뜨다, model school 시법 학교)
model(l)er : n, 모형(소상)을 만드는 사람
model builder : x, 경제 모델의 작성자
model building : x, 모델 구성
modeling : , 모형 제작, 살 붙이는 기법
modeling clay : n, 소상용, 점토)
Model T : x, 발달 초기의, 구식의
modeltheoretic semantics : x, 모델 이론적 의미론(논리학적 의미론)
modem : n, (컴퓨터)변복조 장치
modena : n, 짙은 자줏빛
moderate : a, n, vt, vi, 온건한, 온화한, (양, 정도가) 알맞은, 웬만한, 보통의, 절제하는, 중간 정도의, 온건한 사람, 온건파의 사람, 삼가다, 중재인 노릇을 하다, 사회하다
moderate breeze : x, 건들바람
moderate gale : x, 센바람, 초속14, 17m
moderately : ad, 적당하게, 중간정도로
moderation : n, 적당, 중용, 완화(in moderation 정도에 맞게)
moderatism : n, 온건주의(특히 정치, 종교상의)
moderato : ad, 중간 속도로
moderator : n, 조정자, 조절기, 사회자, 의장
moderator lamp : x, 석유 조절등
modern : a, 현대의, 근대적인, 당세풍의, 모던한
modern dance : x, 현대 무용(자유롭고 자연스러운 동작으로 내면을 표현하려고 하는)
Modern English : x, english
Modern Greek : x, 근대(현대) 그리스러(1500년경 부터 현재까지)
Modern Hebrew : x, 현대 헤브루 말(현대 이스라엘에서 사용하는 말)
modern history : x, 근세사
modernism : n, 현대식, 현대사상, 근대어법, 근대주의
modernist : n, 현대주의자
modernistic : a, 근대(현대) 적인, 근대주의자의
modernity : n, 현대성, 현대풍, 현대적인 것
modernization : n, 근(현)대화
modernize : vt, vi, 근(현)대화하다
modern jazz : x, 모던 재즈(1940년대 이후의)
modern languages : x, 현대어(고전어와 대조적으로)
modern pentathlon : x, 근대 5종 경기
modern school : x, 근대어(과학)중시의 중, 고등학교(학과)
modern times : x, 현대
modern times : x, 현대
modest : a, 조신하는, 겸손한, 수줍은, 수수한
modestly : ad, 겸손하게, 얌전하게, 삼가서
modesty : n, 조심스러움, 수줍음, 겸양, 정숙
modesty panel : x, (앉은 사람의 다리 등이 안 보이게 책상 앞에 대는) 가림 판
modicum : n, 소량, 소액
modifiable : a, 변경(수식, 한정, 경감)할 수 있는
modification : n, 가감, 수정, 수식
modificatory : a, 한정(조절)하는, 변경(수정)하는
modified American plan : x, 변형 미국 방식(대실료, 조석 식대를 매일(매주) 정액으로 청구하는 호텔 요금 제도)
modifier : n, 수정자, 수식어
modify : vt, 가감하다, 완화하다, 수정하다, 수식하다
modigliani : , 이탈리아의 화가
modillion : n, 처마 까치발(코린트 양식의)
modish : a, 유행의, 멋쟁이의
modiste : n, 양재사, 장신구상
modular arithmetic : x, 모듈 산수, 시계산
modular coordination : x, 모듈에 의한 비례 설계(건축, 가구의)
modular home : x, 모듈 방식의 조립 주택
modularity : n, 모듈 방식(생산에 규격 부품을 쓰기)
modularize : vt, 모듈 방식으로 하다(조립하다)
modulate : vt, 조절하다, 음조를 바꾸다, 변조하다
modulation : n, 조절, 억양, 변조
modulator : n, 조절자(물), 음계도, 변조기
module : n, 단위, 기준, 산출 기준, 가 부분의 산출 기중, 모듈, ...선 (우주선의 구성 단위)
modus operandi : x, 활동 방식, 운용법
modus vivendi : x, 생활 양식, 잠정 협정
mogul : n, 무갈 사람, 거물, 무갈 황제
mohair : n, 모헤어(앙골라염소의 털), 모헤어천
mohammed : n, 마호메트(회교의 개조)
mohammedan : a, 회교의, 회교도
mohawk : n, 모호크 사람(New York주에 살던 북미토인)
Mohegan : n, 모히간 족(의 사람)(북미 인디언의 한 종족)
Mohican : n, =MAHICAN
Moho : n, 모호면, 모호로비치치 불연속면
Mohock : n, 모호크단원(18세기초 런던시내를 밤에 휩쓸고 다닌 악질 귀족 도당들)
Mohole : n, 모홀 계획(미국 과학 아카데미의 지구 내부 구조 규명 계획)
Mohorovicic discontinuity : x, (유고슬라비아의 지질학자 이름에서)=MOHO
mohs scale : x, 모스 굳기계
moider : vt, vi, 당황하게 하다, 곤란하게 하다, 괴롭히다, 자꾸 지껄이다
moidore : n, 포르투갈 및 브라질의 옛날 금화
moiety : n, 절반
moil : vi, 악착같이 일하다
moire : n, 물결무늬의 옷감
moist : a, 습한, 눅눅한, 비가 많은
moisten : vt, 습하게 하다, 적시다
moisture : n, 습기, 수분
moistureproof : a, 방습의
moisturesensitive : a, 습기를 잘 타는, 습기로 변질하기 쉬운
moisturize : vt, 습기를 공급하다, 가습하다, (화장품으로) (피부에)습기를 주다
moke : n, 당나귀, 멍청이, 흑인, 검둥이
mol : n, Manned Orviting Laboratory 유인 궤도 실험실
molar : a, 질량의
molar : n, a, 어금니(의)
molasses : n, 당밀
mold : n, 형, 거푸집, 모양, 특성, 성격, 거푸집에 널어 만들다, 연마하다
mold2 : n, 곰팡이
mold3 : n, 옥토, 경지, 토지
moldavia : x, 몰다비아, 소련 흑해 연안의 한 지방
moldboard : n, 보습, 불도저의 흙밀이 판
moldedin : a, 메워 넣어 성형된
molder : vi, vt, 썩어문드러지(게 하)다, 썩다, 허물어지다
molding : n, 주조물, 쇠시리
mold loft : x, (조선, 항공기 제작의) 현도장
moldy, mouldy : a, 곰팡난, 진부한
moldy fig : x, 정통파 재즈의 애호자, 유행에 뒤진 사람(것)
mole1 : n, 사마귀
mole2 : n, 두더지(blind as a mole 눈이 아주 먼)
mole3 : n, 몰, 그램분자
mole cricket : x, 땅강아지
molectronics : n, (단수 취급) 극소(미소) 전자 공학
molecular : a, 분자의, 분자로 된
molecular astronomy : x, 분자 천문학
molecular biology : x, 분자 생물학
molecular disease : x, 분자병
molecular electronics : x, MOLECTRONICS
molecular evolution : x, 분자 진화
molecular film : x, 분자막
molecular formula : x, 분자식
molecular genetics : x, 분자 유전학
molecularity : n, 분자상, 분자성
molecular structure : x, 분자 구조
molecular weight : x, 분자량
molecule : n, 분자
molehill : n, 두더지가 파올린 흙
mole plow : x, 지하 암거 굴착기
mole rat : x, 뒤지
mole shrew : x, 두더지
moleskin : n, 두더지 가죽, 몰스킨 면포, 그것으로 만든 바지
molest : vt, 괴롭히다, 지분거리다, 방해(간섭)하다
molestation : n, 훼방, 방해
molester : n, 괴롭히는 사람, 치한
moliere : n, 프랑스의 극작가
mollet : n, 기장
mollification : n, 완화, 진통
mollify : vt, 느그러지게하다, 달래다
Mollisol : n, 연토양(보통 풍부한 곡류를 산출하는)
mollusc, , lusk : n, 연체동물
Mollusca : n, 연체 동물문
molluscan : n, a, 연체 동물(문의)
molluscoid : n, a, 의연체 동물(의)
molluscous : a, 연체 동물 같은(에 속하는)
mollusk : n, 연체 동물
mollycoddle : vt, 응석받이로 기르다
molotov breadbasket : x, 소련의 모자소이탄
molotov cocktail : x, (대전차용)화염병
molt : vt, vi, n, (동물이) 탈피하다, 털을 갈(게 하)다, 탈피, 털갈이, 그 시기
molten : v, a, melt의 과거 분사, 족은, 주조된
moluccas : n, 몰루카군, 동인도 제도의 군도, 인도네시아령, Spice Islands라고도 함
molybdenum : n, 몰리브덴
momandpop : a, (가게가) 부부(가족)끼리 경영하는, 소규모의
moment : n, 순간, 때, 현재, 중요성, 계기, 요소, 축 둘레의 운동률, 모멘트, 역률(at any moment 언제라도, at the moment 당시)
momentarily : ad, 잠깐, 시시각각
momentary : a, 순간의, 찰나의
momently : ad, 각 일각, 시시각각
momentous : a, 중대한, 중요한
momentum : n, (물체의)타성, 여세, 운동량
momism : n, 모친 중심주의, 어머이에 의한 아들의 과보호
momma : n, =Mother
mommy : n, =mom
momo : n, 얼간이
Mon : , Monday, Monmouthshire(영국 남서부의 구주명)
monacid : a, 일산의
monaco : n, 모나코, 프랑스 남동의 작은 나라
monad : n, 단일체, 단자(원자, 혼, 개인, 신 따위)
monadelphous : a, (수술이) 단체인
monadism : n, 모나드론, 단자론
monadnock : n, 잔구
monadology : n, =MONADOSM
Mona Lisa : x, 모나리자
monarch : n, 군주
monarchal : n, 군주주의
monarchal : a, 군주의, 군주다운
monarchic : a, 군주(정치, 국)의
monarchism : n, 군주주의
monarchist : n, 군주제주의자
monarchy : n, 군주 정치(정체), 군주국
monastery : n, 수도원
monastic : a, 수도원의, 소도사의, 금욕(은둔)적인
monastical : a, 수도원처럼, 금욕적으로
monasticism : n, 수도원 생활(제도)
monasticism : n, 수도원 생활(제도)
monastreial : a, 수도원의, 수도원 생활의
monaural : a, (레코드 따위가)모노랄의, 한쪽귀의(에 쓰는)
mondaine : a, n, 사교계의(여성), 세속적인(여성)
mondaish : a, 나른한, 일요일 다음이라
monday : x, 월요일
Mondayish : a, 느슨한(일요일 다음이라)
Mondayize : vt, (휴일이 일요일 이어서) 월요일로 바꾸다
Monday morning quarterback : x, 나중에 이러쿵 저러쿵 비판하는 사람
Mondays : ad, 월요일 마다
monde : n, 세상, 사회, 사교계
mondrian : n, 네덜란드의 추상파 화가(파리에 살았음)
monel metal : x, 모넬 메탈, 니켈, 동의 내식 합금
moneme : n, 기호소
monensin : n, 모넨신(육우용 사료의 첨가물)
monent : n, 순간, 때, 현재, 중요성, 계기, 요소
monet : n, 프랑스의 화가, 인상파의 창시자
monetarily : ad, money
monetarism : n, 통화주의
monetary : a, 화폐의, 금전상의
monetization : n, 
monetize : x, 화폐로 정하다, 화폐로 주조하다
money : n, 돈(for money 돈으로 돈을 위해, hard money 경화, 정금, lucky money 행운이 온다고 몸에 지니고 다니는 돈)
moneybag : n, 돈주머니 지갑, 재산, 부자, 욕심쟁이
money bill : x, 재정 법안
moneybox : n, 돈궤, 저금통, 헌금통
money changer : x, 환전상
money crop : x, 환금 작물
moneyed, monied : a, 돈 있는, 부자의, 금전(상)의, 재계, 자본가들
moneygrubber : n, 축재, 돈만 아는 사람, 수전노
moneygrubbing : n, a, 축재(에 열심인), 축재가의
moneylender : n, 대금업자
moneyless : a, 돈 없는
moneymaker : n, 축재가, 돈벌이 되는 일
moneymaking : n, 돈벌이
money market : x, 금융시장
money order : x, 환
money order : x, 우편환
money player : x, 경합에 강한 사람(선수등), 큰 돈벌이에 능한 사람
money rates : x, 금리
moneysaving : a, 돈을 절약(저축)하는
money smash : x, 홈런
money spinner : x, 일종의 작은 거미(이것이 몸에 기어다니며 행운이 찾아 온다는), 투기(고리대금등)로 돈을 모은 사람
money supply : x, 통화 공급량
money wages : x, 명목 임금
money washing : n, 부정 취득한 자금을 합법적으로 보이기 위해 외국 은행 등에 이동시키며 출처를 감추기
moneywort : n, 금좁쌀풀류의 덩굴풀
monger : n, 상인, , 상, , 장수
mongol : n, a, 몽고 사람(의)
mongolia : n, 몽고
mongolian : n, a, 몽고 사람(의), 몽고인종(에 속하는), 몽고말(의)
Mongolic : n, 몽고어군(알타이 어족에 속하며 Mongolian, Buryat, Kalmuck을 포함)
Mongolism : n, 몽고증(선천적 치매증의 일종)
mongoloid : a, n, 몽고인 비슷한 (사람)
mongoose : n, 몽구스, 인도산의 족제비 비슷한 육식 동물, 독사를 먹음
mongrel : n, a, 잡종(의), 주로개
mongrelize : vt, 잡종을 만들다, (경멸)(인종, 민족의 성격을) 잡종화하다
moniker, -icker : n, 이름, 별명
moniliform : a, (뿌리, 줄기 등이)염주 모양의, 염주 비슷한
monism : n, 일원론
monist : n, 일원론자
monition : x, 경고, 훈계, 소환
monitor : n, vt, vi, 권고자, 경고자, 학급위원, 장갑함, 큰도마뱀의 일종, 자유회전통구, 방사능 탐지기, 컴퓨터 모니터, ...을 같시하다, 방사능의 강도를 검사하다
monitorial : a, 경고의, 감시의
monitory : a, 경고의, 권고의, 훈계의, 계고장
monk : n, 수도사
monkery : n, 수도사 생활, 수도사의 관행(신조), (집합적)수도사, 수도원
monkey : n, 원숭이, 장난꾸러기, 흉내를 내는 아이, 젊은 것(monkey up 성내다(성내게 하다, monkey business 장난, 기만), 낭난치다, 놀려대다, 흉내내다, 놀려대다
monkey block : x, 고리 달린 도르레
monkey bread : x, 나무(의 열매)
monkey businiss : x, 기만, 사기, (짓궂은) 장난, 바보 같은 짓
monkey cage : x, 감옥
monkey clothes : x, 정장 군복
monkeyengine : n, 말뚝박는 기계, 향타기
monkeyfaced : a, 원숭이 같은 얼굴을 한
monkey flower : x, 물꽈리아재비
monkeyish : a, 원숭이 같은, 장난 좋아하는
monkey jacket : x, (옛 날 선원이 입던) 짧고 꼭 끼는 상의
monkey meat : x, 통조림 쇠고기
monkey nut : x, 땅콩
monkey pox : n, 원두(원숭이의 수두 비슷한 전염병)
monkey puzzle : x, 칠레소나무
monkeyshine : n, 장난, 놀림
monkeyshine : n, 장난
monkey suit : x, 제복, (남자용)예복
monkey time : x, 서머 타임
monkey trial : x, 원숭이 재판(진화론파와 천지 창조파 간에 벌이고 있는 재판)
monkey tricks : x, =MONKEY BUSINESS
monkey wrench : x, 자재 스패너
monkish : a, 소두사 티가 나는, 중 냄새 나는(나쁜 의미로)
monkshood : n, 투구꽃 무리
monnogamist : n, 일부 일처주의자
mono : n, 의 뜻의 결합사
monoacid : a, 산의
monobasic : a, 1염기의
monobuoy : n, 모노부이(항구에 입항할 수 없는 대형 탱커 등을 계류하기 위한 바다의 부표)
monochord : n, (음정 측정용) 일현금
monochromatic : a, 
monochrome : n, 단색(화)
monocle : n, 단안경
monocled : a, 외알 안경을 낀
monoclinal : a, 지층이 단사의
monocline : n, 단사
monoclinic : a, 단사정계의
monoclinous : a, 양성화의
monoclonal : a, 단일 세포에서 유래하는 세포인(로 만들어 지는)
monoclonal antibody : x, 단일 클론 항체
monocoque : n, 모노코크(구조), (자동차의) 단체구조 차체
monocotyledon : a, 단자엽(외떡잎) 식물
monocracy : n, 독재 정치
monocrat : n, 독재자, 독재 정치 지지자
monocratic : a, 독재 정치의
monocular : a, 단안용의
monoculture : n, 단작
monocycle : n, 단핵 백혈구
monocyte : n, 단핵, 백혈구
monodrama : n, 모노드라마, 1인극
monody : n, (그리스 비극의)서정적 독창부, 만가
monoecious : a, 자웅동주의, 자웅동체의
monogamist : n, 일부 일처주의자
monogamous : a, 일부 일처의, 일자 일웅
monogamy : n, 일부 일처제(주의)
monogenesis : n, 일원, 일원 발생설, 단성(무성) 생식
monogenic : a, 단성의(한쪽 성의 자손만 생기는)
monogenism : n, 인류 일조설
monoglot : a, n, 한나라 말만을 하는 (사람)
monogram : n, 짜맞춘 글자, 도형화한 머리 글자 등
monogrammatic : a, 결합 문자(모양)의
monograph : n, vt, (특정 테마에 대한)전공 논문(을 쓰다)
monographer : n, 전공 논문 집필자
monographic : a, 전공 논문의
monogynous : a, 일처(주의)의, 일처제의
monogyny : n, 일처(주의)의, 일처제
monohull : n, 단선체선
monokini : n, 토플리스 수영복, (남성용의) 극히 짧은 팬츠
monolatry : n, 일신 숭배
monolingual : a, n, 1개 국어를 사용하는 (사람)
monolith : n, 돌 하나로 된 비석, 기둥(따위), 통바위, 단암
monolithic : a, 단암의, (사상, 정책이)일관된, 혼란이 없는
monolithic unity : x, 바위 같이 굳은 단결
monolog(ue) : n, 독백(극), 이야기의 독차지
monologist : n, 독연자, 독백자, 회화를 독차지하는 사람
monologize : vi, 독백하다, 혼잣말하다, 회화를 독점하다
monomania : x, 편집광
monomaniac : n, 편집광 환자
monomanoacal : a, 편집광적인
monomark : n, (소유자, 상품명, 제작자 등을 등록한)짜맞춤 기호(문자)
monomer : n, 단량체, 단위체
monometallism : n, (화폐의)단본위제
monomial : a, n, 단항식(의), 한말로 된(명칭)
monomolecular : a, 한 분자의 두께의, 한 분자의
mononucleosis : n, (전염성) 단구 증가증
monophobia : n, 고독 공포증
monophonic : a, 단선율의, (컴퓨터)모노포닉의
monophthong : n, 단모음
monopitch : n, (말, 노래소리의)단조로움
monoplane : n, 단엽 비행기
monopolistic : a, 독점적인, 전매의
monopolization : n, 독점, 전매
monopolize : , vt독점하다, 전매권을 얻다
monopolost : n, 전매(론)자, 독점(론)자
monopoly : n, 독점(권), 전매(권), 독점물, 전매품, 전매회사, 독점자
monopropellant : n, (로켓의) 일원 추진제(약)
monopsony : n, 구매자(수요) 독점
monopsychism : n, 심령 일원설
monorail : n, 단궤철도
monosodium glutamate : x, 글루타민산소다, 조미료
monosyllabic : a, 
monosyllable : n, 단음절어(speak in monosyllable 퉁명스럽게 말대답하다)
monotheism : n, 일신교, 일신론
monotheistic : a, 일신론(교)의
monotone : n, vt, 단조(음), 단조롭게 이야기 하다
monotonous : a, 단조로운, 변화가 없어 지루한
monotony : n, 단음, 단조, 단조로움
monotransitive : a, 직접 목적어만을 취하는 (동사)
monotrematous : a, 단공류의
monotreme : n, 단공류의 동물(오리너구리, 바늘두더지 등)
monotype : n, 자동 주조 식자기, 모노타이프
monovalence : n, 1가(임), (특정 병균에 대한) 항균력
monovalent : a, 1가의, 특정한 병균에만 저항할 수 있는
monovular : a, 일란성의, 일란성 쌍생아에 특유한
monoxide : n, 일산화물
monroe : n, 미국 제5대 대통령
monroe doctrine : , (유럽 각국은 미대륙 각국에 대하여 간섭해서는 안된다고 한)먼로주의x
Monroe Doctrine : , 유럽 각국은 미대륙 각국에 대하여 간섭해서는 안된다고 한)먼로주의
monseigneur : n, 전하, 각하
monseigneur : x, 전하, 각하
monsieur : n, 씨, 귀하, 님
monsoon : n, (인도양, 남아시아의)계절풍
mons pubis : n, 남자의 치구
monster : n, a, 괴물, 도깨비, 거수, 악독한 사람, 거대한
monster lane : x, 다차선의 맨 횐쪽 차선
monster man : x, 정수비 위치가 없는 라인백
monstrance : n, 성체 안치기
monstre sacre : n, 기인, 괴짜, (영화 등의) 대스타
monstrosity : n, 기형, 괴물, 지독한 행위
monstrous : a, 거대한, 괴물같은, 기괴한, 어처구니 없는, 극악 무도한
Mont : x, Montana
montage : n, 혼성화, 합성(몽타주)사진, 몽타주(작은 화의며늬 급속한 연속에 의학 구성), 필름 편집
Montagnard : n, (베트남의) 산지인, (캐나다의) 로키 산맥 속에 사는 북미 인디언족
Montaigne : , Michel Eyquem de(1533, 92)몸테뉴(프랑스의 철학자, 수필가)
Montana : n, 미국 북서부의 주)
Mont Blanc : x, 몽블랑(알프스의 최고봉)
monte : n, (스페인에서 비롯한) 카드 도박
monte carlo : x, 모나코의 도시, 공설 도박장이 있음
Monte Carlo method : x, 몬테카를로법(복잡한 물리 현상을 수학적으로 풀기 위하여 난 수 표룰 사용하는 방법)
montenegrin : n, a, 몬테네그로 사람(의)
Montenegro : n, 몬테네그로(Yugoslavia 남서부의 연방 구성 공학국, 원래 왕국)
montesquieu : , 르랑스의 사상가
Montessori method(system) : x, (이탈리아의 여성 교육가 이름에서) 몬테소리식 교육법(아동의 자주성의 신장을 중시한 교육법)
Monteverdi : n, 몬테베르디(1567-1643)(이탈리아 작곡가)
Montevodeo : n, 몬테비데오(남미 Uruguay 공화국의 수도)
month : n, 월, 달(a month of Sundays 오랫동안)
month's mind : x, (사후 1개월만의)추도 미사
monthly : a, n, 매달의, 월1회의, 월간 잡지, 월경
monthly nurse : x, 산모 간호사(산후 한 달 동안의)
monthly period : x, 월경(기간)
monthly rose : x, (사계화인) 월계화
monticule : n, 작은 산(언덕), 기생 화산, 화산구
montmartre : n, 몽마르트르, 파리 북부의 고지대
montparnase : n, 몽파르나스, 파리 서남의 고지대
montreal : n, 캐나다 최대의 도시, 상공업 중심지
montreal protocol : x, 몬트리올 의정서, 1987년 오존층 보호를 위해 채택됨
monument : n, 기념비, 기념상, 기념문, 기념관, 기념물, 문서, 기록(the Monument 1666년 런던 대화재 기념 원탑
monumental : a, 기념(물)의, 기념되는, 불멸의, 거대한, 실물보다 큰(monumental mason모석 제조인)
monumentally : ad, 
moo : vi, n, (소가) 음매 울다, 그 우는 소리
moo-cow : n, 음매 음매(암소)
mooch : vi, vt, 건들 건들 (살금살금)거닐다, 배회하다, 훔치다, 우려내다
moocher : n, 살금살금 걷는 사람, 떠돌이, 부랑자, 거지, 좀도둑
mood1 : n, 마음(의상태), 기분(be in no mood ...할 마음이 없다, in the mood...할 마음이 나서, a man of moods 변덕쟁이n
mood2 : n, 법, 선법, 음계법
mood drug : x, 기분 약(흥분제, 진정제 등)
moodily : ad, 우울하게
mood music : x, 무드 음악
mood ring : x, 무드 링(끼고 있는 사람의 마음의 움직임에 따라 색이 변한다는 반지)
moody : a, 까다로운, 우울한
moo juice : x, 우유
mook : n, 무크, 서적풍의 잡지, 잡지풍의 서적
moola(h) : n, 돈, 금전
moolvee, -vie : n, (인도) 회교 율법학자, 학자, 선생(경칭)
moomquake : n, 월진
moon : n, vt, vi, 달, 위성(blow the moon 이 세상의, cry for the mon 실현 불가능한 것을 바라다), 멍하니 바라보다, 멍하니 시간을 보내다
moonbeam : n, 달빛
moonblind : a, (말이) 밤눈 어두운, 야맹증인
moon blindness : x, 월맹증, 밤눈 어두운, 야맹증
moonbound : a, 달로 가는
moonbow : n, 달빛의 굴절로 생기는 무지개
moonbug : n, 달 착륙선
moonbuggy : n, 월면차
mooncalf : n, (선척적) 백치
moon car : x, 월면차
moon child : x, 게자리 태생의 사람
mooncraft : n, =MOONSHIP
moon crater : x, 월면의 분화구
moon crawler : x, 월면차
moondown : n, =MOONSET
mooner : n, 병적인 결함을 가진 범죄자
moon exploration : x, 달 탐험
mooneye : n, 월맹증의 눈
mooneyed : a, (공포, 감탄 때문에) 눈이 휘둥그래진
moonface : n, 둥근 얼굴
moonfaced : a, 얼굴이 둥근
moonfall : n, 달 착륙
moonfish : n, 전갱이과의 물고기
moonflight : n, 달 여행(비행)
moonflower : n, 메꽃과의 꽃(열대 아메리카산), 프랑스 국화
Moonie : n, 통일교 신자, 원리 운동지지자
mooning : n, (달리는 차 등의 창문에서) 엉덩이를 내보이기
moonish : a, 달 같은, 변덕스러운, 통통한
Moonism : n,  (교주 Sun Myung Moon(문 선명에서)), 세계 기독교 통일 신령협회주의, 원리 운동
moon jeep : x, 월면차
moon jeep : x, 월면차
moonless : a, 달 없는
moonlet : n, (자연 또는 인공의)소위성
moonlight : n, a, vi, 달빛(의), 아르바이트할
moonlighter : n, (밤에) 부업을 하는 사람, 야습 참가자, 월광단원
moonlight flitting : , 야반 도주
moonlit : a, 달빛에 비친, 달빛 어린
moonman : n, 월인, 달탐험가
moon month : x, 태음월
moon pool : x, 문풀(심해 굴착선 중앙의 원통상공동 설비, 기재를 오르내리는 곳)
moonport : 달로켓 발사 기지, n, 
moonquake : n, 월진
moonscooper : n, 자동 월면 물질 채집선
moonshine : n, 달빛, 부질없는 생각, 밀주, 밀수입주
moonshiner : n, 주류 밀조자, 밀수입자
moonship : n, 달 여행용 우주선
moonshot : n, 달로켓(발사)
moonstone : n, 월장석
moonstrike : n, (로켓의) 월면 착륙
moonstroll : n, 월면보행
moonstruck : a, 실성한, 광기와 달빛과는 상관 관계가 있다고 여겨 왔음
moon type : x, (맹인용의)문식선자
Moon type : , 맹인용의 문식선자(영국인 W, Moon 발명)
Moon type : x, (영국인 고안자 이름에서)문타이프(문자 습득후의 실명자를 위한 도드라진 문자의 서체, 인쇄법)
moonwalk : n, 월면 보행, 달 산책
moonwalker : n, 달밤에 걸어다니는 몽유병자
moonward(S) : ad, 달을 향해서
moon work : x, 월면 작업
moonwork : n, 월면 작
moony : a, 달 같은, 초승달 모양의, 꿈같은, 얼빠진
moor : n, 무어사람, 아프리카 북서부에 사는 회교도
moor1 : n, 황야, 사냥티
moor2 : vt, (배를) 계류하다, 정박시키다
moorage : n, 계류(소), 계류료
moorcock : n, 붉은 뇌조의 수컷
moorfowl : n, 붉은 뇌조
moorgame : n, 붉은뇌조
mooring : n, 계류기구, 계선장, 계류, 계선
moorish : a, 무어 사람(식)의
moorland : n, 황야
moorstone : n, 화강암의 일종
moory : a, 황야성의, 습지성의
moose : n, 큰 사슴
moot : n, a, vt, 집회, 모의재판, 논의의 여지가 있는, 토의하다
moot court : x, (대학의) 모의 법정
mop1 : n, vt, 자루걸레(a mop of hair 더벅머리, 자루걸레로 닦다, 훔쳐 내다, 이익을 빨아 먹다
mop2 : n, vi, 찡그린 얼굴, 얼굴을 찡그리다
mopboard : n, (방 벽의) 걸레받이널, 굽도리널
mope : vi, vt, 침울해지다, 침울하게 하다, 풀이 죽다, 풀죽게 하다
moped : n, 발동기 달린 자전거
moper : n, 곧잘 침울해지는 사람, 운전이 느린 사람
mopery : n, 경범죄
mopey : a, 생기없는, 나른한, 시무룩한
mophead : n, 더벅머리
mopish : a, 침울한
moppet : n, (헝겊으로 만든)인형, 아이, (특히)계집아이, 발바리
moppingup : a, 총정리의, 소탕의
moppy : a, 더부룩한(머리)
MOR : x, middle of the road 누구나 좋아하는 음악
moraine : x, 빙퇴석
moral : a, 도덕(상)의, 윤리적인, 교훈적인, 도덕적인 풍행 방정한, 정신적인, 개연적인, 우화, 산건 등의 교훈, 수신, 도덕, 윤리학, 예절, 몸가짐(Point a moral 보기를 들어교훈하다)
moral certainty : x, 결코 틀림이 없음, 확실성
moral code : x, 도덕률
moral courage : x, 도덕적(참다운)용기
moral cowardice : x, 남의 비난, 반대를 두려워함
moral defeat : x, (이긴 듯이 보이나) 사실상의 (정신적인) 패배
morale : n, 사기(특히 군대의), 의욕, 의기, 도덕, 도의
morale : n, 사기, 풍기
moral evidence : x, 개연적 증거
moral hazard : x, 도덕(인위)적 위험
moralist : n, 도덕가, 윤리(도덕)학자, 도덕주의자
moralistic : a, 도학(교훈)적인
morality : n, 도덕, 도의, 교훈, 우의
morality : x, 도덕(성), 윤리학, 도덕률, 도의, 덕행, 교훈
moralize : vt, vi, 도를(도덕을)설교하다, 도덕저긍로 해석하다, 도의심을 환기시키다, 교화하다, 석교하다
moralizer : n, 도를 설교하는 사람
moral law : x, 도덕률
morally : ad, 도덕적으로, 실제로, 진실로
moral obligation : x, 도덕적 책임
moral philosophy(science) : x, 도덕학, 윤리학
moral rcarmament : x, 도덕 재무장 운동
moral sense : x, 도덕관념, 양심
moral turpitude : x, 부도덕한 행위
moral victory : x, 정신적 승리, 지고도 사기가 왕성해지는 경우
moraly : ad, 도덕적으로, 실제로, 진실로
morass : n, 소지, 
moratorium : x, 모라토리엄, 지급 유예령(기간)
morbid : a, 병적인, 불건전한, 병의, 섬뜩한
morbid anatomy : x, 병리 해부학
morbidity : n, 병적인 상태, 불건전
mordacious : a, 신랄한, 비꼬는
mordant : a, n, 비꼬는, 신랄한, 찌르는 듯한, 부식성의, 매염의, 색을 정착키는, 매염제, 금속 부식제, 금박 점착제
more : a, ad, 더 많은, 더큰, 그이외의, 더 말은 수, 그 이상의 것(what is more 더우기), 더욱, 더, 일층(all the more 더욱더, and no more ...에 불과하다, be no more 이미 없다, 죽었다)
more : , 영국의 대법관, 사상가
moreen : n, 모린(커튼 등에 쓰는 튼튼한 모직물 또는 면모 교직물)
moreish : a, 더 먹고 싶어지는, 아주 맛있는
morel : n, 그물버섯, 까마종이
morello : n, 모렐로(양뻐찌의 일종)
more over : x, 더욱이
moreover : ad, 더욱이
mores : n, 관습, 습관
morganatic marriage : x, 귀천 상혼, 왕족, 귀족이 평민의 여자와 결혼한 경우로
morgue : n, 시체 공식소, (신문사의)자료부
moribund : a, 다 죽어 가는
morion : n, (16-17세기 스페인 보병의) 모자 모양의 투구
mormon : n, 모르몬 교도
mormonism : n, 모르몬교
morn : n, 아침
morning : n, 아침, 오전, 주간, 여명(in the morning 오전중 of a morning 언제나 아침 나절에)
morning after : x, 숙취, (악에서의)뉘우침
morningagter pill : x, 성교후에 먹는 경구 피임약
morning call : x, 오후의 정식 방문
morning coat : x, 모닝 코트
morning dress : x, 여성용 가정복, (남자의)주간예복
morning gift : x, 결혼 다음 날 아침 남편이 아내에게 주는 선물
morning glory : x, 나팔꽃
morning paper : x, 조간(신문)
Morning Prayer : x, (영국 국교회의) 아침 예배
morning room : x, 낮에 사용하는 거실
mornings : ad, 아침에(늘), 아침마다
morning sickness : x, 입덧
morning star : x, 샛별(금성)
morning watch : x, 아침 당직
moro : n, (필리핀의) 모로족의 토인
Moroccan : a, n, 모로코(사람)의, 모로코 사람
morocco : n, 아프리카 북서안의 회교국, 모로코 가죽
moron : n, 정신 박약자, 지능지수 50, 69이고 정신연령 8, 12세인 성인
morose : a, 까다로운, 시무룩한, 부질없는
morpheme : n, 형태소(syntactical 한 관계를 나타내는 요소)
morphemic : a, 형태소의, 형태소론의
morphemics : n, (단수 취급) 형태소론
morpheus : n, 꿈, 잠의 신
morphia : x, 모르핀
morphinism : n, 모르핀 중독자
morphinomania : n, (만성) 모르핀 중독
morphogenesis : n, 형태 형성(발생)
morphological : a, 형태학(상)의
morphologist : n, 형태학자
morphology : n, 형태학, 어형론, 형태론
morris(dance) : n, 모리스춤, 주로 may day에 가지는 가장 무도
morrison shelter : x, 이튿날, 아침, (사건)직후
morrow : n, 이튿날, 아침, 직후
morse code(alphabet) : x, 모스(전신) 부호
morsel : n, (음식의) 한입, 한조각, 소량
mortagage : n, 저당(권), 저당잡히기(on mortgage 저당잡아, 저당잡히다
mortagagee : n, 저당권자
mortagagor : x, 저당
mortal : a, n, 죽어야 할, 인간의, 치명적인, 불치의, 길고 긴, 지루한, 생각할 수 있는, 가능한(be of no mortal use 아무짝에도 쓰데 없다), 죽어야 할 것, 인간
mortality : n, 죽음을 면할 수 없음, 죽어야 할 운명, 사망자수, 사망률
mortality table : x, 사망률 통계표
mortaly : ad, 치명적으로, 굉장히
mortar1 : n, vt, 모르타르, 회반죽, 모르타르로 굳히다
mortar2 : n, vt, 철확, 절구, 유발, 박격포(로 사격하다)
mortarboard : n, (모르타르용)흙손, (대학의) 사각 모자
mortgage : n, 저당, 저당잡힘, 저당권
mortgagee : n, 저당권자
mortgagor : n, 저당권 설정자
mortician : n, 장의사
mortiferous : a, 치명적인
mortification : n, 고행, 금욕, 탈저, 굴욕, 억울함
mortificationing : a, 분한, 고행의
mortify : vt, vi, 억제하다, 굴욕을 느끼게 하다, 상하게 하다, 탈저에 걸리다
mortifying : a, 분한, 원통한, 고행의
mortise, tice : n, 장붓구멍, 장부촉 이음으로 잇다
mortise lock : x, 문에 박은 자물쇠
mortmain : n, 영구 소유
mortuary : n, 시체 임시 안치소, 죽음의, 매장의
mosaic : n, a, 모자이크, 쪽매붙임 세공, 모자이크식의
mosaic : a, 모세의
mosaic disease : x, 모자이크 병(식물의 전염병)
mosaic gold : x, 황화 제 이 주석
mosaic law : x, 모세의 율법
moscow : n, 모스크바, 소련의 수도
moses : n, 모세(아브리의 입법자)
mosey : vi, 배회하다, 방황하다, 어슬렁거리다, 달아나다, 뺑소니치다
MOSFET : n, 금속 산화막 반도체 전계 효과 트랜지스터
moshav : n, 모샤브(이스라엘의 자영 소농이 모인 공동 농장)
moslem : n, 회교도
Moslem Brotherhood : x, 이슬람형제단(이슬람 원리주의를 신봉하는 과격 단체)
Moslem fundamintalism : x, 이슬람 원리 주의 (이슬람의 전통을 엄수하는 복고주의)
moslemism : n, 이슬람교, 회교
mosque : n, 회교 교당
mosquito : n, 모기
mosquito boat : x, 고속 어뢰정
mosquito canopy : x, 소형의 모기장
mosquito craft : x, 소함정
mosquito curtain : x, 모기장
mosquito fleet : x, 쾌속 소함정대
mosquito hawk : x, 잠자리, 쏙독 새류
mosquito netting : x, 모기장 감
moss : n, vt, 이끼, , 이탄지, 이끼로덮다
mossback : n, 구식 사람, 극단적 보수주의자, 촌놈
mossgrown : a, 이끼 낀, 시대에 뒤진
moss rose : x, 이끼 장미
moss rose : x, 모스로즈(장미의 일종)
mosstrooper : n, (17세기 잉글랜드, 스코트랜드 국경에 출몰한)늪지의 산적, (일반적으로) 산적, 약탈자, 습격자
mossy : a, 이끼 낀, 이끼 같은, 케케묵은
most : a, n, ad, 가장 큰, 대부분의, 가장 많은 것, 대개의 것(for the most part 주로, 보통 make the most of...을 충분히 이용하다), 주로, 보통, 가장, 많이
mostest : n, 최대량, 극도(의 것)
most favored nation : x, 최혜국
mostfavorednation clause : x, 최혜국 조관
mostly : ad, 대개
mostuito net : x, 모기장
mot : n, 경구, 명구
mote : n, 티끌, 아주 작은 조각, 남의 사소한 결점(mote and beam티와 들보, 남의 작은 과실과 지기의 큰 과실, mote in another's eye 남의 사소한 결점)
motel : n, 자동차 여행자 숙박소
motelier : n, 모텔 경영자
motet : n, 경문가, 모테트
moth : n, 나방, 좀벌레, 유혹의 포로
mothball : n, 좀약(나프탈렌 따위), (in mothballs 퇴장하여)
mothball fleet : x, 예비 함대
motheaten : a, 좀먹은, 시대에 뒤진, 구식의
mother : n, vt, 어머니, 수녀원장, 근원, 어머니로서 돌보다, 낳다
motherboard : n, 머더보드(신호 케이블이나 전원 배선을 공통화하기 위해 각종 인터페이스 회로판을 배치 하는 보드)
Mother Carey's chicken : , 바닥제비, 바다쇠오리
mother careys chicken : x, 바다 제비, 바다 쇠오리
mother church : x, 어머니 같은 교회, 본 교회, 본산
mother country : x, 본국, 모국
mothercraft : n, 육아법(어머니로서의 지식과 기술)
mother earth : x, 대지
motherfucker : n, 비열한(지긋지긋한)놈(것), 쌍놈
motherfucking : a, 비열한
Mother Goose : x, 머더 구스(영국의 전승 동요집)
Mother Goose rhyme : x, (전승) 동요
motherhood : n, 어머니임, 모성, 모친의 정신, (집합적) 어머니
Mother Hubbard : x, 길고 풍신한 여자용 가운
mothering : n, 귀성, 근친
motherinlaw : n, 장모, 시숙, 시어머니
motherinlay : n, 장모, 시어머니
motherland : n, 모국, 조국
motherly : a, 어머니의, 어머니 같은
motherofpearl : n, 진주 충, 진주모, 자개
mothers day : x, 어머니 날(5월의 둘재 일요일)
mother ship : x, 모함
mother state : x, 버지니아의주의 통칭
Mother State : x, Virginia주의
mother superior : x, 수녀원장
mothertobe : 임신부, n, 
mother tongue : x, 모국어
mother wit : x, 타고난 지혜
mothproof : a, 방충제를 바른, 방충 처리하다
motif : n, (예술 작품의)주제, 주선율, 레이스 장식
motion : n, 움직임, 동작, 몸짓, 의회 등에서의 동의, 신청, 동의(in motion 움직여, 활동하여 on the motion of ...의 동의로), 움직이지 않는, 정지한
motionless : vt, 움직이 않는, 정지한, 뭄짓으로 신호하다(to, toward, away, to do)
motion picture : x, 영화
motivate : vt, 동기를 주다, 자극하다, 꼬드기다
motivation : n, 동기를 줌
motivational research : x, 동기 조사
motive : a, n, vt, a, 운동을 일으키는, 동기가 되는, 동기, 동인, =Motivate(motive less 동기없는, 이유 없는)
motiveless : a, 동기 없는
motive power : n, 원동력, 기관차
motley : a, 잡색의, 잡다한, 뒤범벅, 어릿광대의 울룩덜룩한 옷(wear motley 광대역을 하다)
motor : n, a, vt, vi, 원동력, 발동기, 전동기, 내연기관, 운동 근육, 움직이게 하는, 원동의, 자동차로 가다(수송하다)
motorbike : x, 모터 바이크, 소형 오토바이
motorboat : n, 모터 보트, 발동기선
motorcade : n, 자동차 행렬
motorcar : n, 자동차
motor court : x, =MOTEL, AUTOCOURT
motorcycle : n, 오토바이
motordrome : n, 자동차 시운전장
motorist : n, 자동차 운전자
motorization : n, 
motorize : vt, , , 에 동력 설비를 하다, 자동차화하다, (motorized unit자동차 부대)
motor lodge : x, =MOTEL
motorman : n, 전차 운전수
motor merve : x, 운동 신경
motor muscle : x, 운동 근육
motor pool : x, 배차용 자동차군, 주차장
motor scooter : x, 스쿠터
motor ship : x, 발동기선
motor spirit : x, 가솔린
motor torpedo boat : x, 고속 어뢰정
motorway : n, 고속도로
mottle : vt, n, 잡색으로 하다, 얼룩, 바둑무늬
mottled : a, 얼룩진, 잡색의
motto : n, 명, 금언, 표어, 모토, 논문 등의 첫머리에 인용한)제구, 반복 악구
moujik : n, =MUZHIK
mould : , =MOLD
mould2 : n, 
mould3 : n, 
moult : v, n, =MOLT
mound : n, 흙무덤, 작은 언덕, 석가산, 투수판(take the mound 투수가 되다)
mount : n, 산, 언덕, 궁(손바닥 살의 융기)
mount : vi, vt, n, 오르다, 타다, 앉히다, 박다, 붙이다, 무대에 올리다, 물가가 오르다(mount guard over ...을 지키다, 승용 말, 대지, 보석의 대좌, 포가
mountain : n, 산, 산더미 같은(make a mountain of a molehill침소봉대하다, mountain high 파도 따위가 산더미 같은, remove mountains 기적을 행하다)
mountain ash : x, 마가목류
mountain chain : x, 산맥
mountaineer : n, 등산가, 산악 지대 주민, 등산하다
mountaineering : n, 등산
mountain lion : x, 퓨마
mountainous : a, 산이 많은, 산더미 같은
mountain oyster : x, 요리한 양 또는 쇠불알
mountain range : x, 산맥, 산악 지방
mountain rice : x, 밭벼
mountain sickness : x, 고산병
mountainside : n, 산허리
mountainside : n, 산허리
mountain system : x, 산계
mountain time : x, 산지 표준시
mountebank : n, 사기꾼, 돌팔이 약장수
mountebankery : n, 사기, 협잡
mounted : a, 말탄, 기마의, 기동력이 있는, 박힌, 붙박이한
mourn : vi, vt, 슬퍼하다, 애도하다, 몽상하다
mourner : n, 애도자, 상중의 사람, 회장자
mournful : a, 슬픔에 잠긴, 슬픈, 애처로운
mourning : n, 슬픔, 애도, 상, (fo into mourning 거상하다, 상복을 입다, half mourning 약식 상복, in mourning 상죽인, 상복을 입고, leave off mourning 탈상하다)
mourning band : x, 상장
mourning coach : x, 장의 마차, 영구차
mourning paper : x, 까만 테를 두른 편지지
mouse : n, vt, 새앙쥐, 얻어맞은 눈두덩의 멍(poor as a church mouse 매우 가난한, 찰가난의, like a drowned mouse 비참한 몰골로, mouse and man 모든 생물, 고양이가 쥐를 잡다
MOUSE : , Minimum Orbital Unmanned Satellite of Earth 소형지구 궤도 무인 인공 위성
mouser : n, 쥐 잡는 동물(고양이, 올빼미 따위)
mousetrap : n, 쥐덫
mouth : n, 입, 부양 가족, 출입구, 찡그린 얼굴, 건방진 말투(by word of 구두로 down in the mouth 낙심하여, fron hand to mouth 하루살이 생활의, have a foul mouth 일정이 사납다)
mouthfilling : a, 호연 장담하는
mouthful : n, 한 입, 입 가득, 소량
mouth organ : x, 하모니카
mouthpiece : n, 빨대 구명, 부는 구명, 마우드피스, 재갈, 대변자
mouthwash : n, 양치질 약
mouthy : a, 수다스러운, 흰소리 치는
movability : n, 가동성
movable : a, 움직일 수 있는, 이동할 수 있는( movable feast 해에 따라 날짜가 달라지는 축제일), 가재, 가구, 동산
move : vt, 움직이다, 제출하다, 호소하다, 창자의 배설을 순하게 하다, 움직이다, 이전하다, 활약하다, 제안하다, 움직임, 운동, 이전(be up to ebery move on tne board민첩하다, 빈틈이 없다)
movement : n, 움직임, 동작, 운전, 기계의 움직이는 부분, (사회적, 정치적)운동, 악장, 변통, 나도는 상황(in the movement 풍조를 타고)
movie : n, 영화, (go to the movics 영화 구경 가다)
moviedom : n, 영화계
moviegoer : n, 자주 영화 구경 가는 사람
movie house : x, 영화관
moving : a, 움직이는, 감동시키는, 동기가 되는, 원동력의
movingly : ad, 감동적으로
moving picture : x, 영화
moving staircase : x, 에스컬레이터
mow : n, 건초 더미, 건초 곳간
mow : vt, 깎다, 베다, 쓰러뜨리다
mower : n, 풀깎는 기계, 풀베는 사람
mowing machine : x, 풀베는 기계
mown : n, 나우의 과거 분사
moxa : n, 쑥
moya : n, 화산니
mozambique : n, 모잠비크, 아프리카 남동부의 공화국
mozart : n, 볼프강 아마데우스, 오스트리아의 작곡가
mr : n, 씨, 귀하, 님, 군, 남자의 성, 직명 따위의 앞에붙임
MRA : , Moral Re, Armament
MRBM : , medium range ballistic missile
MRP : n, Mouvenent Republicain Populaire 인민 공화파
mrs : n, 부인, 님, 여사
MRT : , Military Railway Transportation
MRV : n, moon roving vehicle 월면차
Ms : n, Miss와 Mrs, 를 합친 여성에의 경칭
msc : x, 유인 우주선
mt : x, 쾌속 어뢰정
much : a, 다량의, 다액의, 많은, 다량(make much of ...을 중히 여기다), 크게, 훨씬, 대략(as much as정도, as much as to say ...이라는 듯이)
muchacho : n, 소년, 젊은이, 사용인
muchness : n, 많음, 거의 같은, 대동 소이한
mucilage : n, 점액, 고무풀
mucin : n, 점액소, 점액질
muck : n, 퇴비, 오물, 불결한 상태
mucker : n, 예절 없는 사람, 쿵하고 떨어짐, 봉변, 버력을 제거하는 사람
muckrake : n, vi, 쇠스랑, 추문을 들추다
muckraker : n, 추문을 들추는 사람
muckworm : n, 구더기, 수전노
mucous : a, 점액의, 점액을 분비하는
mucous membrane : x, 점막
mucus : n, 점액, 진
mud : n, 진흙, 진창(throw mud at ...을 헐뜯다, stick in the mud 궁지에 빠지다, 보수적이다, 발전이 없다
muddle : vt, vi, n, 혼합하다, 얼근히 취하게 하다, 어리 둥절하게 하다, 갈피를 못잡다(muddle away 낭비하다, muddle on 얼렁뚱땅 해나가다), 혼잡, 혼란
muddleheaded : a, 당황한, 얼빠진, 멍청한
muddy : a, 진흙의, 진흙 투성이의, 충충한, 혼란한, 진흙 투성이로 만들다, 흐리게 하다, 흐리게 하다
mudfish : n, 미꾸라지
mud flat : x, 개펄
mudguard : n, 흙받기
mud puppy : x, 영원
mudroom : n, 흙묻은 레인 코트나 장화를 벗어 두는 곳
mudstone : n, 이암
muezzin : n, 회교 교당에서 기도 시각을 알리는 사람
muff : n, vt, 얼뜨기, 스포츠에 서툰 사람, 실수하다, 공을 놓치다
muff : n, 머프(여자용, 모피로 만든 외짝 토시)
muffin : n, 머핀(살짝 구운 빵, 버터를 발라 먹음)
muffle : vt, n, 덮어 싸다, 소리를 죽이다, 누르다(muffled curse 무언의 저주), 권투 장갑, 간접 가열실
muffler : n, 머플러, 목도리, 벙어리 장갑, 권투 장갑, 소음 장치
mufti : n, 평복, 사복, 신사복, 회교 법전 설명관(in mufti 평복으로)
mug : n, 머그(손잡이 있는 컵), 청량 음료
mug : vt, vi, n, 벼락 공부하다, 벼락 공부하는 사람
muggy : a, 무더운
mugp : vt, vi, 벼락 공부하다, 벼락 공부하는 사람
mug shot : x, 얼굴 사진
mugwump : n, 당파에 초연한 사람, 두목, 거물
mujik : n, =muzhik
mukden : n, 봉천(현명은 심양)
mulatto : n, 백인과 흑인과의 트기, 황갈색의
mulberry : n, 뽕나무, 도디, 짙은 자주색
mulch : n, vt, (이식한 식물의)뿌리 덮개
mulct : n, vt, 벌금, 빼앗다
mule : n, 노새(수나 귀나 암말과의 잡종), 얼간이, 고집쟁이, 잡종, (실내용)슬리퍼
muleteer : n, 노새 모는 사람
mulish : a, 노새 같은, 고집센
mull : n, vt, 실수, 그르침, 그르치다, 엉망진창
mull : vt, 향료, 설탕, 달걀을 넣고 데우다
mull : n, 얇고 보드라운 모슬린
mullah : n, 물라(고승, 학자에 대한 회교도의 경칭), 회교의 신학자
mullen : n, 현삼과풀의 일종
muller : n, 막자(그림 물감 약 등을 개는), 분쇄기
mullet : n, 숭어과의 물고기
mulligan : n, 스튜 요리의 일종, 스코어에 안드는 쇼트
mulligatawny : n, (동인도의)카레가 든 수프
mullion : n, 창의 세로 창살, 장살대
multi : , 많은의 결합사
multichannel : a, 다중 채널의
multicolored : a, 다색의
multifarious : a, 가지 가지의, 각양 각색의
multiform : a, 여러 모양을 한, 다양한
multigraph : n, 소형 윤전 등사기
multiheaded : a, 두부가 많은, 다탄두의
multilateral : a, 다변의, 여러 나라가 참가한(multilateral trade 다변적 무역)
multimillionaire : n, 억만장자
multinational : a, n, 다국적의, 다국적 기업
multinomial : a, n, 다항의, 다항식
multinuclear : a, 다핵의
multiple : a, 복합의, 다양한, 배수의, 배수, 배수량(least common multiple 최소 공배수)
multiple choice test : x, 선다형 테스트
multiple cropping : x, 다모작
multiple farming : x, 다각 농업
multiple shop : x, 연쇄점
multiplex : a, 다양의, 다중의
multiplex telegraphy : x, 다중 송신법
multiplicand : n, 곱셈, 증가, 배가, 중식
multiplication table : x, 구구표(12*12까지 있음)
multiplicity : n, 중복, 다양성(a multiplicity of 많은)
multiplier : n, 승수, 증폭기, 배율기
multiply : vt, vi, 늘리다, 번식시키다, 곱하다, 번식하다
multipolar : a, 다극의
multiprocessing : n, 다중처리
multiprogramming : n, 다중 프로그래밍
multipurpose : a, 다목적의, 용도가 많은
multiracial : a, 다민족의
multiracialism : n, 다민족 공존
multiscreen : n, 사면 또는 구면으로 된 분할 스크린, 다수화면
multishift : a, 여러번 교대하는
multishift working : x, 단시간 교대작업
multistage : a, 다단식의(a multistage rocket 다단식 로켓)
multitude : n, 다수, 군중(the multitude 대중, a multitude of 다수의)
multitudinous : a, 수많은
multivalent : a, 다원자가의, 삼가 이상의
multum in parvo : x, 소형이나 내용 풍부
mum : n, 엄마(mummy)
mum : int, a, 쉿!, 말 마라!, 무언극을 하다(Mun's the word! 남에게 말마라, 무언극을 하다)
mumble : vi, vt, n, 중얼 거리다, 우물 우물 먹다, 중얼거리는 말
mumbojumbo : x, 무의미한 의식, 알아 들을 수 없는 말, 우상
mummer : n, 무언극 배우, 배우
mummery : n, 무언극, 허례, 점잔빼는 동작
mummify : vt, 미라로 만들다, 바짝 말리다
mummy : n, 미라, 갈색 안료의 일종
mummy : n, 엄마
mummy wheat : x, 이집트 밀
mump : vi, 뚱해 있다, 오만상을 짓다, 구걸하다, 속이다
mumps : n, pl, 이하선염, 항아리 손님
munch : vt, vi, 우적 우적 먹다
mundane : a, 현세의, 속세의, 우주의
muniaturist : n, 축소 화가
munich : n, 뮌헨(서독의 Bavaria의 도시)
municipal : a, 지방 자치체의, 시의(municpal government 시당국 municipal law 국내법, municipal office 시청)
municipality : n, 자치체(시, 읍등), 자치체 당국
munificent : a, 아낌 없이 주는, 손이 큰
muniment : n, 권리 증서, 땅문서, 증서
munition : n, 군수품, 필수품, 자금, 군수품을 공급하다
muntz metal : x, 먼츠 메탈, 아연과 구리의 합금
mural : a, 벽의, 벽에 걸린(mural painting 벽화)
murder : n, vt, 살인, 모살, 고살(like blue murder 나쁜짓은 드러나게 마련이다, 살해다하, 곡을 서투르게 불러서(연주하여)망치다
murderer : n, 살인자
murdererous : a, 살인의, 흉악한, 살인적인, 지독한
muriatic : a, 염화 수소의
muriatic acid : x, 염산
murine : a, n, 쥐과의
murky : a, 어두운, 음울한
murmur : vi, vt, 웅성대다, 졸졸 소래내다, 투덜거리다, 중얼 거림, 불평, 시내의 졸졸거리는 소리, 파도의 출렁거리는 소리, 속삭임
murphy : n, 감자
murrain : n, 가축의 전염병
murrhine : a, 형석의, 꽃무늬 유리의
mus : , museun, music, musician
muscadine : n, 포도의 일종(미국 남부산)
muscat : n, 포도의 일종
muscat : n, 아라비아 동남단 토후국의 수도 (Muscat and Oman Oman의 구칭)
muscatel : n, 머스커텔(muscat로 만든 포도주)
muscle : n, vi, 근육, 완력, 영향력, 힘, 압력(not move a muscle 까닥도 않다), 완력을 위두르다
musclebound : a, 근육이 굳어버린
muscovite : n, a, 모스크바 사람, 러시아 사람, 백운모
muscovy : n, 러시아
muscular : a, 근육의, 근육이 늠름한
muscularity : n, 근육이 억셈, 힘셈
muse : vi, 뮤즈 의 신(시, 음악, 그밖의 학예를 주관하는 9여신 중의 하나), 시적 영감, 시심, 시인n
muse : vi, 심사 묵고하다, 명상에 잠기다, 골똘이 바라보다
museum : n, 박물관, 미술관
museum piece : x, 박물관의 진열품, 박물관 진열감, 진품
mush : n, 박쥐우산, 전세 마차집
mush : n, 옥수수 죽, 죽 모양의 것, 값싼 감상
mushroom : n, vi, 버섯, 버섯 모양의 것, 벼락 출세자, 여자의 밀짚 모자의 하나, 버섯을 따다, 탄알 끝이 납작해지다
mushroom cloud : x, 핵 폭발에 의한 버섯 구름
mushroom growth : x, 급격한 성장
mushy : a, 죽 모양의, 걸쭉한, 감상적인, 푸념 많은
music : n, 음악, 악곡, 악보, 음악적인 음향, 듣기 좋은 소리, 묘음(face the music 태연히 난국에 당하다, 당당하게 비판을 받다, fough music 야유하는 환성 set to music 시에곡을달다)
musical : a, 음악의, 음악적인, 음악을 좋아하는, 음악이 따르는, 희가극, 뮤지컬
musical box : x, 자명악(music box)
musical chaire : x다, 의자 빼앗기 놀이
musical comedy : x, 희가극, 뮤지컬
musicale : n, 사교 음악
musical instrument : x, 악기
musical saw : x, 톱을 휘어 켜거나 쳐서 하는 음악
musicaly : ad, 음악적으로
musicassette : n, 음악 카세트
music hall : x, 연예관, 음악당
musician : n, 음악가, 작곡가, 악사
musicology : n, 음악학
music paper : x, 오선지
music stand : x, 악보대
music stool : x, (높이가 조절되는)피아노용 걸상
musing : a, 생각에 잠긴
musique concrete : x, 뮈지크콩크레트(자연음 따위를 넣은 죽물적 음악)
musk : n, 사향, 사향 노루
musk cat : x, 사향 고양이
musk deer : x, 사향 노루
musket : n, 머스켓 총(구식 소총)
musketeer : n, 머스켓총을 가진 병사
musketry : n, 소총, 소총 부대, 소총 사격술
muskmelon : n, 머스크멜론(참외의 일종)
musk ox : x, (북아메리카의)사향소
muskrat : n, 사향쥐
musky : a, 사향내 나는, 사향의
muslin : n, 모슬린(부인복 커튼용 면직물의 일종)
muss : n, vt, 뒤죽박죽(으로 만들다), 혼란, 언쟁, 소동
mussel : n, 홍합, 마합
mussolini : , Benito(1883, 1945) 이탈리아의 파시스트 당수, 수상
mussorgsky : n, Modest Petrovich(1835, 81)러시아의 작곡가
mussulman : n, 회교도
must : n, 곰팡이
must : n, 과즙, 새 포도주
must : n, a, 발정한
must : aux, v, a, n, 하지 않으면 안되다, 임에 틀림없다, 그러나 지금은 ...하지 않으면 안되었다, 운나쁘게 ...했다, 절대 필요한, 필요한 일절대 필요한
mustache : n, 콧수염, (고양이 따위의)수염
mustang : n, 반야생의 말(소형, 미국 평원 지대산)
mustard : n, 겨자, 갓(grain of mustard seed 작지만 발전성이 있는 것, French mustard 초넣은 겨자)
muster : x, 소집, 점호, 검열, 소집하다, 점호하다, 분발시키다(muster in 입대 시키다)n
muster roll : x, 병원 명부
musty : a, 곰팡내 나는, 케케묵은, 무기력한
mutability : n, 변하기 쉬움, 부정, 변덕
mutable : a, 변하기 쉬운, 변덕의
mutagen : n, 돌연 변이 유도물(약물, 방사선 따위)
mutant : n, 변종, 돌연 변이체
mutation : n, 변화, 돌연 변이, 변종, 모음 변화
mutatis mutandis : x, 필요한 변경을 가하여, 준용해서
mute : a, n, vt, 벙어리의, 무언의, 폐쇄음의, 묵자의, 벌어리, 말 않는 배우, 벙어리 하인, 회장꾼, 약음기, 소리를 죽이다, 약음기를 달다
mutilate : vt, 절단하다, 병신을 만들다, (책의 일부를 삭제하여)불완전하게 하다
mutilation : n, 절단, 훼손
mutineer : n, 폭도, 반항자
mutinous : a, 폭동의, 반항적인
mutiny : n, 반란, 폭동, 반항, 반란을 일으키다, 반항하다
mutt : n, 잡종개, 똥개, 바보
mutter : vi, vt, n, 중얼거리다, 투덜거리다, 얼거림, 불평
mutton : n, 양고기(dead as mutton 아주 죽어서)
muttonchop : n, 양의 갈비 고기, 위는 조붓하고 밑으로 둥글게 퍼진 구레나룻
muttonhead : n, 멍텅구리, 바보
mutual : a, 상호의, 공통의(mutual aid 상호 부조, mutual friend 공통의 친구, mutual insurance 상호 부험)
mutualism : n, 상호 부조론, 공서
mutuality : n, 상호 관계, 상관
mutualy : ad, 서로
muzak : n, 전화, 무선으로 식당, 공장에 음악 보내주는 시스템
muzhik : n, 러시아의 농민
muzzle : n, 코, 입부분, 총구, 입마개, 부리망, 재갈, 개 따위에 부리망을 씌우다, 언론을 탄압하다, 말못하게 하다
muzzleloader : n, 구장총, 전장포
mwss jacket : x, 옆이 트인 짧은 웃옷(군대에서는 준의례적인 겨우에 입음)
Mx, : x, Middlesex(이전의 잉글랜드 남부의 주)
my : x, 나의, Ny!, or Oh, my!, or My eye!, 아이고!, 저런!
myall : n, 아카시아의 일종(오스트레일리아산)
mycelium : n, 균사
mycenae : n, 미케네(그리스 남동부의 옛 도시, 청동기 문명의 중심지)
mycologist : n, 균학자
mycology : n, 균학
mycosis : n, 사상균 병
myelitis : n, 척수염
myocardial : a, 심균의
myoglobin : n, 미오글로빈(근육 세포 속의 헤모글로빈)
myope : n, 근시안인 사람
myopement : n, 잘못 두기
myopia : n, 근시안, 근시
myopy : n, 근시안, 근시
myriad : n, a, 만, 만의
myriagram : n, 1만 그램
myrialiter : n, 1만 리터
myriapod : n, a, 다족류의(동물)
myrmidon : n, 부하, 졸개, 앞잡이, 수하
myrrh : n, 몰약(향료, 약제로 쓰이는 열대 수지)
myrtle : n, 도금양
myself : pron, 나 자신(by myself 혼자서, for myself 나 자신을 위해서, 남의 부림을 받지 않고, 자력으로 I am not myself 몸 상태가 아무래도 이상하다)
mystagog : n, 비법가
mystagogy : n, 비법, 전수
mysterious : a, 신비한, 불가사의한, 이상한
mystery : n, 신비, 불가사의, 비밀, 비결, 성체, 중세 종교극, 추리 소설(be wrapped in mystery 비밀에 싸여 있다, 전혀 모르다)
mystery play : x, =MYSTERY
MYSTERY STORY : x, MYSTERY
mystery voat : x, =Q, boat
mystic : a, 신비한, 비교의, 신비주으자(명상 , 자기 포기로 신과의 합일을 구하는 자)
mystical : a, 신비의, 비법의
mysticism : n, 비교, 신비주의
mystictically : ad, 신비적으로
mystification : n, 신비화, 당혹시킴, 속이기
mystify : vt, 신비화하다, 어리둥절하게 하다, 속이다
mystique : n, 신비, 비법
myth : n, 신화, 꾸민 이야기, 가공의 사람(물건)
mythic : a, 신화(가공)의
mythological : a, 신화의, 신화학의, 가공의
mythologist : x, 신화학자, 신화 작자
mythology : n, 신화학, 신화(집)
myxoma : n, 점액종
myxomatosis : n, (다발성)점액종중
