I : n, 알파벳 9번째의 문자, 문자 I로 나타내는 소리, 로마숫자의 1, I자형의 것, 연속된 것의 아홉째의 것 
I : pron, n, 나는, (소설등에서) I(나)라는 말, 자아, 나
I : x, 허수의 단위
i'd : x, suf, I had의단축, IDE의 변형
I'd : I had 의 단축형, 
I'll : x, I will, I shall의 단축
I'll : x, I will(shall)의 단축형
I'm : x, I am의단축
I'm : x, I am의 단축형
I've : x, i heve의 단축형
I've : x, (구)I have의 단축형
I.A.A.F : x, International Amateur Athletic Federation
I.A.D.A : x, International Atomic Development Autority
I.A.E.A : x, International Atomic Energy Agency
I.B.M : x, IntercontinentalBallistic Missile, International Business Machines(미국 컴퓨터 제작 회사명)
I.B.R.D. : x, Intercontinental Bank for Reconstruction and Development=World Bank
I.C : x, lesus chistus
I.C.A. : x, International Cooperation Administration
I.C.A. : x, International Cooperation Administration, International Communication Agency 국제협력국(지금은 AID)
I.C.B.P. : x, International Council for Bird Preservation 국제 조류보호 회의
I.C.E : x, Institution of Civil Engineers
I.C.I : x, Imperial Chemical Industries, International Commission on Illumination
I.C.S : x, Indian Civil Service
I.D : x, industrial design, Infantry Division, Intelligence Department, ness
I.D.N. : x, in dei nomine
i.e. : x, 즉 다시말하면
I.E. : x, Indian Empire
I.F.S. : x, Irish Free State
I.H.M. : x, (Servants of the)Immaculate Heart of Mary
I.I.S.S. : x, intrernational institute for Strategic Studies
I.M. : x, Isle of Man
I.N.D. : x, 하느님의 이름으로
I.N.R.I., INRI : x, Iesus Nazarenus Rex Iudaeorum
I.O.G.T., IOGT : x, International Order of Good Templars
I.O.M. : x, Isle of Man
I.O.R.M. : x, Improved Order of Red Men
I.O.W. : x, Isle of Wight
I.of M.(W.) : x, the Isle of Man(Wight)
i.q. : x, idem quod
I.R. : x, Inland Revenue, intelligence ratio, Internal Revenue
I.R.A, IRA : x, individual retirement account, Irish Republican Army
I.R.B. : Irish Republican Britherhood, 
I.S, IS : x, Intermendiate School, Irish Society
I.S.O : x, Imperial Service Order(영)문관 훈공장
I.W., IW : x, index word, inside width, Isle of Weight, isotopic weight
I.W.T.D : x, Inland Water Transport Department(영)내국 수운 관리국
I.W.W, IWW : x, Industrial Workers of the World
i/c : x, in charge, in command
I/O : x, (전산)input/output 입출력
I/O bus : x, (전산)입출력 모선
I/O controller : x, (전산)입출력 제어장치
I/O port : x, (전산)입출력포트
ia : suf, 병명에 붙임(malaria), 동식물의 이름에 붙임(Reptilia), 나라이름에 붙임(Australia)
IAC : x, International Apperentices Competition 국제 기능 올림픽
IADB : x, InterAmerican Development Bank 미주 개발 은행
IAF : x, International Astronautical Federation
Iago : n, 남자 이름, 이아고(Shakespeare 작 othello에 나오는 음험하고 간악한 인물
ial : suf, AL의 변형 celestial, colloquial
iamb : n, 
iambic : a, n, (영시의) 단장격의 (시), 약강격의 (시)
iambus : n, (영시의) 단장격, 약강격(cf.TROCHEE)
ian : n, AN의 변형
iana : suf, ANA의 변형 
iarovize : vt, VERNALIZE
IARU : x, International Amateur Radio Union
IAS : x, indicated airspeed
iasis : suf, ASIS의 변형
IATA : x, International Air Transport Association 국제 항공 수송협회
iatro : x, (연결형) 의사, 의료의 뜻
iatrogenic : a, 의사의 치료(진단)에 의해 생기는, 의사에게 원인이 있는
iatrophysics : n, pl, (단수취급) 물리요법 의학, 물리요법
IB : x, International Baccalaureate 국제공통 대학 입학 자격 제도
Ib'erian Pen'insula : n, 
iB. : x, ibidemLid
IBA : x, Independent Broadcasting Authority(영국) 독립 방송 협회
IBE : x, International Bureau of Education
Iberia : n, 이베리아(이베리아 반도의 옛 이름), 고대 코카서스 남부지방
Iberian : a, n, 이베리아 반도의, 스페인 포르투칼의, (고대) 이베리아 사람(말)의, 이베리아 (반도에 사는)사람, 옛 이베리아 사람, 옛 이베리아 말
ibex : n, 아이벡스(알프스.아펜니노.피레네 산맥 등에 사는 야생 염소
IBF : x, internatinal banking facilities, International Boxing Federation
IBI : x, International Bank for Investment
ibid : x, ibidem
ibidem : ad, 같 장소에, 같은책(페이지, 절, 장)에 보통ib(id) 꼴로 인용문 각주등에 씀
ibis : n, 
ible : suf, ABLE의 변형, impressible, reducible
ibn : pref, 아들의 뜻(ibnsuad)
Ibrahim : n, 남자 이름
Ibsen : n, 입센 Henrik (1828-1906)(노르웨이의 극작가 시인)
Ibsen'ism : n, 입센주의(문제극의 형식으로 사회의 인습적 편견을 적발함
Ibsenian : a, 입센의, 입센적인
Ibsenite : n, 입센주의자(모방자)
IC : x, integrated circuit
ic : suf, 의, 같은, 한 성질의 뜻, 명사로 전용
IC4A : x, ICAAAA, ty
ICAA, ICA4, I.C.4-A : x, Intercollegiate Association of Amateur Athletes of America 전미대학 스프츠 연맹
ICAC : x, International Cotton Advisory Committee 국제 목화자문 위원회
ical : suf, 에 관한, 의, 와 같은의 뜻
ICAO : x, International Civil Aviation Organization 국제 민간 항공 기구
Icarian : a, Icarus의 같은 , 앞뒤를 가리지 않는, 모험적인
Icarus : n, 이카로스(밀로 붙인 날개로 날았는데 너무 태양에 접근했으므로 밀이 녹아 바다에 떨어졌다는 인물
ICBM : x, intercontinental ballistic missile 대륙간 탄도탄
ICC : x, International Chamber of Commerce 국제 상공회의소, Interstate Commerce Commission
ice : n, vt, 얼음, 과즙을 섞은 빙수, (과자 등의)당의, 다이아몬드, 보석, 차가움, 쌀쌀함, 부정업자가(경찰에)바치는 뇌물, 암표 장수가 극장측에 내는 수수료, 얼리다, 얼음으로 차게하다 얼음으로 덮다
Ice. : x, Iceland, Icelandic
ice age : x, 빙하시대
Ice Age : x, 갱신세 빙하시대
iceax(e) : x, 쇄빙 도끼(등산용), 피켈
ice bag : x, 얼음 주머니(베개)
iceberg : n, 빙산, 냉담한 사람, 불감증인 여자, 빙산의 일각
iceberg lettuce : x, 양상추의 일종(잎이 양배추 모양)
iceblink : n, (빙원의 반영에 의한)빙광, 빙영, 얼음의 낭떠러지
iceblue : x, 담청색, 엷은 녹청색
iceboat : n, 빙상요트(활주선), 쇄빙선
icebound : a, 얼음에 뒤덮인, 얼음에 갇힌
icebox : n, (얼음을 사용하는)냉장고, 아이스박스, 냉동실, 몹시 추운곳
icebreaker : n, 쇄빙선, 쇄빙기, 서먹서먹함을 푸는 것, 교제에 능한 사람, 사귐성있는 사람, 택시의 기본요금
icebreaking : a, 쇄빙의 화해의 계기가 되는
ice cap : n, (고산.꼭대기.극지 등의)만년(빙)설(cf. ICE SHEET), (머리에 얹는) 얼음주머니
ice chest : x, ICEBOX
icecold : a, 얼음같이 찬, (감정.태도등이)냉담한, 냉정한
ice cream : x, 아이스크림, 결정꼴의 마약, 아편
icecream : a, (옷이)바닐라 아이스크림색의
icecream chair : x, (거리의 카페 등에서 쓰는) 팔걸이 없는 둥글고 작은 의자
icecream cone : x, 아이스크림을 담는 원뿔꼴 웨이퍼(wafer)
icecream freezer : x, 아이스 크림 제조기
icecream soda : x, 아이스 크림소다
ice crusher : x, (특히 가정용) 얼음 깨는 기구
iced : a, 얼음으로 뒤덮인, 얼음을(에)채운, 얼음으로 냉각한, 당의(설탕)을 입힌
ice dancing : x, 빙상 무용(댄스)
icefall : n, 빙하의 붕락, 얼어붙은 폭포
ice field : x, (극지 지방의 해상의) 빙원, (육상의)빙원
icefish : n, 반투명의 작은 물고기 총칭, 뱅어, 별빙어
ice floe : x, (해상의)빙원, 부빙
ice foot : x, 빙각(극지 지방의 해안선을 따라 형성된 띠나 벽 모양의 얼음지대) 빙하의 끝
ice free : a, 얼지 않는 결빙하지 않는
ice hokey : x, 아이스하키
icehouse : n, 얼음창고 빙고
icekhana : n, 빙상자동차 경기
Icel. : x, Iceland, Icelandic
Iceland : n, 아이슬란드(북대서양의 공화국, 수도, -er 아이스란드 사람
Icelandic : a, n, 아이슬란드의, 아이슬란드 사람(말)의, 아이슬란드 말
Iceland moss : x, 아이슬란드이끼(식용, 약용)
Iceland poppy : x, 시베리아 꽃 양귀비(극지산)
Iceland spar : x, 빙주석(순수무색 투명의 방해석)
iceless : a, 
ice lolly : x, ICELOLLY
icelolly : n) 막대기가 있는 아이스 캔디
ice machine : x, 제빙기
iceman : n, 얼음장수(배달인), 빙상 여행에 익숙한 사람, 스케이트장 관리인, 보석도둑, 냉정을 잃지 않는 도박사(선수, 예능인)
ice milk : x, (지방분이 적은)아이스크림
ice neele : x, 세빙(ice crystals)
IC engine : x, INTERNAL COMBUSTION ENGINE
iceout : n, 해빙(호수면 등의 얼음이 녹기
ice pack : x, 대부빙군, 얼음주머니
ice pail : x, 얼음통(포도주병 냉각, 아이스크림 제조용)
ice pick : x, 얼음깨는 송곳
ice plant : x, 제빙공장
iceplant : x, 채송화
ice point : x, 빙점
ice pudding : x, 아이스 푸딩(얼음과자)
ice rink : x, 실내 스케이트장
ice run : x, 썰매용 빙판 활주로
icescape : n, (극지의) 빙경 빙원의 경치
ice sheet : x) 빙판(남극 대륙이나 Greenland의 광범위한 내륙빙
ice shelf : x, 빙붕(ice sheet의 해상에 나온 말단
ice show : x, 아이스 쇼를 하면서 하는 흥행
ice skate : pl, 스케이트 화의 날
ice skating : x, 빙상 스케이트 경기
ice skste : vt, 스케이트를 타다
ice station : x, (남극의)극지 관측소(기지)
ice storm : x, 착빙성, 폭풍우
ice sube : x, (전기 냉장고에서 만드는)각빙, 각 얼음
ice tongs : x, 얼음집게
ice tray : x, (전기 냉장고의)제빙, 쟁반
iceup : n, (눈물의)빙결, 동결, 착빙(고체 표면에 대기중의 수분이 얼어 붙기
ice water : x, 빙수, 얼음 냉수, 얼음이 녹은 물
ICFTU : x, International Confederation of Free Trade Unions 국제자유 노동 조합연맹
Ichabod : n, intro, 남자 이름, 슬프도다(영광은 사라졌구나 하는 탄식)
I ching : n, 역경, 역점
ichneumon : n, 이집트 몽구스
ichnography : n, 평면도법, 평면도
ichnolite : n, 족적, 화석
ichnology : n, 족적, 화석학
ichnomon : x, 발자국, 자국의 뜻
ichor : n, (신들의 맥관속에 흐르는)영액, 이코르, 농장, 아이코어(화강암질의 용액)
ichorous : a, 농장의
ichthy(o) : x, 물고기의 뜻
ichthyic : a, 물고기의, 어류의, 물고기 모양의
ichthyography : n, 어류 기재학, 어류지(학), 어론
ichthyoid : a, n, 물고기 모양의, 물고기 꼴의, 어형 척추동물
Ichthyol : n, 이히티올(태고 때의 어류의 잔해로 된 역청질에서 만든약, 상표명)
ichthyolite : n, 물고기 화석
ichthyological : a, 
ichthyology : n, 어류학, 어류학자
ichthyophagist : n, 물고기 상식자
ichthyophagous : a, 물고기를 먹고 사는, 어식성의
ichthyosaur : n, 어룡
ichthyosaurus : n, 이크리오 사우루스
ician : suf) 에 능한 사람, 을 배운사람
icicily : ad, 
iciciness : n, 
icicle : n, 고드름, 냉담(냉철)한 사람, 감정의 움직임이 둔한 사람, 크리스마스트리에 매다는 은박지 등의 가느다란 장식
icicled : a, 
icily : ad, 얼음같이, 싸늘하게
iciness : n, 싸늘함, 냉담한
icing : n, (과자에) 입힌 설탕, 당의
icing sugar : x, 가루 설탕
ICJ : x, International Court of Justice
icky : a, 끈적끈적한, 싫은, 불쾌한, 역겨운, 너무 감상적인, 시대에 뒤진, 재미 없는, 세련되지 않은, 멋이없는
ickypoo : a, 
ICO : x, International Coffee Organization(유엔)커피 기구
icon : n, 초상, 성상, 화상, 아이콘, 도상, 유사기호, 아이콘(컴퓨터의 각종 기능이나 메시지를 그 뜻을 알수 있게 표시한 그림문자)
icon : x, 
icon. : x, iconographic, iconography
iconic : a, 상의, 우상의, 성상의, 전통적인 양식의, 인습적인, (아)이콘적인
iconize : vt, 우상화(시)하다
icono : a, 빠른
iconoclasm : n, 우상 파괴, 성상 파괴, 인습 타파
iconoclast : n, 우상 파괴자, 인습 타파주의자
iconoclastic : a, 우상 파괴(자)의, 인습 타파주의(자)의
iconographer : x, , 도해법 연구자
iconographic : 도해의, 도상학의
iconograpical : 도해의, 도상학의
iconography : n, 도상학, 초상연구, 
iconolatry : n, 우상숭배, -ater(우상숭배자)
iconological : a, 
iconologist : n, 
iconology : n, 도상학, 초상, 화상, 상징주의
iconometer : n, 이코노미터, 자동 조절직시 파인더
iconoscope : n, (카메라의) 송상관, (라디오의 마이크에 해당함)
icosahedron : n, 20면체
ICPO : x, International Criminal Police Organization
ICRC : x, International Committee of Red Cross 국제 적십자 위원회
ICRP : x, International Committee for Radiation Protection국제방사선 방어 위원회
ics : suf, -학, -론, -술의 뜻
ICSH : x, interstitial cell stimulating hormone 간질 세포 자극 호르몬 
ICSU : x, International Council of Scientific Unions
icteric : a, n, 황달의, 황달병에 걸린, 황달병 치료에 쓰이는, 황달병 치료약
icterus : n, 황달, 황화병
ictus : n, 강음, 발작
ICU : x, intensive care unit 집중 치료부(병동)
icy : a, 얼음의, 얼음으로 덮인, 얼음 같은, 얼음이 많은, 얼음이 찬, 쌀쌀한, 냉담한
id : n, 이드(본능적 충동의 근원), 특수 원형질, 유전기질, 
ID : x, inside diameter 내경
id : x, IDE의 변형, sstr(Isesse
id. : idem, dem, 
Id. : x, Idaho
Ida : n, 여자이름, 이다산, 소아시아의 산
IDA : International Development Association, 
Idaho : n, 미국북서부의 주
IDB : n, , illicit diamond buyer
ID card : x, 신분증명서
IDDD : x, international direct distance dialing 국제 장거리 자동 전화
idea : n, 개념, 관념, 생각, 사상, 견해, 신념, 상상, 이념, The ~ ! 이건 지독하군 
ideaed, idead : a, 생각을 가진
ideal : a, n, 이상적인, 완전한, 상상의, 관념적인, 이상, 전형
idealism : n, 이상주의, 관념론, 유심론, 관념주의
idealist : n, 이상주의자, 공상가, 관념론자, 관념주의자
idealistic : a, 이상주의의, 몽상가의, 관념론의
idealistically : ad, 
ideality : n, 관념성, 이상적임, 상상력
idealization : n, 이상화
idealize : vt, vi, 이상화하다, 이상을 그리다
idealizeer : n, 
ideal type : x, 이상형
idealy : ad, 이상적인, 완전한, 상상의, 관념적인, 이상, 전형
idea man : x) 아이디어맨(새로운 착상을 잘 하는 사람
ideamonger : n, 아이디어를 파는 사람
ideate : vt, vi, f, n, 관념화 하다, 생각하다 , 상상하다, 관념적 대상
ideation : n, 관념, 작용, 관념화
idee fixe : x, 고정관념
idem : n, a, 위와 같음(같은), 동서(의)
idem, idem quridem qurd : ad, 와 똑같이
idemportent : a, n, 입급멱등의, 멱등원
identic : a, 동문의, ~ note 동문통첩
identical : a, 동일한, 같은
identical equation : a, 항등식
identicalIly : ad, 꼭같게, 동등하게
identicalness : n, 
identical twin : x, 일란성 쌍생아
identifiable : a, 동일하다고 증명할수 있는, 신원을 확인할수 있는, 동일시 할수 있는
identification : n, 동일하다는(동일임, 동일물이라는) 증명, 신분 증명(이 되는 것)
identification disk : x, (군인의) 인식표
identification parade : x, (범인 확인을위해 줄 세우는)피의자 들의 줄
identification tag : x, (전시에 군인이 지니고 다니는 금속제)인식표
identify : vi, vt, 동일하다고(동일인, 동인물임을)인정하다, 동일시하다, ..이 무엇이라는 것을 확인하다, (에 틀림없음을)확인하다, 알다, 감정하다, 증명하다
Identikit : n, a, 몽타주식 얼굴 사진 합성 장치, 몽타주 사진, 몽타주의
identity : n, 동일함, 일치, 본질, 독자성, 주체성, 본성, 동일한 사람(것)임, 동일성, 자기 자신(그것 자체)임, 신원
identity card : x, 신분증명서
identity crisis : x, 자기 인식의 위기(사춘기 등에 자기의 실체에 의문을 가짐)
identity dic : x, IDENTIFICATION TAG
ideo : x, IDEA의 뜻
ideogram : n, 표의 문자
ideography : n, 표의 문자학, 표의 문자 상용
ideological : a, 이데올로기의, 관념 형태의, 관념학의, 공리 공론의
ideologist : n, 특정 이데올로기의 신봉자, 공론가, 공상가, 관념학파의 사람, 관념론자
ideologize : vt, 이데올로기적으로 분석하다, 특정이데올로기를 따르게 하다
ideologue : n, 공론가, 몽상가, 특정 이데올로기의 창도자
ideology : n, 이데올로기, 관념 형태, 관념학, 공리 공론
ideomotor : a, 관념운동적인, 관념운동성의
ides : n, pl, 15일(3, 5, 7, 10월의), 13일(그밖의 달의)
idest : x, q, 바꿔말하면
idio : x, 특수한, 특유의의 뜻
idiocy : n, 백치(같은)짓
idioglossia : x, 구어부전(이해 불가능한 발음을 함
idioglottic : a, 
idiographic : a, 서명의, 사인의 상표의, 개별적 구체적 사례의 개성(개별)기술적인
idiolalia : n, IDIOGLOSSIA
idiolect : n, 개인 방언(일생중 어떤 시기에 쓰는 말투)
idiom : n, 이디엄, 관용구, 숙어, (어떤 언어의 정해진)어법, (어떤 민족의)언어, 방언, (특수한)직업 용어, (화가, 음악가 등의)의 독특한 맛, 특색, 특징
idiomatic : x, 관용구적인, 관용어법적인, (어떤 언어의)특징을 나타내는
idiomatically : ad, 관용구적, 관용어 법적
Idiom Neutral : x, 이디엄 뉴트럴(1902년에 발표된 인공적 국제 보조어
idiomology : n, 관용어법 연구
idiomorphic : a, 고유의 형태를 가진, 자형의 자형적인
idiopathic : a, 특발성의, 어떤 개인에 특유한 고유의
idiopathy : n, 특발증, 특발성 질환
idiophone : n, 이디오폰(마찰, 타격등에 의한 물질 자체의 음을 이용한타악기)
idioplasm : n, 유전질, 배형질
idiosyncrasy : n, 특질, 특이성, (특이한)성벽(eccentricity), (알레르기 따위의) 특이 체질
idiosyncreatic : a, (한개인에게)특유한, 기인한 색다른
idiosyncreatically : ad, 특이체질의
idiot : n, 바보, 백치(지능 지수 0-25의 정신 박약자)
idiot's lantern : x, 텔레비젼
idiot board : x, (출연자용의)대사 지시판
idiot box : x, 텔레비전
idiot card : x, 텔레비젼 출연자용 큐카드(대사등을 쓴 대형카드)
idiot channel : x, 민간 텔레비젼 방송
idiot girl : x, IDIOT CARD를 출연자에게 보이는 담당 여직원
idiotic : a, 바보의, 백치의
idiotical : a, 바보스러운, 비상식적인
idiotically : ad, 
idiotism : n, 백치같은 행위, 백치
idiot light : x, 이상 표시등(배터리 오일 휘발유 등의 부족 이상을 자동으로 표시
idiot savant : x, 이디오 사방, 천재백치(특수한 재능을 가진 정신 박약자)
idiot sheet : x, IDIOT CAR고생들 많았오
idiot tape : x, 자동 식자용 컴퓨터 입력 테이프
idiottype : n, 유전자형
IDL : x, international date line
idle : a, vi, vt, 태만한, 일이 없는, 한가한, 활용되지 않고 있는, 무용의, 쓸모 없는, (공포, 근심 따위)까닭(근거) 없는, 놀고 보내다
idle bread : x, 놀고 먹기
idle cost : x, 유휴비, 무효 원가(시설, 노동력을 충분히 활용 못한 데서 오는 손실)
idle facilities : x, 유효시설
idle money : x, 놀고 있는 돈
idleness : n, 게으름 , 무위, 놀고지냄
idle pulley : x, 아이들 풀리, 유동도르래
idler : n, 게으름뱅이, 쓸모없는 인간, 당직 아닌 선원, 유동바퀴, 빈차
idler gear : x, 아이들 기어, 유동 톱니바퀴
idlesse : n, 안일, 나태
idle wheel : x, 유동바퀴(2개의 톱니바퀴 사이에 쓰는 톱니바퀴
IDLS : x, International Digital Leased Line Service 국제 디지털 전용회선
idly : ad, 하는일 없이, 빈둥거려, 게으르게, 멍하니, 무익하게
IDO : x, International Disarmament Organization
Ido : n, 이도어(Esperanto를 기초로 한 국제 보조 언어)
idol : n, 우상, 사신, 숭배 받는 것(사람)
idolater : n, 우상 숭배자, 우상교도, 이교도, 숭배자, 심취자
idolatress : n, IDOLATER의 여성형
idolatrize : vt, vi, 숭배하다, 에 심취하다, 우상을 숭배하다, 우상 숭배적으로 심취하다
idolatrous : a, 우상 숭배의, 우상 숭배적인
idolatrously : ad, 
idolatry : n, 우상 숭배
idolization : n, 우상화, 맹목적 숭배, 심취
idolize : vt, vi, 우상화(숭배)하다, 맹목적으로 사랑하다, 심취하다, 우상을 숭배하다
idolum : n, (Francis Bacon)선입적 오견, 관념, 심상, 환영, 우상
IDP : x, inosine diphosphate 2인산 이노신, integrated data processing(집중 데이타 처리, international driving permit(국제 운전면허)
IDR : x, International Depository Receipt(국제 예탁 증권)
Idun : n, 이둔, 봄의 여신
idyll : n, 전원시, 목가, (한가한)전원 풍경, 전원시곡, 낭만적인 이야기
idyllic : a, 전원시풍의, 목가적인, 아주 좋은, 아름다운, 소박한
idyllically : ad, 전원시적으로
idyllist : n, 전원, 시인
ie : suf, 
IE : x, Indo-European, Industrial Engineer
IEC : x, International Electrotechnical Commission국제 전기 표준회의
ier : suf, 직업의 사람의 뜻
if : x, 
IF : x, intermediate frequency
IFAD : x, International Fund for Agricultural Development(유엔)국제 농업 개발 기금
IFC : x, International Finance Corporation
ifclause : n, 조건절
IFCTU : x, International Federation of Christian Trade Unions
IFF : x, identification friend or foe (비행기, 군함등의)피아식별장치
iffy : a, n, 불확실한, 의심스러운, 조건부의, 다국적 국제 금융기관
IFO : x, identified flying object확인 비행물체
I formation : x, 두세명의 back이 quarterback 바로 뒤에 I자 꼴로 서는 공격대형
IFR : x, instrument flight rules 계기 비행 방식
IFRB : x, International Frequency Registration Board 국제 주파수 등록 위원회
IFTA : x, International Federation of Travel Agencies
IFTU : x, International Federation of Trade Unions국제 노동 조합연합회
Ig : x, immunoglobulin
IG : x, Indo Germanic, Inspector General
IgD : x, immunoglobulin D
IgE : x, immunoglobulin E
igloo, iglu : n, (애스키모 사람의) 눈으로 만든 작은 집, 이글루 모양의 건조(구조물)
ign. : x, ignition
Ignatius : n, 남자의 이름
igneous : a, 불의, 불로인하여 생긴 화성
igneous rock : x, 화성암
ignescent : a, n, 확타오르는, 불꽃을 일으키는, 불꽃을 일으키는 물질
ignis fatuus : n, 도깨비불, 인화, 사람을 현혹시키는 것, 헛된소망
ignitability : n, 가연성의
ignitable : a, 발화
ignite : vt, vi, 점화하다, 고도로 가열하다, 연소시키다, 감정을 타오르게 하다, 발화하다
igniter : n, 점화자, 점화기(장치)
ignition : n, 점화, 발화, 점화 장치, 아크점화
ignition key : x, (자동차 등의)이그니션
ignitron : n, 아크점화 장치용 수은 방정관
ignobility : n, 
ignoble : a, 저열한, 야비한, 멸시할 만한, 불명예스러운, 신분이 천한
ignominious : a, 수치(불명예)스런, 면목없는
ignominy : n, 치욕, 불명예, 수치스러운 행위, 추행, 면목없음
ignoramus : n, 무식한 사람, 아는 체 하는 바보
ignorance : n, 무지, 무식, 모르고 있음
ignorant : a, 무지한, 무식한, ...을 모르는, 무지에서 비롯되는
ignorationelenchi : n, 논점 상위의 허위
ignore : vt, 무시하다, 모르는체하다, 
ignotum per ignotius : n, 모르는 내용을 더욱 모르는 말로 설명하기
Igorot : n, 이고로트 사람 (필리핀 군도의 Luzon섬 북부에 사는)
iguana : n, 이구아나, 열대 아메리카의 큰 도마뱀
iguanodon : n, 이구아노돈, 금룡(백악기 공룡의 일종)
IGY : x, International Geophysical Year
IHP : x, indeicated horsepower 실마력
IHS : x, 그리스어(=Jesus)의 생략형
IIC : x, International Institute of Communication
iiddem : pron, a, 같은저자, 같은말, 같은책
IIL : x, integrated injection logic
iintrodentification card : x, 신분 증명서
IISI : x, International Iron and Steel Institute
ike : n, =ICONOSCOPE
IKE : x, 아이크(Dwight D. Eisenhower의 애칭
IKey : n, 남자의 이름, 유대사람
ikon : n, =ICON
Il : x, illinium
IL : x, Illinois
il : pref, (l 앞에 올때의 변형)
ILA : x, International Law Association, International Longshoremen's Association
Il Duce : x, 일 두체(파시스트 당수mussolini의 칭호
ile : x, 에 관한, 할수 있는, 에 적합한의 뜻의 형용사 어미, 와 관계있는 것의 뜻의 명사어미
ile, ileo : x, 회장의 뜻
ilea : n, ILEUM의 복수
ileac : a, 회장의
ileitis : n, 회장염
ileum : n, 회장
ileus : n, 장폐색증
ilex : n, 털가시나무, 감탕나무속의 나무
ILGWU : x, International Ladies' Garment Workers' Union
ILI : x, index of linguistic insecurity
iliac : a, 장골의
Iliad : n, Homer작으로 전하여지는 Ilium(=Troy)전쟁의 서사시, 일리아드풍의 서사시, 장편소설, 거듭되는 불행, 길게 계속되는것
ilium : n, 장골
ilk : a, n, 동일한, 각각의, 각자의, 같은, 가족, 동류, 
ill : a, , 병든, 앓는, 편찮은, 나쁜, 부덕한, 사악한, 심술궂은, 악의있는, 불친절한, 상서롭지 못한, 불길한, 성급한, 꾀까다로운, 기분이 상한, 서투른, 졸렬한, 부적절한, 결점이 있는
ill : n, 악, 사악, 죄악, 불행, 재난, 고난, 병고
ill : ad, 나쁘게, 사악하게, 부정하게, 형편에 맞지 않게, 운 나쁘게, 불친절하게, 심술궂게, 가혹하게, 불완전하게, 불충분하게, 부적당하게, 거의..않다
Ill : x, Illinois
ill., illus(t). : x, illustrated, illustration, illustrator
illadvised : a, 무분별한, 지각없는
illadvisedly : ad, 무분별하게도
illaffect : vt, 나쁜 영향을 미치다
illaffected : a, 호감이 없는, 불평을 품고 있는, 못마땅해 하는
illassorted : a, ILLMATCHED
illation : n, 추리, 추론, 추정, 결론
illative : a, n, 추정적인, 추론의, 추론을 유도하는, 추론, 추론을 유도하는어구
illative conjunction : x, 추론접속사(therefore, then, so등)
illatively : ad, 추론에 의하여
illaudable : a, 칭찬할 가치가 없는
illbehaved : a, 버릇없는(illmannered)(opp. well behaved)
illbeing : n, 나쁜상태, 불행(opp.well being)(몸의)불편함
ill blood : x, 악의, 앙심, 적대심, 원한
illboding : a, 상서롭지 못한, 불길한
illbred : a, 본데없이 자란, 버릇없는(rude)
ill breeding : x, 본데없음, 버릇없음
illconditioned : a, 질이 나쁜, 심술궂은, 몸이 편찮은, (병이)악성인
illconditioness : n, 
illconsideread : a, 분별없는, 부적당한
illdefined : a, 정의가 신통치 않은, (윤곽이) 불명확한
illdisposed : a, 질이 나쁜, 심술궂은, 호감을 갖지 않고, 악의를 품은(toward(s))
illegal : a, n, 불법(위법)의(unlawful)비합법적인, 불법입국자
illegal abortion : x, 낙태(죄)
illegal alien : x, 불법입국자
illegal detention : x, 불법감금
illegality : n, 위법, 불법, 불법행의
illegalize : vt, 불법화(위법화)하다, 금하다
illegally : ad, 
illegibility : n, 판독하기 어려움
illegible : a, 읽기 어려운, 판독하기 어려운
illegibly : ad, 
illegitimacy : n, 위법, 비합법, 사생, 서출, 비적출, 부조리, 불합리
illegitimate : a, n, vt, 위법의, 서출의, 사생의, 비논리적인, 부조리한, 서자, 사생아, 위법으로 인정하다, 사생아로 인정하다
illegitimation : 위법으로 인정함, 사생아라는 인정(선고)
illegitimatize : vt, ILLEGITIMATE
illegitimatly : ad, 위법으로, 불합리하게
ill fame : x, 악평, 악명, 오명
ill famed : a, 악평의, 악명높은
illfated : a, 불운한, 불행한, 불운(불행)을 가져오는, 불길한
illfavored : a, (사람, 얼굴등이)못생긴, 못난(ugly), 불쾌한, 꺼림칙한, 싫은(unpleasant)
illfounded : a, 근거가 박약한, 정당한 이유가 없는
illgotten : a, 부정, 수단으로 얻은, 부정한
illgrounded : a, ILLFOUNDED
ill humor : x, 기분이 언짢음, 심기가 나쁨
ill humored : a, 기분이 좋지 않은, 심기가 나쁜
ill humorly : ad, 
illiberal : a, 인색한, 도량이 좁은, 편협한, 옹졸한, 교양 없는, 저속한
illiberalil : ad, 
illiberalism : n, 반자유주의
illiberality : n, 인색, 옹졸, 저질, 저속
illiberalness : n, 
illicit : a, 불법의(illegal), 금제의, 무허가의
illicitly : ad, 
illicitness : n, 
illimitability : n, 한없음, 광대, 무변
illimitable : a, 무한의, 광대한, 끝없는
illimitablly : ad, 
illinformed : a, 지식이 불충분한, 잘 모르는, 소식(정보)에 어두운, 인식부족의(opp.well informed)
illinium : a, 일리늄(promethium의 전 이름)
Illinois : n, 미국 중부의 주
Illinoisan : a, n, Illinois주의(사람)
illiquid : a, 현금으로 바꾸기 어려운, 비유동적인, 현금부족의
illit. : x, illiterate
illiteracy : n, 문맹, 무식, 글자를 읽고 쓸줄 모름, 잘못말하기
illiterate : a, n, 글자를 모르는, 읽기 쓰기를 못하는, 무식한, 문맹인(사람), 무교육자, 무식자
illjudged : a, 무분별한, 생각이 깊지 않은
illlooking : a, (얼굴이)보기 흉한, 인상이 험한
illmannered : a, 버릇 없는, 예의 없는, 거친, 무례한
illmatched, illmated : a, 어울리지 않는
ill nature : x, 심술궂은(비뚤어진, 야비한)성격, 심술궂음, 심통사나움
ill natured : a, 심술궂은, 마음보가 비뚤어진, 불쾌한
ill naturely : ad, 
ill natureness : n, 
illness : n, 병
illogic : n, 무논리, 비논리성, 불합리(성), 모순, 불합리한 사항
illogical : a, 비논리적인, 불합리한, 조리에 맞지 않는
illogicality : n, 불합리, 불합리한 일, 부조리
illogically : ad, 비논리적으로, 불합리하게
illomened : a, 불길한, 흉조의, 불운한
illsorted : a, ILL MATCHED
illspent : a, 낭비된
illstarred : a, 불운한, 필자가 사나운
illsuited : a, 부적당한, 어울리지 않는
ill temper : x, 성급함, 심술
illtempered : a, 성마른, 성미 까다로운
illtemperediy : ad, 
illtimed : a, 때가 좋지(알맞지)않은, 계제(시기)가 나쁜
illtreat : vt, 학대하다, 냉대하다
illtreatment : n, 혹사, 냉대, 학대
illume : vt, ILLUMINE
illuminable : a, 비출수 있는, 계발할수 있는
illuminance : n, 조도
illuminant : a, n, 발광성의, 비추는, 광원, 발광체(물)
illuminate : vt, vi, 조명하다, 등불을켜다, 비추다, 장식하다, 일루미네이션(조명장식)을달다, 계몽하다, 광명을 던지다, ..을 명백히 하다, 해명하다, ..광채를 더하다, 유명하게하다, 밝아지다
illuminated : a, 을한, 채식된, 술취한
illuminati : n, 터득한 예지를 자랑하는 사람들, 철인들, 계몽주의자, 광명파, 비밀결사
illuminating : a, 비추는, 조명하는, 밝히는, 계몽적인
illuminating projectil : x, 조명탄
illumination : n, 조명, 조도, 일루미네이션, 전광 장식, 해명, 계몽, (사본의)채색
illuminative : a, 밝게하는, 계몽적인
illuminatly : ad, 
illuminator : n, 빛을주는 사람(물건), 조명계(원), 조명기, 반사경, 발광체, 계몽자, 사본 채식사
illumine : vt, vi, 비추다, 밝게 하다(되다), 계몽(계발)하다, (마음등을)밝게하다, 맑게하다, 밝아지다
illuminometer : n, 조도계
illusage : n, 학대, 혹사
illuse : vt, n, 학대(혹사)하다, 악용(남용)하다, 학대, 혹사
illusion : n, 환영, 환상, 착각, 오해, 미망, 투명한 명주망사(여성용 베일등에 쓰이는
illusional : a, 환영의, 환상의, 착각의
illusionsm : n, 환상설, 미망설(실재 세계는 하나의 환영이라고 하는), 환각법
illusionst : n, 미망론자, 환상가, 착각에 빠진 사람, 환각법을 쓰는 화가(예술가), 요술사
illusive : a, 착각을 일으키는, 눈을 속이는, 현혹시키는, 가공의 실체가 없는
illusiveness : n, 
illusivly : ad, 
illusorily : ad, 
illusoriness : n, 
illusory : a, 사람을 미혹하는, 착각의 , 현혹시키는, 가공의, 실체가 없는 
illust : x, illustrated, illustration
illustrate : vt, vi, (실례 따위로) 설명하다, 예증하다, 삽화(도판)을 넣다, 도해하다, 예(보기)를 들어 설명하다, 예증(예시)하다
illustrated : a, 삽화(사진, 도해)를 넣은, 삽화(사진)가 많은신문(잡지)
illustration : n, 실례, 보기, 예증, 삽화, 도판, 예해, 도해
illustrative : a, 실례가 되는, 예증이 되는
illustratively : ad, 
illustrator : n, 삽화가, 도해(설명)자
illustrious : a, 저명한, 유명한, (행위등이)혁혁한, 빛나는
illuvial : a, 집적(물)의, 집적지의
illuviate : vi, 집적하다
illuviation : x, 집적(작용)
ill will : x, 악의, 앙심, 악감정, 반감, 증오, 원한
illwisher : n, 남이 못되기를 비는 사람
illy : ad, ILL BADLY
ILO : x, International Labor Organization (Office)국제 노동기구
ILP, I.P.L : x, (영)Independent Labour Party
ILS : x, instrument landing system(공)계기 착륙 장치(방식)
ILTF : x, International Lawn Tennis Federation 국제 정구 연맹
ILZSG : x, International Lead and Zinc Study Group국제 남아연연구회
im : pref, (b, m, p 앞에 올때의 변형)
im : pref, (b, m, p앞에 올때의 변형
image : 초상, 상, 화상, 조상, 성상, 우상, 형태, 모습, 닮은 사람(것), (거울또는 망막상의)상, 영상, 상징, 화신, 전형(type), (개인이 가지는)이미지, 인상, (대중이 가지는) 이미지, 관념, (사실적인)묘사, 표현, (심)심상, 표상, 개념(idea)(수) 형상, 이미지, ..의 상을 만들다(그리다)
image advertising : x, 이미지 광고(상품의 특성을 강조하기 보다 성적 매력, 성공감 등 긍정적 이미지를 상품에 결부시키는 광고)
image builder : n, 이미지를 형성하는 사람(것)
image building : n, (광고등에 의한)이미지 형성
image converter : x, (전자)영상변환관
image dissector : x, (라디오, TV)해상관
image intensifier : x, (전자)영상중배관
image marker : 이미지를 만드는 사람, 광고인
image marking : n, a, 이미지 만들기, 이미지를 만드는
image orthicon : x, (TV)이미지 오시콘(고감도 찰영관)
image processing : x, (전산)화상정보처리
imagery : n, (집합적)상, 조상, 심상, (문예)(비유적 표현에 사용하는)형상, 사상, 이미지
image tube : x, (전자)이미지관(image converter)
imaginable : a, 상상할 수 있는(한의), 강조하기 위해 최상급 형용사 또는 all, every, no등에 덧붙여씀
imaginableness : n, 
imaginably : ad, 상상할수 있게 당연히
imaginal : a, 상상(력)의, 영상의, 심상의
imaginal : a, (비)성충(imago)의, 성충모양의
imaginary : a, n, 상상의, 가공의(유의어)어떤 사물이 상상으로서만 존재하는, 비현실적이어서 신용할수 없는, (수)허수
imaginary part : x, (수)허수 부분
imaginary unit : x, (수)허수 단위(기호i)
imagination : n, 상상, 상상력, (작가등의)창작력, 창조력, 구상력, 상상(의 소산), 심상, 공상, 망상(예술품의)이해력
imaginative : a, 상상(으로서)의, 상상에 관한, 상상적인, 상상력(창작력, 구상력)이 풍부한, 상상하기 좋아하는
imaginatively : ad, 
imaginativeness : n, 
imagine : vt, v, (마음에 그리다)의 뜻에서, (유의어)imagine어떤 상황이나 생각 등을 마음에 떠올리다, suppose 생각하다, 추상하다, guess suppose와 대체로 같은 뜻이지만 보다 구어적인 말이다, 생각하다, 미루어 생각하다, 추측하다(guess)(고)꾀하다, 상상하다, 추측하다
imagineering : n, 이미지니어링(새로운 경영 관리 기술, 기술자의 창조력을 높이는 기술 또는 공학
imaging radar : x, (군)영상, 화상레이더
imagism : n, 사상주의, 이미지즘(낭만파에 대항하여 1912년 경에 일어난 시인 일파의 주장)
imagist : n, a, 사상주의자(의)
imago : n, (나비, 나방등의 )성충, (정신분석)(양친등의)면모, 영상(어렸을때의 사랑의 대상이 이상화된 것
imam, imaum : n, 회교국의 종교적원수의 칭호, (회교사원의)사식승, 도사
imbalance : n, 불균형, 불안정, 언밸런스(between)(불안정)의 뜻으로 일반적으로 사용하는 말이다, unbalance 주로 정신적인 불안정의 뜻으로 사용한다
imbalanced : a, 불균형의 (특히 종교적, 인종적으로) 인구 비율의 불균형이 심한
imbalm : vt, (고)EMBALM
imbecile : n, a, 저능(한), 우둔(한), 매우 어리석은(stupid), 허약한(feeble), 저능한 사람 바보(심)치우(지능도가 IDIOT 보다 높고 MORON 보다 낮아 3-7세 정도인 저능자
imbecilic : x, 치우의, 정신박약자 특유의, 어리석은
imbecility : n, 저능, 우둔함, 바보짓, 어리석은말
imbecilly : ad, 
imbed : vt, =EMBED
imbibe : vt, (양분, 수분등을)흡수하다, 섭취하다, (술등을)마시다, (사상등을)흡수하다, 동화하다
imbibition : n, 빨아들임, 흡수, 동화
imbitter : vt, EMBITTER
imbody : vt, EMBODY
imbosom : vt, EMBOSOM
imbricate : vt, vi, a, (잎, 비늘등 겹쳐진, 미늘을 단(over), 비늘 모양으로 겹쳐진, 비늘모양으로 겹쳐진, 비늘, 모양으로 겹치다, 미늘을 달다
imbrication : n, 기왓장 처럼 겹친 모양(의 구조), 미늘달기
imbroglio : n, ((연극의)복잡한 줄거리, (사물)의 뒤얽힘, 분규, 혼란
imbrue, em- : vt, (피로) (손칼을)(피로)더럽히다, 물들이다
imbrute, em- : vt, vi, n, 짐승같이되(게 하)다, -ment
imbue : vt, (수분등을)듬뿍스며 들게 하다, (빛깔로)물들이다, IMBRUE, (감정, 사상, 의견등을)불어넣다
IMCO : x, Inter Governmental Maritime Consultative Organization(유엔)정부간 해사 협의 기구
IMF, I.M.F : x, International Monetary Fund국제 통화 기금
imide : n, (화)이미드
imine : n, (화)이민
imipramine : n, (약)이미프라민, (항울제)
imit. : x, imitation, imitative
imitability : n, 모방할수 있음
imitable : a, 모방할 수 있는
imitate : 모방하다, 흉내내다(mimic), 본받다, (유의어)imitate(흉내내다)의 일반적인 말로서 놀리거나 업신여기는 뜻을 담고 있지않다, mimic남의 말이나 몸짓을 놀리거나 업신여겨 흉내내다, copy원래의 것과 아주 같은 것을 만들려고 하다, 모사(모조)하다, ..와 비슷하다, 하게 하다, ..을 닮다(생)..을 흉내내다
imitated : a, 본뜬, 모조의 가짜의
imitation : n, a, 모방, 흉내, 모조, 모사, 모조품, 비슷하게 만든 것, 위조품, 가짜, (약)모방(작법)(악구.주제를 뒷부분에서 수식 또는 그대로 되풀이함)모조, 인조
imitation cheese : x, 모조(대용)치즈(식물유로 만든것)
imitation milk : x, 대용 우유(식물유 등으로 만든 식이 요법용)
imitative : a, ad, n, 흉내내기 좋아하는, 모방의, 모방적인, 모조의, 모사의, 의음적인, 의성적인, -ly, -ness
imitative arts : x, 모방예술(회화, 조각등)
imitative music : x, 의성음악
imitative words : x, 의음어, 의성어
imitator : n, 모방(모조, 위조)하는 사람
IMM : x, International Monetary Market
immaculacy : n, 오점(흠집, 결점, 과실)이 없음, 티없음, 무구, 결백
immaculate : a, ad, 오점없는, 흠없는, 결점없는, 완전한, (동)반점없는 , 깨끗한 순결한, 티없는, -ly
Immaculate Conception : x, (천주교)(성모 마리아의)원죄없는 잉태(설), 무염시태
immanence, nency : n, 내재(성), (신학)신의 우주에 있어서의, 내재(편재)(성)(opp.transcendence), 내재론
immanent : a, (성질이)내재하는, 내재적인(inherent), (철)마음속에서만 일어나는, 주관적인, (신학)(우주)내재의, 내재적인, 
immanuel : n, 남자이름, 구세주, 그리스도
immaterial : a, n, , 실체없는, 무형의, 비물질적인, 정신상의, 영적인(spiritual)중요치 않은, 하찮은, 보잘것없는, -ism
immateriality : n, 비물질성, 비실체성, 비물질적인것, 실체없는, 비중요성, 중요하지 않음
immaterialize : vt, ..의 형제를 없애다, 비물질적으로 하다, 실체가 없게하다
immature : a, ad, n, 미숙한, 생경한(crude), 미완성의(opp. ripe), (지질)(지형이)유년기의, -ly, -ness
immaturity : n, 미숙, 미완성, 생경함
immeasurability : n, 헤아릴수 없음, 광대무변
immeasurable : a, ad, 헤아릴수 없는, , 끝없는, 광대한(vast), -bly(헤아릴수 없을 정도로)
immediacy : n, 직접, 즉시(성), 긴급하게 필요한것
immediate : a, n, 즉각의, 당장의, 즉시의, 직접의(direct), 바로앞(이웃)의 인접한, 당면한, 목하의, (장래, 관계등이)아주 가까운, -ness
immediate constituent : x, (문법)직접 구성요소(문장을 차례로 2개의 하위 구분으로 나누어 갈때의 그 한쪽 보기
immediate inference : x, (논)직접(적) 추리, 추론
immediately : ad, conj, 곧, 즉각, 즉시로(at once), 직접(으로), 바로 가까이에, 인접하여, 하자마자(as soon as)
immedicable : a, 불치의, 고칠수 없는, 돌이킬수 없는
immemorial : 사람의 기억(기록)에 없는, 먼 옛날의, 태고(로부터)의
immense : a, ad, n, 거대한, 막대한, 광대한(huge), 이루 헤아릴수 없는, 한없는, 멋진, 굉장한, -ly막대(광대)하게, (속)아주, 굉장히, -ness
immensity : n, pl, 광대, 막대, 무수, 무한한 공간, 막대한것(수량)
immensurable : a, IMMEASURABLE
immerge : vt, vi, IMMERSE, (문어)(물속등에) 뛰어들다, (천체 등이)사라지다
immerse : vt, 담그다, 가라앉히다, 적시다, 침례를 베풀다, 열중(몰두)시키다, ..에 휩쓸어 넣다, 에 빠뜨리다, 
immersible : a, (미)(전기 기구등)내수성의
immersion : n, 액체속에 담금, (기독교)침례, 열중, 골몰, 몰두, (형용사적)(외국어의)집중 훈련의, (천)잠입, (한천체가 다른 천체의 뒤 또는 그늘에 숨는일
immersion heater : x, 침수(투입)전열기(직접 물속에 넣어 물을 끓이는)
immesh : vt, ENMESH
immethodical : a, 불규칙한, 질서없는, 난잡한
immie : n, (미)색구슬
immigrant : n, a, (외국으로부터의)이민, (입국)이주자(cf. EMIGRANT), 귀화식물, 외래동물, 이주해 오는, 이주자의(마을)
immigrate : vi, vt, (외국에서부터..으로)이주하다(시키다)
immigration : n, (입국)이주, 입국, 입국관리(심사), (일정기간내의), 이민(수)
immigration office : x, 출입국 관리 사무소
imminence : n, 절박, 촉박, 급박, 절박한 위험(사정)
imminency : n, IMMINENCE
imminent : 절박한, 촉박한(impending), 박두한, 곧 닥쳐올 것 같은, (유의어)imminent 위험등이 금방이라도 닥쳐올 것 같은 절박한 느낌을 나타낸다, impending나쁜 일이나 꺼리는 일이 금박이라도 일어날 듯한의 뜻으로서 불안한 느낌을 나타낸다
imminently : ad, 
imminentness : n, 
immingle : vt, vi, 혼합(융합)하다, 시키다
immiscible : a, ad, 혼합할 수 없는, bly
immitigable : a, 완화하기(달래기), 힘드는
immitigablly : ad, 
immittance : n, (전)이미턴스(admittance와 impedance의 총칭)
immix : vt, 섞다, 휩쓸어 넣다
immixture : n, 혼합(상태), 휩쓸려들기, 연루
immobile : a, 움직일 수 없는, 고정된, 부동의, 정지의
immobilism : n, (양보, 타협에 의한)현상유지 정책, 극단적 보수주의
immobility : n, 부동(성), 고정, 정지
immobilization : n, 고정화
immobilize : vt, 움직이지 않게(못하게)하다, 고정시키다, (깁스 등으로 관절, 환부등을)고정시키다, (군대, 함대를)이동할수 없게 하다, (정화의)유통을 정지시키다, (유동 자본을)고정 자본화하다
immoderate : a, 무절제한, 중용을 결한, 지나친, 엄청난(extreme)
immoderately : ad, 
immoderateness : n, 
immoderation : n, 무절제, 행실이 좋지 못함, 과도, 극단
immodest : a, (특히 여성의 행위, 복장등이)조심성 없는, 천박한, 음란한, 무례한, 버릇없는 건방진, 뻔뻔스러운, 안하 무인격의
immodestly : ad, 
immodesty : n, 조심성 없음, 천박함, 무례, 염치없음, 뻔뻔스러움, 버릇(조심성)없는짓(말)
immolate : vt, 희생(제물)으로 바치다(죽이다), 희생하다(sacrifice)
immolation : n, 제물로 바침, 제물이 됨, 제물, 희생
immolator : n, 희생(제물)을 바치는 사람
immoral : a, 도덕에 어긋나는, 부도덕한, 품행이 나쁜, 음란한, (책, 그림, 영화등이)음란한, 외설한
immoralist : n, 부도덕을 부르짖는(행하는)사람, 부도덕가(주의자)
immorality : n, 부도덕, 품행이 나쁨, 난잡함, 음란, 외설, 부도덕(패륜)행위, 추행, 난행, 풍속, 문란
Immorality Act : x, 부도덕법, (백인과 흑인의 결혼, 성행위를 금하는 법령)
immorally : ad, 
immoraly : ad, 부도덕한, 품행이 나쁜
immortal : a, n, pl, 불사의(undying), 불멸의, 불후의, 영구한, 영속하는, 불후의 명성을 가진, 신의, 불사의 사람, 명성 불멸의 사람(특히 작가, 시인)(고대 그리스, 로마의)여러신
immortality : n, 불사, 불멸, 불후의 명성, 영속성, 영원한 생명
immortalization : n, 불멸화, 불후화
immortalize : vt, 불멸(불후)화 하다, (..에게)영원성을 부여하다, (..에게)불후의 명성을 주다
immortally : ad, 영원히, 무한히, 매우(very)
immortelle : n, 부조화
immotile : a, 움직일수 없는, 자동력이 없는
immovability : n, 부동(성, 
immovable : a, 움직일 수 없는, 움직이지 않는, 고정된, 정지한, 부동의, 확고한, 태연, 자약한, 감정에 좌우되지 않는 무감동의 냉정한, (축제일, 기념일등이)해마다 같은 날짜의 고정된, (법)(재산이)부동의, (법)부동산
immovablly : ad, 
immovablness : n, 
immune : a, n, 면역의, (전염병, 병독등을)면한, 면역성의(to, from), (과세, 공격 등에서), 면제된(exempt), (..을) 당할 염려가 없는(from, against), (에)동하지 않는, 영향을 받지 않는(to), 면역(면제)자
immune body : x, 면역체, 항체(antibody)
immune complex : x, 면역 복합체
immune response : x, 면역 응답, 면역 반응
immune serum : x, 면역 혈청
immune surveillance : x, IMMUNOLOGICAL SURVEILLANCE
immunity : n, (책임, 의무등의)면제, 특전, (전염병 등에 대한)면역성, 면역질, (교회의 세속적 의무의)면제
immunity bath : x, 면책, 특권, 기소(소추)면제, (증언을 얻기 위해 증인에 대한 기소를 면제함
immunization : n, 면역(법), 면역조치, 면제, (면역)예방주사
immunize : vt, 면역(면제)시키다(against, from)
immuno- : x, (연결형)(면역)의 뜻
immunoadsorbent : n, (생화)면역, 흡착제
immunobiology : n, 면역 생물학
immunochemist : x, 면역화학자
immunochemistry : n, 면역화학
immunocompetence : n, 면역능력
immunocyte : n, ( 역)면역세포
immunocytochemistry : n, 면역세포화학
immunodeficiency : n, 면역결여(부전)
immunodeficient : a, 
immunoelectrophoresis : n, 면역전기 영동(법)
immunofluorescence : n, 면역 형광검사(법), 면역 형광법
immunogen : n, (의)면역원
immunogentics : n, (단수 취급)면역 유전학
immunoglobulin : n, 면역 글로불린
immunohematology : n, 면역 혈액학
immunologicalm surveillancd : x, (인체조직의)면역 감시(기구)
immunology : n, 면역학, -gist
immunoprotein : n, (생화)면역단백질(면역 글로블린, 인터페론등)
immunoreactive : a, 면역반응성의
immunoregulation : n, (의)면역 조정
immunosuppressant : a, n, IMMUNOSUPPRESSIVE
immunosuppression : n, (의)면역억제
immunosuppressive : n, a, (의)면역(반응)억제약(물질), 면역(반응), 억제(성)의
immunosurveillance : n, IMMUNOLOGICAL SURVEILLANCE
immunotherapy : n, (의)면역요법, 면역제 치료법
immure : vt, 감금하다, 가두다, -ment(감금, 칩거)
immurement : n, 감금, 칩거
immusical : a, (희)비음악적인(unmusical)
immutability : n, 불변(성), 불역성(unchangeableness)
immutable : a, 불변의, 변경되지 않는
immutableness : n, 
immutablly : ad, 
IMP : x, International Maritime Organization
imp : n, vt, 마귀 새끼, 꼬마도깨비(익살)장난꾸러기, 왈패(고)아이, 보강(보수)하다(mend), (매사냥)(매의 날개에)깃을 덧붙여주다, 
IMP : x, interplanetary monitoring platform 행성간 조사위성
Imp, imp : x, indeterminate mass particle(물)불확정 질량입자
IMP, imp : x, (카드)International Match Point
imp. : x, impersonal, imperative, imperfect, imperial, implement, import(ed), importer, impression, imprimatur, imprint
imp. gal. : x, imperial gallon
impact : n, vt, vi, 충돌(collision), 격돌(against), 충격, 충격력(강한)영향(력)(influence), 감화, 효과(effect), 꽉 눌러대기(끼우기), 꽉 밀어넣다, 채워 넣다, 밀착시키다, 충돌시키다, 강한 충격을 주다, 격돌하다, 부딪치다, 강한 영향을주다
impact aid : x, (미)(국가 공무원의 자제가 다니는 학구에 대한 )연방 정부의 재정원조
impact area : x, (폭탄, 미사일의)작력지역, 착탄지역
impact crater : x, 충돌 화구(운석이나 화산 분출물의 낙하로 생긴 크레이터
impacted : a, 꽉 채워진, 들어찬, (치과)(이가)매복해 있는, 인구가 조밀(과밀)한, (지역이 인구 증가에 따라 공공 시설의 증설이 부득이 하여)재정적으로 애먹고 있는
impacted area : x, 인구 급증지구
impacted school district : x, (미)과밀학구
impaction : 꽉 들어차게함, 밀착시킴, 눌러댐, (의)(신체의 일부의)매복(증)
impactive : a, 충격에 의한, 충격적인, 강렬한
impact loan : x, (경)용도 제약이 없는 외화차관
impact statement : x, (어떤 기획이 환경등에 미치는)영향평가(보고서)
impact strength : x, (재료의)충격 강도
impair : vt, (가치, 미점, 건강등을)감하다, 덜다, 손상시키다, 해치다(damage)
impairment : n, 감손, 손상
impala : n, 임팔라(아프리카산 영양
impale : vt, (뾰족한 것으로)찌르다, 꿰뚫다(upon, with), 말뚝으로 찌르는 형벌에 처하다, 꼼짝못하게 하다, (문)방패 중앙에 세로 줄을 긋고 양쪽에 문장을 그리다
impalement : n, 말뚝으로 찌르는 형벌, (문)합문
impalpability : n, 만져서 알수 없음, 무형, 알기 어려움
impalpable : a, 만져 보아도 알수없는, 실체가 없는, 무형의, 쉽게 이해하기 어려운, 영묘한 
impalpably : ad, 
impanel : vt, 배심 명부에 기록하다, (배심 명부에서 배심원을)선출하다
impanelment : n, 
imparadise : vt, 천국에 들어가게 하다, 행복(황홀)하게 하다, 낙원으로 만들다
imparity : n, 부동, 같지 않음
impark : vt, (고)(동물을)원내에 가두다, (숲등을)둘러 공원(수렵지)으로 하다
impart : vt, (문어)나눠 주다(bestow.give)(사물에 성질등을)덧붙이다, 첨가하다, (지식, 비밀등을)전하다, 알리다(tall)
impartable : a, 
impartation : n, 수여, 나누어 줌, 전달
impartial : a, 치우치지 않은, 편견이 없는, 공평한, 공명정대한(fair, 
impartiality : n, 불편부당, 공평무사, 공명정대
impartially : ad, 
impartible : a, (부동산등을)분할할 수 없는, 불가분의(indivisible, 
impassability : n, 통과(통행)불능, 불통된 곳
impassable : a, (길등이)지나갈수 없는, 통과(횡단)할수 없는, (곤란등이)넘어설 수없는, 극복할수 없는
impassableness : n, 
impassablly : ad, 
impassably : ad, 
impasse : n, 막다른 골목, 난국, 궁경, 막다름
impassibility : n, 고통을 느끼지 않음, 무감각
impassible : a, 고통을 느끼지 않는, 무감각(무감정, 무신경)한, 둔감한
impassion : vt, (감동)감격 시키다
impassioned : a, 감동한, 정열적인, 열렬한
impassive : a, 고통을 느끼지 않는, 무감각한, 의식없는(unconscious)둔감한, 무표정한, 감동 없는, 열성없는.태연한, 냉정한, impassively, ad
impassivity : n, 무감각, 둔감, 무표정, 무감동, 태연, 냉정
impaste : vt, ..에 풀칠하다, 풀로 봉하다, 풀모양으로 하다, 채료를 두껍게 칠하다
impasto : n, (서)채료를 두껍게 칠하기, 두껍게 칠한 재료
impatience : n, 성급함, 조급, 안달, 조바심, (고통, 압박등을)참을수 없는일
impatiens : n, 봉선화
impatient : a, 성급한, 참을성없는(restless), 안달하는, 조바심하는, 몹시..하고 싶어하는 , 갈망하는(eager)몹시기다려지는
impatiently : ad, 성급하게, 조바심하며
impavid : a, (고)대담한, 겁내지않는(fearless)
impawn : vt, (고)전당 잡히다, 언질을 주다, 서약하다(pledge)
impayable : x, 귀중한, 소중한
impeach : vt, (미)(공무원 등을)탄핵하다, 비난하다, 탓하다(charge)...의 허물로)..의 과실을 나무라다, ..에게 죄를 취우다, 고소(고발)하다, (명예, 인격등을)의심하다, 문제삼다
impeachable : a, 탄핵(비난, 고발)해야할
impeachment : n, 비난, 고소, 고발, (법)탄핵
impearl : vt, (문어)진주 모양으로 만들다, 진주(같은 구슬)로 장식하다
impeccability : n, 죄(과실)가 없음, 완전무결
impeccable : a, 죄를 범하지 않는, 죄(과실)없는, 결점없는, 나무랄데 없는
impeccably : ad, 
impeccancy : n, 
impeccant : a, 죄없는, 결백한
impecuniosity : n, 돈이없음, 가난한
impecunious : a, 돈없는, 가난한(poor)
impecuniously : ad, 
impedance : n, (전)임피던스(교류에 있어서 전압의 전류에 대한 비)
impede : vt, 방해하다, 저해하다(hinder)
impediment : n, 방해(물), 장애(obstacle), 신체장애, (특히)언어 장애, 말더듬이
impedimenta : n, 방해물, 수하물, (군)보급품
impedimental : a, (고)방해가 되는
impedimentary : a, 
impeditive : a, 방해가 되는
impel : vt, (생각, 감정 등이)추진하다, 재촉하다, 몰아대다(compel)억지로...시키다, 밀다, 밀어붙이다, 추진하다, 몰다
impellent : a, n, 추진하는, 밀어붙이는, 몰아대는, 억지스러운, 추진하는것, 추진력
impeller : n, 추진하는 사람(것), (기)날개바퀴
impend : vi, (고)머리위에 걸리다, 드리워지다, (사건, 위험등이)임박하다
impendence, impendency : n, 들이닥침, 절박, 임박, 위급
impendent : a, IMPENDING
impending : a, (불길한 일이)금세 일어날 것 같은, 절박한, 박두한(유의어, imminent)
impenetrability : n, 꿰뚫기 어려움, (물)불가입성, 불가해, 무감각, 완고
impenetrable : a, 꿰뚫을수 없는, 뚫고 들어갈수 없는, (신비로움)헤아릴 수 없는, 불가해의(obscure), 고집스러운, 완고한, (사상, 감정등을)받아들이지않는, 무감각한, (물)불가입성의
impenetrably : ad, 꿰뚫을수 없게, 무감각하게
impenrtence : n, 뉘우치지 않음, 개전의 정이 없음, 억척스러움, 완고
impenrtency : n, 회개하지 않는
impenrtent : a, n, 개전의 정이 없는, 완고한, 뉘우치지 않는 사람, 완고한 사람
impenrtently : ad, 
imper., imperat. : x, imperative
imperatival : a, (문법)명령법의
imperative : a, n, 피할 수 없는, 긴급한, 꼭 해야 할, 필수적인, 긴요한(urgent), 명령적인, 단호한, 위엄있는, 엄숙한, 강제적인, (문법)명령법의, 명령(command), (정세등에 따른)필요성, 의무, 요청, (문법)
imperatively : ad, 
imperativeness : n, 
imperator : n, 원수, 황제, (희)전제군주, (로마사)황제, 대장군, 최고 사령관
imperatorial : a, IMPERATOR의 다운
imperceptibility : n, 감지할수 없음, 극미, 미세
imperceptible : a, 눈에 보이지 않는, 알아챌수 없을 만큼의, 지각(감지)할수 없는, 알수없는, 미세한, 경미한, (very slight)
imperceptibly : ad, 
imperceptive : a, 감지 못하는, 지각력이 없는
imperceptiveness : n, 
imperence : n, (영속)IMPUDENCE
imperf. : x, imperfect
imperfect : a, 불완전한, 불충분한, 결점(결함)이 있는, (문법)미완료의, 반과거의, (문붑)미완료시제
imperfect flower : x, 불완전한(화)자웅이화
imperfect fungus : x, (직)불완전한 균(불완전균류에 속하는 진균의 총칭)
imperfection : n, 불완전, 결점, 결함
imperfective : a, n, (문법)(러시아어 동사등이)미완료형의, 미완료형(의 동사)
imperfectly : ad, 불완전하게, 불충분하게
imperfectness : n, 
imperforate : a, n, 구멍 없는, (우표에) 구멍선이 없는, 구멍선이 없는 우표
imperial : 제국의, 대영제국의, 대영제국 제정의, 황제의, 황후의, 황실의, 제권의, 제위의, 최고 권위의, 최고 권력을 가진, 장엄한, 당당한(majestic), 거만한, 건방진(상품이)특대(고급)의, 우수한, (도량형이)영본국의 법정표준을 따른, 황제수염(나풀레옹 3세의 수염식으로아랫입술밑에 끝이 뾰족하게 기른, 승합마차의 지붕(에 싣는 여행용 트렁크), 특대품, 질이 좋은 물건, 제정 러시아의 금화
imperial city : x, 제국의 중심지, 제국 정부의 소재지, 제도(Rome 시의 별칭)
imperial gallon : x, 영 갤런
imperialism : n, 제국주의, 제정, 영토확장주의, 대영 제국주의, 개발도상국 지배(정책)
imperialist : n, 황제지지자, 제국(제정)주의자, 대영 제국주의자
imperialistic : a, 제정의, 제국주의적인
imperialistically : ad, 제국주의 적으로
imperialize : 제국의 지배하에 두다, 제국주의화하다
imperially : ad, 제왕처럼, 제국주의적으로, 장엄하게
imperial presidency : x, (미)제왕적 대통령제(초헌법적으로 강대해진 미국 대통령의직(지위)
Imperial Valley : x, 미국 California주 남동부의 농경지대
imperil : vt, (생명, 재산 따위를)위태롭게 하다, 위험하다(endanger)
imperious : a, 전제적인, 오만한, 거만한, 긴급한, 중대한, 피할수 없는, 필수의
imperiously : ad, 
imperiousness : n, 
imperishability : n, 불사, 불멸, 불멸성, 불후성, (식품등의)무부패성
imperishable : a, 불멸의, 불사의, 불후의, (식품등이)부패하지 않는
imperishably : ad, 
imperium : n, 절대권, 주권
imperium in imperio : n, 국가내의 국가, 권력내의 권력
impermanence, -nency : n, 비영구(비영속)성, 일시성, 덧없음
impermanent : a, 비영구적인, 영속하지 않는, 일시적인(temporal)
impermanently : ad, 
impermeability : n, 불침투성
impermeable : a, 스며(배어)들지 않는, 불침투성의
impermissible : a, 허용(용납)할수 없는
impermissiblity : n, 
impers. : x, impersonal
imperscriptible : a, 전거 없는
impersonal : a, n, 인격을 가지지 않는, 비인간적인, 개인에 관하지 않는, 비개인적인, 일반적인, 개인의 감정을 섞지 않는, 객관적인, (문법)비인칭동사(대명사)
impersonality : n, 비인격성, 비개인성, 인간 감정의 부재, 특정 개인에 관하지 않는 것, 비인간적인 것
impersonalize : vt, 비개인적인(비인격적)으로 하다
impersonally : ad, 
impersonal verb : x, 비인칭 동사(항상 제3인칭 단수
impersonate : vt, (배우등이)..의 역을 하다, ..으로 분장하다(act), 흉내내다, 음성을 흉내내다, 체현(구현)하다(embody), 인격화하다, 의인화하다
impersonation : n, 인격화(체현)하다, 의인, 권화, (배우의)분장(법), (역을)맡아함, 연기, 음성(말투, 태도)을 흉내냄
impersonator : n, 의인자, 분장자, 배우(음성, 태도등을), 흉내내는 사람(연예가)
impertinence : n, 건방짐, 주제넘게 굴기, 무례, 무례하게도(건방지게도), 무례한 행위(말), 무례한(건방진)사람, 부적절 관계, 무관계, 부적절한 행위(말)
impertinency : n, 
impertinent : 건방진, 무례한, 주제넘은, (유의어 impertinent 뻔뻔스럽고, 주제넘은의 뜻으로서 무례함을 나타낸다, impudent 염치없고 뻔뻔스러운의 뜻을 지닌, 무례함의 정도가 더 심한 말이다, insolent 무례한), 적절하지 못한, 무관계한, 주제넘은 사람, 무례한 사람
impertinently : ad, 
imperturbability : n, 침착, 냉정(calmness), 태연함
imperturbable : a, 침착한, 동요치 않는, 냉정한, 태연한
imperturbably : ad, 
imperturbation : n, 침착, 냉정
impervious : a, (물, 공기 등을)통과시키지 않는, 불침투성의, (비평등에)영향 받지 않는, 손상되지 않는, 견디는, 무감각한, 둔감한
imperviously : ad, 
imperviousness : n, 
impetigo : n, (병리)농가진
impetrate : vt, 탄원하여 얻다, 기원(기도)하여 얻다, (희)탄원하다
impetuous : a, (바람, 흐름, 속도 등이) 격렬(맹렬)한(violent), (기질, 행동등이)열렬한, 성급함, 충동적인(rash)
impetuously : ad, 
impetuousness : n, 
impetus : n, 힘, 기세, 자극, 기동력, (기)운동량
impetusosity : n, 격렬, 맹렬, 열렬, 성급함, 성급한(격렬한)언동
impf. : x, imperfect
impi : n, 남아프리카 Zulu 또는 Kafir족 전투원의)대부대
impiety : n, 불경, 불손, , 신앙심이 없음, 경건하지 않음, 신앙심 없는(불경한, 사악한 행위(말)
impinge : vi, 치다, 충돌하다(strike), 부딪치다, (남의 권리, 재산 등을 )침범하다, 침해하다, ..에 영향을 미치다, 인상을주다
impinger : n, 집진장치
impious : a, 신앙심 없는, 경건치 않은, 불경(불효)한, 사악한
impiously : ad, 
impiousness : n, 
impish : a, 장난꾸러기의(mischievous), 개구장이의
impishly : ad, 
impishness : n, 
implacability : n, 달래기 어려움, (노여움등)풀기 어려움, 앙심깊음, 무자비함
implacable : a, (적, 증오 등)달래기 어려운, 준엄함, 무자비한, 화해할수 없는 , 앙심깊은
implacablness : n, 
implacably : ad, 
implant : vt, n, 꽂아 넣다, 박다, (씨 등을)심다, (주의, 사상 등을)주입하다, 불어넣다, (의)(살아 있는 조직 조각등을)이식하다, (의)신체에 이식되는 조직, 조각, (이과)(라듐등의)방사 물질을 넣은 작은관(암등의 치료를 위해 환자 체내에 삽입함)
implantable pump : n, (의)매몰식 펌프(체내에 삽입하여 약제를 주입하는 장치
implanter : n, 
implantion : n, 부식, 이식, 주입, 고취, (의)피하 주입, 내이식, 이식성, 전이
implausibility : n, 
implausible : a, 받아들이기(믿기)어려운, (믿어질 만큼)그럴듯하지 않은, implausibly, ad
implead : vt, 고소하다, 기소하다, (고)비난하다, 책망하다, (고)항변하다
impledge : vt, (고)저당 잡히다(pawm)
implement : n, vt, 도구, 용구, rlrn, ..에게 필요한 수단(권한)을 주다, (약속, 계약, 계획등을)이행하다, 실행(실시하다), (요구, 조건, 부족등을)충족시키다, 다하다
implemental : a, 도구의, 도구가 되는, 도움이 되는, 실현에 기여하는
implementation : n, 이행, 실행, 완성, 성취, 충족
impletion : n, (고)가득 채우기, 충만
implicate : vt, n, (문어)(범죄 등에)관련시키다, 휩쓸리게 하다, 연루시키다, 휩쓸어넣다(involve), (뜻을)포함(함축)하다(imply), 엉키게하다, 서로 얽히게 하다, 포함된것
implication : n, 연루, 밀접한 관계, 관련, 포함, 함축, 내포(암시)하고 있는 것, 언외의 의미, 
implicative : a, 함축적인, 은연중에 내포하는, 언외의 뜻이 있는, 연루의
implicatively : ad, 
implicit : a, 절대적인, 맹목적인, 함축적인, 분명히 표현하지 않은, 암시적인(opp.explicit), 내재하는
implicitly : ad, 
implicitness : n, 
implied : a, 함축된, 은연중의, 암시적인, 언외의(opp.express)
implied consent : x, 암묵의 동의, 묵낙, (미법)묵시적 동의(운전자가 음주 테스트에 응하는등)
impliedly : ad, 암시적으로, 은연중의
implied powers : x, (미)(헌법에 규정은 없으나 의회가 행사하는)묵시적 권한
implode : vi, vt, (진공관 등이)안쪽으로 파열하다, 내파하다, (음성)(폐쇄음이)내파하다, (음성)(폐쇄움을)내파시키다
imploration : n, 탄원, 애원
imploratory : a, 애원하는, 탄원하는
implore : vt, vi, 간청(탄원, 애원)하다, 애원(탄원, 간청)하다
imploring : a, 탄원하는, 애원하는(듯한)
imploringly : ad, 
implosion : n, (음성)(폐쇄음의)내파, 진공관의 내파
implosive : n, ((폐쇄음이)내파의(cf, implode), 내파음
impluvium : n, (옛로마)암플루비움(현관 홀의 천창으로 부터 빗물 모으는 통이나 수반)
imply : vt, (필연적으로)포함하다, 수반하다, 내포하다, 함축하다.(-의)의미를 암암리에 가지다, 의미하다, 암시하다
impo : n, (영구)(학생에게)벌로 과하는 과제
impolder : vt, (땅을)메우다(reclaim)간척하다
impolicy : n, 졸책(bad policy
impolite : a, 무례한, 버릇 없는
impolitely : ad, 무례한, 버릇 없는
impoliteness : n, 무례한, 버릇 없는
impolitic : a, 지각없는, 득책이 못되는, 졸렬한, 불리한(unwise)
impoliticly : ad, 미련하게, 졸렬하게
imponderability : n, 무게를 달수 없음, 극히 가벼움, 평가할수 없음
imponderable : a, n, 무게가 없는, 무게를 달수 없는, 극히 가벼운, 미량의, (그 효과, 중요성등을)평가할수 없는 , 헤아릴수 없는, 불가량물, (열, 빛등), 계량 평가 할수 없는
imponderably : ad, 
imponent : n, 부과하는 사람
import : vt, vi, 수입하다, (의견, 감정, 습관등을)가지고 들어오다, 끌어들이다, 의미하다, (의)뜻을 내포하다, 뜻하다, (고)..에 중요하다, 중대한 관계가 있다, 중요하다, 중대한 관계가 있다(matter), 수입, 수입품(캐나다)외래선수, 수입액, (문어)취지, 의미(meaning), 중요(성)
importable : a, 수입할수 있는
importance : n, 중요(성), 중대성, 중요한 지위, 무게, 관록, 거드름, 오만(한 태도)
important : a, 중요한, 중대한, 소중한, (더욱)가장 중요한 것은, (사람, 지위등이)유력한, 영향력있는, (사회적으로)중요한, 저명한, 거드름부리는, 오만한
importantly : ad, 중요한, 유력한, 거만한
importation : n, 수입(품)
import bill : x, 수입어음
import declaration : x, 수입신고
import duty : x, 수입세
imported fire ant : x, (비)남미 원산의 마디개미(미 남동부의 해충)
importer : n, 수입자(상), 수입업자, 수입국
import license : x, 수입허가(서)
import quota : x, 수입할당(쿼터)
import restriction : x, 수입제한(규제)
import surcharge(surtax) : x, 수입과징금
import tariff : x, 수입세율
importunate : a, 성가신, 끈질긴, 귀찮은(추근추근)조르는
importunately : ad, 끈덕진, 귀찮은
importune : vt, ..을 끈덕지게 조르다, 성가시게 부탁하다, 괴롭히다(worry)
importunity : n, 끈덕짐, 끈덕진 요구(간청)
impose : (의무, 벌, 세금 등을)과하다, 지우다, 부과하다, (의견등을)강요(강제)하다, (가짜 등을)떠맡기다, 속여서 사게하다, (고)위에 놓다, (인)정판하다, (기독교)안수하다, 속이다, ..에 편승하다(남의 약점 따위를) 편승하다, 속이다, (남의 일에)주제 넘게 나서다, 말참견하다, 용훼하다, 위압하다, 탄복하게하다, 
imposing : a, 인상적인(impressive)당당한, 훌륭한, 남의 눈을 끄는
imposingly : ad, 
imposingness : n, 
imposing stone(table, surface) : x, (인)정판대
imposition : n, (의무짐, 세금 등을)지움, 과함, 부과, 부과물, 세금, 부담, (학생에게 벌로 과하는 과제), 둠, 놓음, (인)정판, (기독교)안수, (남의 호의등을 악이용한)기만, 사기, 협잡
impossibility : n, 불가능성, 불가능한 일
impossible : a, 불가능한, 있을 수없는, 믿기어려운, (구)(사람, 상황등이)참을수 없는, 몹시 싫은, (물품등이)몹시 이상한
impossible art : x, 개념예술(conceptual art
impossibleness : n, 
impossibly : ad, 불가능하게, 있을것 같지도 않게, 어처구니 없이, 극단적으로
impost : n, vi, 부과금, 세금(특히)수입세, 관세, (경마)핸디캡으로 싣는 짐, 부담 중량, (수입품의)관세를 결정하다, (관세를 위해)수입품을 분류하다, (건)홍예(아치)굽(홍예밑을 받치는 돌)
impostor, poster : n, (타인을 사칭하는)사기꾼, 협작꾼(swindler)
impostume, thume : n, (고)농양, 도의의 퇴폐(의 근원)
imposture : n, (타인을 사칭하는)사기(행위), 협잡
impot : n, IMPO
impotence : n, 무(기)력한, 허약, 뇌쇠, (병리)(남성의)성교불능, 음위
impotent : a, n, 무(기)력한, 체력이 없는, 허약한, 뇌쇠한, 능력이 없는, 효과가 없는, 어떻게 해볼수 없는, (병리)(남성이)성교 불능의, 음위의, 허약자, 무력자, 노쇠자, 성교불능자
impotently : ad, 
impotentness : n, 
impound : vt, (밖에 잘못나간 가축 등을) 우리속에 넣다, (물건을) 둘러싸다, (사람을)가두어 넣다, (물을 관개용으로) 모으다, 받다, (법)사람을 구치 감금하다, (물건을)몰수(압수하다(confiscate)
impoundment : n, 
impoverish : vt, (사람, 국가 등을)가난하게 하다, (토지 등을)메마르게 하다, 불모로 만들다, 약하게 하다, 허약하게하다, 흥미(변화, 매력(등)을 잃게하다, 지루하게(따분하게)하다
impoverished : a, 가난하게 된, 메마른, 힘을 잃은, 허약해진, 동식물의 종류(수)가 적은(지역)
impoverisher : n, 
impoverishment : n, 가난하게 만들다, (토지를) 메마르게 하다
impower : vt, EMPOWER
impracticability : n, 실행(실시) 불가능한, 버거움, 억척스러움, 고집셈, 실행 불가능한 일
impracticable : a, 실행 불가능한, (희)버거운, 억척스러운, 고집센, (길등이)통행할수 없는
impracticableness : n, 
impracticably : ad, 
impractical : a, (사람등이)실용적이 아닌, 실제에 어두운, 양식이 없는, (생각, 계획등이)실행할수 없는, 비현실적인, 비실용적인
impracticality : n, 비실제성, 실행불가능, 실제적이 아닌(실행 불가능한)일
impracticalness : n, 
imprecate : vt, (재난등을)빌다, 저주하다
imprecation : n, (재난등의)기원, 저주(의말)
imprecator : n, 
imprecatory : a, 저주하는
imprecise : a, 부정확한, 불명확한(vague)
imprecisely : ad, 
impreciseness : n, 
imprecision : n, 부정확, 불명확, 비정밀, 부정확(불명확)한것
impreg : n, 합성 수지를 먹인 합판
impregnability : n, 난공 불락, 견고
impregnable : a, 난공 불락의, (비평, 논리, 유혹등에 )끄떡 않는, 지지않는, 도덕심이 견고한, 수정(수태)가능한
impregnablebly : ad, 
impregnableness : n, 
impregnate : vt, a, 임신(수태)시키다, (생)수정시키다, 스며들게 하다, 포화(충만)시키다, (마음에)스며들개 하다, 깊은 인상을 주다(impress), (사상등을)불어넣다, 고취하다, 주입하다, 임신한, 스며든, 포화된, 고취(주입)된 
impregnation : n, 수태, 수정, 포화, 충만, 고취, 주입
impresa : n, (병)(방패위의)문장, 금언
impresario : n, (가극, 음악회 따위의)흥행주, 주최자(organizer), (한흥행 단체의)감독 지휘자, 경영자
imprescriptible : a, (법)(권리등이)시효로 소멸되지 않는, 법령으로 움직일수 없는 , 불가침의, 절대적인(absolute)
imprescriptiblebly : ad, 
impress : vt, n, ..에게(깊은)인상을 주다, 마음에 새기게 하다, 감동시키다, 감명을 주다(impressed), (도장등을)찍다, 누르다, (도장등을)찍음, 날인, 흔적, 특징, 인상, 감명, 영향
impress : vt, 징발하다, (해군 등에)(강제)징집하다, (논증등에)인용(이용)하다
impressed : a, 감명하여, 감명을 받아
impressibility : n, 다감, 감수성
impressible : a, 다감한, 감수성이 강한(susceptible)
impressiblebly : ad, 
impression : n, 인상, 느낌, 감명, (막연한)느낌, 생각, 기분, (인)인쇄, 1회의 부수(원판대로의)쇄, 영향, 효과(effect), 날인, 인각, 자국, 흔적, (치과)의치의 본(mold), (유명한 사람을)흉내내기
impressionability : n, 감수(감동)성 민감
impressionable : a, 감수성이 강한, 밖으로부터의 영향을 받기 쉬운, 민감한, 감동하기 쉬운
impressionism : n, 인상파(주의)
impressionist : n, 인상주의자, 인상파화가(조각가, 작가), 유명인사의 흉내를 내는 연예인, 인상파(주의)의
impressionistic : a, 인상주의자의, 인상파의, 인상적인
impressive : a, 강한 인상을 주는, 감명을 주는, 인상적인(감명적)
impressively : ad, 인상적으로, 인상깊게
impressiveness : n, 
impressment : n, 강제징모(모병)징발, 징용, 수용
imprest : n, (병사나 선원에게 주는)선불금, (국고에서 내는)전도금
imprimatur : n, (특히 카톨릭 교회가 주는 저작물의)인쇄(발행)허가, 허가, 인가, 면허, 승인
imprimis : ad, 최초에, 맨처음에
imprint : n, vt, 누른(박은, 찍은)자국, 인장, 자국, 흔적, 인상모습, (서적등의)간기, (발행자, 인쇄인의 주소, 성명등), (도장등을)누르다, 찍다(stamp), (마음, 기억등에)강한 인상을 주다, 명념시키다, 감명시키다(impress)
imprinter : n, 
imprinting : n, (동, 심)각인 찍기(태어난 직후에 획득하는 행동양식)
imprison : vt, 교도소(감옥)에 넣다, 수감하다, 가두다, 감금하다(shut up)
imprisonment : n, 투옥, 구금, 금고, 감금, 유폐, 속박
improbability : n, 정말같지 않음, 있음(일어남)직 하지 않음, 정말 같지 않은일, 있을(일어날)것 같지 않은일
improbable : a, 일어날 듯(있음직)하지 않은, 정말 같지 않은
improbably : ad, 있음직하지 않게, (..인지도 모르다)
improbity : n, 부정직, 불성실, 사악
impromptu : ad, a, n, 즉석에서, 준비없이, 즉흥적으로, 임시변통으로, (연설, 시, 등이)준비없이의, 즉석에서의, 즉흥적인, (식사등이)급히 지은, 임시로 마련한, 즉석연설(연주)즉흥시, (악)즉흥곡(등)(improvisation)
improper : a, (경우, 목적등에)부적당한, 어울리지 않는, (사실 규칙등에)맞지 않는, 틀린, 타당하지 않은, 버릇없는, 부도덕한, 상스러운, 음란한
improper fraction : x, (수)가분수
improperly : ad, 
improperness : n, 
impropriate : vt, a, (영국교)(교회의 수입을)개인 재산으로 넘기다, (교회재산이)속인의 손에 넘어간
impropriation : (영국교)교회의 수입(재산)을 속인의 손에 넘김, 그와 같은 수입(재산)
impropriator : n, (영국교)교회 재산을 보관하는 속인)
impropriety : n, 부적당, 온당치 않음, 부정, 잘못(단어의)오용, 점잖지 못함, 상스러움, 도리에 어긋남, 버릇없는(상스러운, 음란한)행위(말)
improvability : n, 개량(개선)할수 있음
improvable : a, 개량(개선)할 수 있는
improvablebly : ad, 
improve : vt, vi, 개선(개량)하다, 진보(향상)시키다, 이용하다, 활용하다, (농경, 건설등으로 토지, 부동산의)가치를 높이다, 나아가다, 호전하다, 진보하다, 증진하다, (주가, 시황등이)회복(호전)되다, 오름세가 되다
improvement : n, 개량, 개선, 진보, 향상, (동일물의)개량(개선)된 것, 개량(개선)(점), 개수공사(기회등의)이용 활용 
improver : n, 개량, 개선하는 사람(물건), 식품 첨가물(특히 방부제)수습공(임금 없이 또는 저임금으로 기술을 배우는
improvidence : n, 선견지명(지각)이 없음, 절약심이 없음
improvident : a, 선견지명 없는, 일을 생각하지 않는, 준비 없는, (사람이 경제상으로)장래에 대비하지 않는, 절약하지 않는(thriftless)
improvidently : ad, 
improvisation : n, 즉석에서 하기, 즉흥, 즉석에서한(지은)것, (즉흥시(곡)즉석화, (연주)등)
improvisational : a, 
improvisator : n, 즉석에서 짓는(연주하는)사람, 즉흥시인
improvisatore : n, IMPROVISATOR
improvisatorial : a, 즉석의, 즉흥의
improvisatory : a, (영)IMPROVISATORIAL
improvise : vt, vi, (시, 음악등을) 즉석에서 짓다, 즉흥적으로 연주하다(extemporize)임시 대용으로 마련하다, (만들다), (연주, 연설등을)즉석에서(즉흥적으로)하다
improvised : a, 즉석에서 지은, 즉흥의
improviser : n, 즉흥시인, 즉석 연주자
imprudene : n, 경솔, 경망, 무분별, 조심성 없음, 경솔한 언행
imprudent : a, 경솔한, 분별없는, 경망스러운(indiscreet)
imprudently : ad, 
impudence : n, 뻔뻔스러움, 건방짐, 몰염치, 건방진 언행
impudent : a, 뻔뻔스러운, 염치없는, 건방진(impertinent), impudently, ad
impudicity : n, 파렴치, 염치없음, 후안무치, 음탕, 추행(immorality)
impugn : vt, (문어)(남의 행동, 으견, 성실성 등에 대해)이의를 제기하다, 논박하다, (남을)비난(공격) 하다(challenge)
impugnable : a, 비난(공격)의 여지가 있는
impugnment : n, 비난, 공격
impuissance : n, 무기력, 무력, 허약, 무능
impuissant : a, 무기력한, 무력한, 무능한, 허약한
impulse : n, 추진(력), (물리적인)충격, (외부로부터의)자극, 고무, (마음의)충동, (기동)자극, 변덕, 일시적 감정(역학)순간력, 충격량, 역적, (힘과 시간과 의 곱), (생리)충동, 욕구, (전)충격, 임펄스ne the ~ 일시적 기분으로
impulse buyer : x, 충동적인 구매자
impulse buying(purchase) : x, 충동 구매(소비재의)
impulse charge : x, 충격 장악(로케, 미사일)등을 발사기에서 이탈시키는 데 쓴 폭약)
impulseness : n, 
impulsion : n, 충동, 충격, 자극, 원동력, 추진, 순간적인 동기(기분)
impulsive : a, 충동적인, 감정에 끌린, 추진하는, 추진적인, 자극적인, 고무적인, (역학)순간력의 
impulsively : ad, 
impunity : n, 형, (벌, 해, 손실)을 받지 않음
impure : a, (물공기 등이)더러운 불결한(dirty)순수하지 않은불순물이 섞인, (색이)혼색의, (문체 어법등이)관용적이 아닌, (동기 등이)불순한 부도덕한, 외설한, 음단한(obscene), 종교적으로 더럽하지 , 신성하지 않는
impurely : ad, 
impurity : n, 불결, 불순, 음란, 외설(obscentiy)불순물, 혼합물, 불순한(부도덕한 행위, 
imputability : n, 전가 시킬(책임지울)수 있음
imputable : a, (탓으로)돌릴수 있는, 지울수 있는, 전가할수 있는
imputablebly : ad, 
imputableness : n, 
imputation : n, (죄 등을..에게)돌림, 전가(accusation)비난, 비방, 허물, 누명
imputative : a, ..탓으로 돌려진, 덮어 쓰위진 전가된
imputatively : ad, 
impute : vt, (죄등을)..에게 돌리다, 씌우다, 전가하다, ..의 탓이라고 하다
imputer : n, 
imputrescible : a, 부패하지 않는, 분해되지 않는
impv. : x, imperative
IMU : x, inertial measurement unit(관성측정 장치)
in : pref, (1앞에서는 il로, b, m, p앞에서는 im으로, r앞에서는 ir로 바뀜) in, into, not, without, un 따위의 뜻
in : prep, IN
In : x, (화)indium
IN : x, (미우편)IIndiana, (전산)information newtwork
in : x, (연결형)(안의, 속의)의 뜻
in : suf, 에 속하는의 뜻의 형용사 및 그파생명를 만듬
in : suf, 화학제품, 약품명등을 만듬
in : x, (연결형)집단 항의(시위)및 사교적 집회를 나타내는 복합어를 만듬
in- : pref, 무, 불, (not)의 뜻
in. : x, inch(es)
ina : suf, 여성형 명사를 만듬, 악기를 만듬
inability : n, 무능, 무력, 할수 없음
inabsentia : ad, 부재중에
inaccessibilty : n, 접근하기 가까이 가기, 도달하기, 얻기, 어려움
inaccessible : a, 가까이 가기, 도달하기, 얻기, 어려운, 친해지기 어려운, (감정등에)움직여 지지 않는, (작품등이)난해한
inaccessiblebly : ad, 
inaccessibleness : n, 
inaccuracy : n, 부정확한, 정밀하지 않음, 잘못, 틀림
inaccurate : a, 부정확한, 정밀하지 않은(inexact)
inaccuratly : ad, 틀린
inaction : n, 무활동, 불활동, 게으름, 휴지, 휴식
inactivate : vt, 활발치 않게 하다, (생화)(혈청등을)비활성화하다
inactivation : n, 
inactive : a, 활동하지 않은, 움직이지 않는, 게으른, (기계등이)움직이지 않는, 사용되지 않고 있는(화, 물)불활성의, (광)불선광성의(물)방사능이 없는, (군)현역이 아닌
inactively : ad, 
inactivity : n, 무활동, 휴지, 정지, 활발하지 않음, 무기력, 게으름
inadaptability : n, 적응성이 없음, 적합하지 않음
inadaptable : a, 적응(순응)할수 없는
inadequacy : n, 부적당, 불충분, 무능(incompetence), 부적당(불충분)한점(부분)
inadequate : a, 부적당한, 부적절한, 불충분한, (사람이 사회적으로)적성(적응성)이 없는, (부족한), 사회 부적격의
inadequately : ad, 
inadequateness : n, 
inadmissibility : n, 용납(승인)하기 어려움
inadmissible : a, 용납할 수 없는, 승인할수 없는
inadmissibly : ad, 
inadvertence : n, 부주의, 소홀(부주의에 따른)실수, 잘못
inadvertency : n, 부주의, 소홀(부주의에 따른)실수, 잘못
inadvertent : a, 부주의한, 소홀한(inattentive), 태만한, 고의가 아닌, 우연의, 의도하지 않은
inadvertently : ad, 
inadvisabiliity : n, 
inadvisable : a, 권할 수 없는, 현명하지 않은, 어리석은(unwise)
inadvisably : ad, 
in aeternum : ad, 영원히
inalienability : n, 양도불가능
inalienable : a, (권리등이)양도할 수 없는, 빼앗을수 없는
inalienable : a, 변경할수 없는, 불변성의
inalienably : ad, 
inalienably : ad, 
inalterability : n, 변경할수 없음, 불변성, 불역성
inamorata : n, 애인, (특히)정부
inamorato : n, 정부, 애인(lover)(남자)
inandin : a, ad, 동종 교배의(로)
inandout : a, (증권등을 단기로)매매하는, (미속)들쭉날쭉의
inandouter : n, (미속)(컨디션이)고르지 못한 선수(연예인)
inane : a, 공허한, 어리석은, 텅빈, 허공, 무한한 공간
inanely : ad, 
inaneness : n, 
inanimattion : a, 생명이 없음, 무활동, 무기력
inanition : n, 공허, (의)영양실조
inanity : n, 어리석음, 우둔, 헛됨, 공허, 지각없는 언행
inappeasable : a, 달래기 어려운, 누그러지게 할수 없는
inappellable : a, 상고(공소)할수 없는
inappetence : n, 식욕부진
inappetency : n, 식욕부진
inappetent : a, 식욕이 없는, 식욕부진의
inapplicability : n, 응용(적용)할 수 없음
inapplicable : a, 응용(적용)할 수 없는, 들어 맞지 않는, 부적당한
inapplicably : ad, 
inapposite : a, 적절하지 않은(unsuitable), 엉뚱한
inappositly : ad, 
inappositness : n, 
inappreciable : a, 감지, 할수 없을 만한(imperceptible)근소한, 보잘것 없는
inappreciably : ad, 
inappreciantion : n, 진가를 알지 못함, 몰이해
inappreciative : a, 진가를 알지 못하는, 감식력이 없는
inapprehensible : a, 이해할 수 없는, 불가해한
inapprehension : n, 몰이해, 불가해
inapprehensive : a, 이해력이 없는, 이해하지 못하는, (위험등을)알아차리지 못하는
inapproachable : a, 가까이 갈 수 없는, 당해낼수 없는, 쌀쌀한
inappropriate : a, 부적당한, 온당치 못한
inappropriately : ad, 부적당한
inappropriateness : n, 
inapt : a, 부적당한(unfit), 서투른(unskillful)
inaptitude : n, 적합하지 않은, 부적당한, 서투름, 졸렬
inaptly : ad, 
inaptness : n, 
inarch : vt, (원예)접붙이다
inarguable : 논쟁의, 여지없는, (사실등)
inarguably : ad, 
inariticulate : a, 발음이 똑똑하지 않은, 알아들을수 없는, (흥분, 고통으로)말을 못하는, 말하지 않는(unspoken)말을 못하는 , 말이 나오지 않는, 똑똑하게 의견을 말하지 않는, (해)관절이 없는
inariticulatly : ad, 명료하지 않게
inariticulatness : n, 
inarm : vt, (시)을 꼭껴안다
in articulo mortis : ad, a, 죽음의 순간에(의), 임종에(의)
inartificial : a, (희)기교가 없는, 기교를 가하지 않은, 천진 난만한, 자연스러운, 비예술적인
inartificialy : ad, inartificial
inartistic : a, 비예술적인, 예술을 모르는, 몰취미한(cf.UNARTISTIC)
inartistical : a, 비예술적인, 예술을 모르는, 몰취한(cf.UNARTISTIC)
inartistically : ad, 
inasmuch as : ad, (문어)...이므로, (희)..하는 한은(insofar ad)
inattention : n, 부주의, 태만, 무뚝뚝함, 무심, 경솔한, 행동
inattentive : a, 부주의, 태만, 등한한, 무뚝뚝함, 실례
inattentively : ad, 부주의, 태만, 무뚝뚝함, 실례
inaudibility : n, 들리지 않음, 청취 불능
inaudible : a, 알아들을 수 없는, 들리지 않은
inaudibly : ad, 
inaugural : a, n, 취임식의, 개시(개회)의 낙성, (개업)(영)교수의 취임초 공개강의(미)취임연설(식)취임식
inaugurate : vt, 취임식을 거행하다, 취임시키다(미)에서는 특히 대통령에게씀, (보통 수동형으로, 낙성식(개업식, 발족식)을 거행하고 공공 시설을 쓰기 시작하다, (새 시대를 개시하다..의 막을 열다
inauguration : x, 정식, 개시, 개업, 창업, 창립, 취임식, 낙성(개업, 개통, 제막)식
Inauguration Day : x, 대통령취임식 날(당선 다음해 1월 20일)
inaugurator : n, 취임시키는 사람, 서임자, 개시자, 창시자
inauspicious : a, 불길한, 불운(불행)한
inauspiciously : ad, 
inauspiciousness : n, 
inbd. : x, inboard(항공)기내의, 선내의
inbeing : ['inbitw'i
inboard : a, ad, n, (해)배안의(에), 엔진이 배안에 있는, (기)안으로 향한(향하게), (공)비행기의 동체에 가까운쪽의(에), 선내 모니터
inboardoutboard : a, n, 선내 발동기와 연결된 선미 추진식의(배)
inborn : a, 타고난, 선천적인, 천부의
inbound : a, 본국행의, 귀향의, 교통기관등 시내로 가는
inbounds line : x, (미호)인바운즈 라인(경기장을 세로로 3분하는 2개의 점선)
inbreathe : vt, 들이마시다, (생각등을)불어넣다, 고취하다(inspire)
inbred : a, 타고난, 동종번식의
inbreed : vt, (어떤 감정등을)내부에 생기게 하다, (가축을)동종번식시키다
inbreeding : n, 동종(근친)번식, 근친 결혼
inbuilt : a, BUILTIN
Inc. : x, Incorporated(미)유한책임회사, 주식회사(영국에서는ltd를 주로 씀)
inc. : x, inclosure, includ.including, inclusive, income, incorporated, increase
Inca : n, 잉카사람(스페인 사람들이 건너가기 전의 페루의 국왕), 잉카족, 잉카사람
Incabloc : n, (팔목 시계의)내진장치(상표명)
Incaic : a, 잉카사람(제국)의
Incaic Empire : n, 잉카 제국(12-16세기 페루에 있었던)
incalculability : n, 셀수 없음, 무수, 예상, (기대)할수 없음
incalculable : a, 이루어 헤아릴수 없는, 무수(무량)한, 막대한, 예상(대중)할수 없는, 믿을(기대할)수 없는, 변덕스러운
incalculably : ad, 무수히
incalculabness : n, 
incalescent : a, 온도(열)가 오르는
Incan : a, n, 잉카 사람(제국, 문화)의, 잉카사람
incandesce : n, 가열, 더해가는 열의
incandesce : 백열하다(시키다);vi, vt
incandescence : n, 백열
incandescent : a, 백열(광)의, 백열광을 내는, 빛나는, 열렬한
incandescent lamp : x, 백열전구
incandescent light : x, 백열(전)등
incantation : n, 주문, 마법, 요술
incantatory : a, 주문의
incap : n, (속)INCAPACITANT
incapability : n, 불능, 무능, 무자격
incapable : a, n, 할수 없는, (개선등이)불가능한, (거짓말등을)못하는, 무능한, 무력한, 자격이 없는, (사정등이)허용하지 않는, 받아들일수 없는, 무능자, 무자격자
incapableness : n, 
incapably : ad, 
incapacious : a, 좁은 한정된, (고)(지적으로)무능한
incapacitant : n, 행동불능, 화학제(최루가스.독가스등)
incapacitate : vt, 무능력하게 하다, (법)자격을 박탈하다, 실격시키다
incapacitation : n, 무능력(무자격)하게 함, 실격
incapacitator : n, INCAPACITANT
incapacity : n, 무능, 무력(inability)(법)무능력, 무자격, 실격
incarcerate : vt, 감금하다, 투옥하다
incarceration : n, 감금, 투옥, 유폐, 감돈
incarcerator : n, 
incardinate : vt, (로마 교황청의)추기경으로 임명하다, (성직자를 )교구에 입적시키다
incardination : n, 
incarnadine : a, vt, n, (시)분홍색의, 담홍색의, 살색, 분홍색, 붉게 물들이다, redden)
incarnate : , vt, 육체를 갖춘, 육체를 입은, 성육한, 사람의 모습을 한, (관념, 추상물등이)구체화한, 육체를 부여하다, (보통 수동형으로 써서 (..의 육체(모습)을 가지다)의뜻이 됨, ..의 화신이 되다, 구체화하다, 구현(실현)시키다
incarnation : n, 육체를 부여함, 인간화, 구체화, 실현, 권화, 화신, (의)육아발생, (하느님이)육신을 입으심, 성육신(인간을 구원하기 위해서 그리스도가 하느님의 아들로서 육신과 인간성을 가지고 지상에 태어난 일))
incase : vt, encase
incaution : n, 부주의
incautious : a, 무모한, 경솔한, 
incautiously : ad, 
incautiousness : n, 
incendiarism : n, 방화(arson), 선동
incendiary : a, n, 방화의, 불붙기, 불타기, 선동적인, 방화범, 선동자(agitator), 소이탄, 물질
incendive : a, 발화력이 있는
incense : n, vt, vi, 향, 향내, 방향, 아첨, 아부, 에 향을 피우다, 분향하다, 향을 피우다
incense : vt, 성나게 하다
incense burner : x, 향로
incensory : n, 달아매는 향료(censer, 
incentive : a, n, 자극적인, 고무하는(능률향상등을)격려하는, 보상의(encouraging), 자극, 유인, 장려금, 보상물, (하고자하는)의욕, 열의
incentive pay : x, (종업원 등에 대한)생산성 향상 장려금
incep : vt, vi, (고)시작하다, 착수하다(생)(음식등을)섭취하다, (특히cambridge 대학에서)석사(박사)학위를얻다
inception : n, (문어)시초, 발단, (cambridge 대학에서)학위를 받음
inceptive : a, n, 시초(발단)의(문법)동작(상태)의 개시를 나타내는, 기동(상)
inceptor : x, (cambridge대학의)학위 취득(후보자)
incertitude : n, 불확실, 부정, 불안정(unvertainty, 의혹
incessancy : n, 
incessant : a, 끊임없는, 그칠새 없는, 
incessantly : ad, 끊임없는
incest : n, 근친 상간(죄), 상피
incestuous : a, 근친 상간(죄)의
incestuously : ad, 
incestuousness : n, 
inch : n, vt, vi, 인치(1/12 피트, 2.54cm), 신장, 키, (근소한 거리), 소량, 신장, 조금, (부정문에서 부사적으로)조금도..(않다)한치도 물러서지(양보하지), 조금씩 움직이다(움직이게 하다)
inch : n, (스코)작은섬
inch : a, 인치의
incher : n, (길이, 지름등이)몇 인치의것
inchmeal : ad, 조금씩, 차츰(inch by inch) 
inchoate : a, (문)방금, 시작한, 불완전한, 미완성의
inchoate : vt, 시작하다, 창시하다
inchoation : n, 시작, 착수
inchoative : a, 시초의, (문법)동작의 개시를 나타내는
inchworm : n, (비)자벌레
incidence : n, (사건, 영향의)범위, 발생, 발생률, 발병률, 떨어짐, 추락, 낙하, 부담, 귀착, (물)투사, 입사, (물)투사각, 입사각, (공)영각(동체기준선에 대하여 주익이 이루는각
incident : 중대 사건으로발전할 위협성이 있는 부수적인 사건, accident뜻하지 않게 일어나는 사고, event중요한 사건이나 행사, 사변사건(전쟁, 폭등등)(시, 소설 중의)삽화, (법)부대조건(부수된권리, 의무등), 일어나기 쉬운, 흔히 있는, 있기 수운, (법)부대적인, 부수적인, (물)투사의, 입사의
incidental : a, n, 부수하여 일어나는, 흔히 있는 , 우연히 일어나는, 중요하지 않은, 부수적인, 지엽적인
incidentally : ad, 부수적으로, 우연히, (문장 수식어로)말이난 김에(말하자면), 덧붙여 말하자면
incidental music : x, (연극.영화등의)부수(반주)음악
inciderjell : n, 발염, 젤리(화염방사기, 소이탄용)
incinerate : vt, 태워서 재로 만들다, 소각하다, (화)재가 되게 하다, 화장하다
incineration : n, 소각, (화)회화, (미)화장
incinerator : n, (쓰레기등의)소각로, 화장로
incipience : n, (문어)최초, 발단, (병 등의)초기
incipiency : n, (문어)최초, 발단, (병 등의)초기
incipient : a, 시작의, 초기의, 발단의
incipiently : ad, 처음으로
incipit : n, (중세의 사본등의)쓰기시작(하는말)시작, 첫마디
incircuit : a, 전자, 회로에 짜넣은
incise : vt, 베다, 째다, 절개하다, 새기다, 조각하다
incised : a, 짼, 깊이 갈라진, 새긴, 조각한
incision : n, 베기, 째기, 새기기, 파기, 짼(벤)데, (외과)절개, (직)(잎의)결각렬
incisive : a, 예리한, 예민한, 재빠른, 기민한, (말등이)날카로운, 통렬(신랄)한
incisively : ad, 
incisiveness : n, 
incisor : n, (해)니
incitant : a, n, 자극하는, 흥분시키는, 자극물, 흥분제
incitation : n, INCITEMENT
incite : vt, 자극하다, 격려하다, 고무하다, 선, (분노, 호기심을 )일으키게하다
incitement : n, 자극, 고무, 선동, 자극물, 유인동기
incivility : n, 무례, 버릇없음, 무례(한 짓)
incivism : n, 시민정신의 결여, 비애국적 정신
incl, : x, inclosure, including, inclusive(ly)
inclearing : n, (집합적)(영)수입, 어음, (총액), 교환 수입어음
inclemency : n, (날씨의)불순, 험악, (기후의)혹독함, 무정함
inclement : a, (날씨가)험악한, 거칠고, 궂은, (기후가)혹독한, 추운, 무정한, 가혹한
inclinable : a, ..하는 경향이 있는, ..하고 싶어하는(to, to do), 유리한, 호의를 품은(to)
inclination : n, (기질적)경향, 기질, 성향, 좋아함, 의향, (문어)하는 체질적 경향, 기울이기, (머리를)숙임, 기울어짐, 경사, 비탈, 기울기, 빗면, 사면, (기)경도, 경각, 부각
incline : (마음이)내키게 하다, (마음을)..으로 돌리게 하다, ..의 경향이 생기게 하다, 기울이다, 경사지게하다, (몸을)구부리다, (머리를)숙이다, (귀를)기울이다, 들어주다, 기울다, 비탈지다, (몸을)기울이다, ..에 가깝다, 비슷하다(approximate)..하고 싶어지다, 할 마음이내키다, 마음이 기울다, 내키다, ..하는 경향이 있다, ..하는 체질이다, ..하기 쉽다, 경사(면), 물매, 기울기, 인클라인
inclined : a, ..하고 싶어하여, 경향(성향)을 나타내며, 경사진(선, 평면과)각도를 이루는
inclined plane : x, 사면
inclined railway : x, (보통 기관차로는 오르지 못하는)급경사 철도
inclinometer : n, (공)경각계, 경사계
inclose : vt, =ENCLOSE
inclosure : n, =ENCLOSURE
include : vt, 포함하다, 함유하다(유의어contain)넣다, (전체의 일부로서)계산하다, 포함시키다, 끼우다
including : prep, ...을 포함하여(함께 넣어서)(opp.exelude)
inclusion : n, 포함, 포괄, 산입, (논)포섭, 함유물, (생)세포함유물, (지질)포유물
inclusion body : x, (의)봉입제
inclusive : a, (수사 등의 뒤에 놓아) 포함하여, 함께 넣어, 함께 계산하여, 모든것을(포함한)넣은
inclusive languge : x, 남녀 포괄 영어(chairman을 chairperson으로 하는 등)
inclusively : ad, 계산에 넣어서, 전부 통틀어
inclusiveness : n, 
incoercible : a, 억제(억압)할수 없는, (물)액화할수 없는(기체)
incog : =INCOGNITO 
incog. : =INCOGNITO 
incogitable : a, (의)믿을(생각할)수없는
incogitant : a, 지각없는, 무분별한, 사고력이 없는
incognita : INCOGNITO의 여성형
incognito : a, ad, n, 익명의(으로)가명의(으로)암행의(으로), 익명(자), 가명(자), 암행(자)
incognizable : a, 감지 할수 없는, 알아채지 못하는
incognizant : a, 의식(감지)하지 않는, 알아채지 못하는(of)
incoherence : n, 조리가 서지 않음, 논리가 맞지 않음, 지리 멸렬, 모순된 생각(말)
incoherency : n, 조리가 서지 않음, 논리가 맞지 않음, 지리 멸렬, 모순된 생각(말)
incoherent : a, 조리가 서지 않는, 논리가 일관되지 않는, 모순된, 점착력이없는, 흐트러진
incoherently : ad, 
incohesive : a, 결합력(응집성)이 없는
incombustibility : n, 불연성
incombustible : a, n, 불연성의 (물건)
incombustibly : ad, 
income : n, 정기적수입, 소득(cf.REVENUE)
income group : x, 사회 소득층(동일 소득세액집단)
income maintenance : x, (미)(정부지급)소득, 보조(유지)금
income policy : x, (경)소득정책
incomer : n, 들어오는 사람, 침입자, 이입민, 내주자, 신임자, 후계자
income statement : x, 손익계산서
income tax : x, 소득세
income tax return : x, 소득세 신고
incoming : n, a, 들어옴, 찾아듦, 수입, 소득(income), 세입, 들어오는, (전)들어오는 선, 인입선, 뒤를 잇는, 신임의
incommensurability : n, 같은 표준으로 잴수 없음, 약분할수 없음
incommensurable : a, 같은 표준으로 잴 수 없는, 비교할수 없는, 어림도 없는, (수)약분 할 수 없는
incommensurably : ad, 
incommensurate : a, 어울리지 않는, 알맞지 않는, incommensurable
incommensurately : ad, 
incommensurateness : n, 
incommode : vt, (문어)..에게 불편을 느끼게 하다, 폐를 끼치다, 괴롭히다(trouble)훼방하다
incommodious : a, 불편한, 형편이 마땅치 않은(방 등이), 비좁은, 옹색한
incommodiously : ad, 
incommodiousness : n, 
incommodity : n, 거북함, 불편, 형편이 마땅치 않음, 불편한점
incommunicability : n, 전달할수 없음
incommunicable : a, 전달할 수 없는, 말로 할수 없는, (희)말수가 적은
incommunicable : a, 교환할수 없는, 바꿀수 없는, 불변의
incommunicablness : n, 
incommunicably : ad, 
incommunicably : ad, 
incommunicado : a, (미)외부와의 연락이 두절된, 독방에 감금된
incommunicative : a, 말하기 싫어하는, 말수가 적은, 과묵한, 붙임성 없는
incommunicatively : ad, 
incommutation : n, REVERSE COMMUTING
incompact : a, 짜임새 없는, 치밀하지 않은, 산만한(loose)
incompactly : ad, 
incompactness : n, 
incompany : a, 회사내의, 기업내의
incomparable : a, 비교할 수 없는, 비길데 없는(amtchless)
incomparably : ad, 비교가 안될 정도로, 빼어나게
incompatibilty : n, 양립할수 없음, 상반, 성격의 불일치, (직)접목의 불친화성, 상반된점
incompatible : a, 성미가 맞지 않는, 서로 용납하지 않는, 양립할수 없는, 모순된
incompatible color(system) : x, tv 비양립식(보통 흑백 세트에는 수상되지 않는 컬러 텔레비전방식)
incompatibly : ad, 
incompetence : n, 무능력, 부적격, 무자격
incompetency : n, 무능력, 부적격, 무자격
incompetent : a, 무능한, 쓸모없는, 능력없는(incapable), (법)무능력의, 무자격의, 무능력자, 부적임자, (법)무자격자
incompetently : ad, 
incomplete : a, 불완전한, 불충분한, 미완성의, 미비의(imperfect), (문법)불완전자(타)동사
incompletely : ad, 
incompliant : a, 순종하지 않는, 승낙하지 않는, 고집센
incompltion : n, 불완전, 미비, 미완성
incomprehensibilty : n, 이해할수 없음, 불가해성
incomprehensible : a, n, 이해할수 없는, (특히)신의 속성이)인식할수 없이 무한한, 무한(불가해)한것
incomprehensibly : ad, 불가해할 정도로, (문장 전체를 수식하여)불가해한, (이해할수 없는)일이지만
incomprehension : n, 이해력의 부족, 몰이해
incomprehensive : a, 이해력(포용력)이 없는
incompressibility : n, 비압축성
incompressible : a, 압축할 수 없는
incompressibly : ad, 
incomputable : a, 계산할 수 없는, 무수한
incomputably : ad, 
inconceivability : n, 불가해
inconceivable : a, 상상 할 수도, 인지를 초월한, (구)터무니없는, 믿을수 없는(incredible) 
inconceivableness : n, 
inconceivably : ad, 
inconclusive : a, 설득적이아닌, 결론에 이르지 못하는, 결정(확정)적이 아닌, 요령 부득이
inconclusively : ad, 
inconclusiveness : n, 
incondensable : a, 응축(응결)되지 않는
incondite : a, (문학작품등)구성이 서투른, 조잡한
inconformity : n, 부동형, 부적합, 불일치
incongruence : n, INCONGRUITY
incongruent : a, 맞지 (일치하지)않은, 조화(적합)하지 않은
incongruently : ad, 
incongruity : n, 부조화, 모순, 부적합, 부조화한 사물
incongruous : a, 조화되지 않는, 어울리지 않은, 모순된, 부조리한, 동닿지 않은
incongruously : ad, 
incongruousness : n, 
inconnu : n, (어)북미산, 연어과의 식용어
inconsecutive : a, 연속하지 않는, 일관성이 없는, 앞뒤가  안맞는
inconsecutively : ad, 
inconsecutiveness : n, 
inconsequence : n, 논리적이 아님, 모순, 불합리, 부조화, 엉뚱함
inconsequent : a, 비논리적인, 조리에 맞지 않는(illogical)당찮은, 부조화의
inconsequential : a, 하찮은, 이치에 맞지 않는
inconsequentially : ad, 
inconsequentialness : n, 
inconsequently : ad, 
inconsiderable : a, 사소한(small), 중요치 않은, 하찮은
inconsiderablness : n, 
inconsiderably : ad, 
inconsiderate : a, 남의 일을 생각할줄 모르는, 무관심한, 인정없는, 지각(분별)없는, 경솔한
inconsiderately : ad, 
inconsiderateness : n, 
inconsideration : n, 지각없음, 경솔, 인정 없음
inconsistency : n, 불일치, 모순, 주견없은, 모순된사물
inconsistent : a, 일치하지 않는, 조화되지않는, 모순된, 모순이 많은, 정견이 없는, 절조없는, 변덕스러운
inconsistently : ad, 
inconsoable : a, 위로할 길 없는, 슬픔에 잠긴
inconsoably : ad, 
inconsonance : n, 부조화, (소리에)불협화
inconsonant : a, 조화(일치)하지않는, (소리가)불협화의
inconsonantly : ad, 
inconspicuous : a, 눈에 띄지 않는, 주의를 끌지 않는, 뚜렷하지 않은, (직)(꽃이)작고 빛깔이 엷은
inconspicuously : ad, 
inconspicuousness : n, 
inconstancy : n, 변하기 쉬움, 부정, 변덕, 변덕스러운 행위
inconstant : a, 변덕스러운, 변하기 쉬운, 일정하지 않은, 변화가 많은, 신의가 없는(unfaithful)
inconstantly : ad, 
inconsumable : a, 다 테어버릴수 없는, 다소모(소비)할수 없는, 소모품이 아닌, 내구재의
inconsumably : ad, 
incontestable : a, 논의의 여지가 없는, 논쟁할 필요없는(사실, 증거)명백한
incontestably : ad, 의심할 바없이, 명백시
incontinence : n, 자제할수 없음, 다변, 장광설, 음란, (대소변)의 실금
incontinency : n, 자제할수 없음, 다변, 장광설, 음란, (대소변)의 실금
incontinent : a, 자제할수 없는, 음란한, (비밀등을)지키지 못하는, (병리)(대소변)실금의
incontinent : ad, INCONTINENTLY
incontinently : ad, 자제할수 없게, (문어)즉시
incontrollable : a, 제어(억제)할수 없는, 감당할수 없는
incontrovertible : a, 논쟁의 여지가 없는, 다툴 나위 없는(indisputable), 명백한
incontrovertibly : ad, 
inconvenience : n, vt, 불편, 부자유, 귀찮음, 불편한것, 귀찮은 일, 불편을 느끼게하다, 폐를 끼치다(trouble)
inconvenient : a, 불편한, 부자유스런, 형편이 마땅하지 않은, 폐가되는
inconveniently : ad, 부자유스럽게, 불편하게
inconvertibilty : n, 교환(태환)불능
inconvertible : a, 교환할수 없는, 태환할수 없는
inconvertible note : 불환지폐, 
inconvincible : a, 납득시킬수 없는, 고루한
incoordinate : a, 동격, (동등)이 아닌, 조정되지 않은
incoordination : n, 동격이 아님, (의)근육의 협동 운동실조(증)
incor., incorp. : incorporated, 
incorporable : a, 합병(합체, 편입)할수 있는
incorporate : vi, vt, a, 통합(합동)시키다, 합병하다, 편입하다, 법인조직으로 만들다, (미)(유한책임)회사(주식회사)로 하다, 가입시키다, 구체화하다, (전산)기억장치에 짜넣다, 합동(통합)하다, 결합하다, 섞이다, 법인 조직이 되다, (유한책임)회사(주식회사)가되다
incorporate : a, (고)무형의, 영적인(spiritid)
incorporated : a, 합병한, 합동한, 편입한, 법인조직의, (미)회사가 유한 책임의
incorporation : n, 혼인, 혼합, 결합, 합동, 합병, 편입, 결사, 법인, 단체, 회사(corporation), (법)법인격 부여, 법인, (미)회사)설립, 문서병합, (언)포합
incorporative : a, 합체적인, 합동적인, 결합적인, (언)포합적인
incorporator : n, 결합자, 합동자, (미)법인(회사)설립자
incorporeal : a, 형체가 없는, 무형의, 영적인(spiritual)(법)무체 상속재산
incorporeality : n, INCORPOREITY
incorporealy : ad, 
incorporeity : n, 실체가 없음, 무형, 비물질성, 무형적 존재
incorrect : a, 부정확한, 타당치 못한, 관례상어긋난(행위등)
incorrectly : ad, 
incorrectness : n, 
incorrigibility : n, 고칠수 없음, 선도(개선)할수 없는 상태
incorrigible : a, 교정(선도)할 수 없는, 건지기 어려운, 순댈수 없는, 제멋대로 구는, 고쳐지지 않는(버릇등), 선도(구제할수)없는 사람
incorrigibly : ad, 
incorrupt : a, 타락하지 않은, 매수할수 없는, 청렴한, (언어가)순정한, (사본등이)잘못이 없는
incorrupted : a, 
incorruptibilty : n, 부패하지(매수되지)않음, 청렴, 결백
incorruptible : a, 부패하지않는, 불후의, 매수되지 않는, 청렴결백한
incorruptibly : ad, 
incorruption : n, 부패하지 않음, 청렴, 결백(opp.corruption)
incorruptly : ad, 
incorruptness : n, 
incoterms : n, (상)인코텀스(무역 용어의 해석에 관한 국제 규칙)
incountry : a, 국내의
incr. : x, increased, increasing
incrassate : (약)증발등으로)액체를 농축하다(직, 동)비후한
increasable : a, 증가 (증대)할수 있는
increase : 늘다, 불어나다, 증가(증대, 증진)하다, 커지다, 강해지다, (유의어increase 수량정도등이 증가(증대)하다, enlarge 크기 양 등이 증가하다, multiply 수량이 배증하듯 늘어나다, 번식하다, 증식하다, (달이)차다, 늘리다, 불리다, (opp.diminish)(영토등을)확장하다, 증강하다, (국제 긴장등을)격화시키다, 증가, 증대, 증진, 증식, 확대, 상승, 번식, 자손(의 번식)증가액, 증대량, 이익, 이자
increaser : n, 늘리는 사람(것), 점대관, (소경관을 대경관에 연결하는)
increasing : a, 증가(증대)하는(opp.decreasing)
increasingly : ad, 점점, 더욱
increasing returns : x, (경)수확, 체증
increate : a, (신 또는 그 속성이)창조되지 않고 본래부터 존재하는
incredibilty : n, 믿어 지지 않음, 신용할수 없음
incredible : a, 믿어지지 않는, 신용할수 없는, 놀라운, 엄청난, 굉장한
incredibleness : n, 
incredibly : ad, 믿을수 없을 만큼, (구)대단히, 매우
incredulity : n, 쉽사리 믿지 않음, 의심 많음, 회의심
incredulous : a, 쉽사리 믿지 않는, 의심많은, 의심하는 듯한
incredulously : ad, 
incredulousness : n, 
increment : n, 증가, 증대, 증진, 이익, 이득, 증가량, 증액, (경)땅값 등의 자연불로증액, (수)증분
incremental : a, 
incremental computer : x, (전산)증분계산기
incremental recorder : x, (전산)증분 리코더
increscent : a, 증대하는(특히)달이 점점차는, 상현의opp.decrescent)
incretion : n, (생리)내분비(물), 내분비(작용)
incriminate : vt, 고발하다, (남에게)죄를 씌우다, 유죄를 증명하다, 죄에빠뜨리다, ..을 원인으로 돌리다
incrimination : n, 죄를 씌움:유죄를 증명하는 것
incriminator : n, 
incriminatory : a, 유죄를 증명하는, 죄에 빠뜨리는
incroach : =ENCROACH 
incross : n.vt, 동종 근친 번식에 의한, 식물(동물), 동종(근친)번식(교배시키다)
incrowd : n, 내부 사정이나, 유행을 잘아는 사람, 배타적인 그룹, 한동아리
incrust : vt, 외피로 덮다, 겉장식을 하다, 보석을 박다, 외피를 형성하다
incrustation : n, 외피로 덮음, 피각, 겉껍질, (습관, 사고등의)껍질, 버케, 딱지, 상감, 겉치장
incubate : vt, vi, 알을 품다, 알을 까다, 숙고하다, 궁리하다, 생각해내다, (세균)등을배양하다, 조산아등을 보육기에 넣어 기르다, 알을 품다, 둥우리에 들다, 알이 깨다, (병리)병이 잠복하다, (생각이)구체화하다
incubation : n, 알을 품음, 부화, 부화기간, 기도, 계획, (병리)잠복, 잠복기
incubational : a, 
incubative : a, 부화의(병리)잠복(기)의
incubator : n, 부화기, 미숙아 보육기, 세균 배양기, 알을 품는새, 계획을 꾸미는 사람
incubator facility : x, 고 기술, 새 산업등의 육성, 유치를 위한, 보육적 편익 시설
incubatory : a, INCUBATIVE
incubus : n, (잠자는 여자를 범한다고 하는)몽마, 가위 , 악몽, 압박하는 사람(것)(빛, 시험등)
incudes : n, INCUS의 복수
inculcate : vt, 사실, 사상, 지식, 습관을)되풀이하여 가르치다, 열심히 설득하다, (의 마음에 가르치다)(사상, 감정등을)..에게 주입하다, 심어주다
inculcation : n, 설득함, 터득시킴, 가르쳐줌(of)
inculcator : n, 설득하는 사람, 가르쳐주는사람
inculpable : a, 나무랄데 없는, 죄없는, 결백한
inculpate : vt, 죄를 씌우다, 탓하다, 연루시키다
inculpation : n, 고발, 비난, 연루시킴
inculpatory : a, 죄를 씌우는, 탓으로 돌리는, 연루시키는
incult : a, 거친, 천한, 세련되지 않은, 교양없는, (고)미개간의
incumbency : n, 공직자, 성직자의 임무(임기), 재직기간, 의무, 채무
incumbent : a, n, 기대는, 의지하는(on), 의무로서 지워지는, 현직(재직)의, (시)(암석등이)쑥내밀고 있는(overhanging), (영)성직록, 소유자, 수록, 성직자, 목사, (미)현직(재직)자
incumber : v, =ENCUMBER
incumbrance : n, ENCUMBRANCE
incunable : n, INCUNABULA의 한권
incunabula : n, (서기 1501년 이전의)초기 간행본, 초기여명기, 요람기
incunabular : a, 
incur : vt, (빚을 지다)(손실을)입다, 분노, 비난, 위험을 초래하다
incurability : n, 불치, 교정, 불능
incurable : a, n, 불치의 교정(개량, 선도)불능의, 불치의 환자, 구제 불능자
incurably : ad, 
incuriosity : 호기심이 없음, 무관심
incurious : a, 부주의한, 무관심한, 호기심 없는, 파고들지 않는, 재미없는(uninteresting)
incuriously : ad, 
incurrence : n, (손해등을)입음, (책임, 빚을)짐 초래함
incurrent : a, (물이)흘러드는, (사건이)발생하는
incursion : n, 침입, 습격(invasion)(하천등의)유입
incursive : a, 침입(유입)하는
incurvate : (안으로)굽히다, 만곡시키다, 만곡된, 안으로 굽은
incurvation : n, (안으로)굽음, 만곡
incurve : n, vt, 안으로 굽음, 만곡, 인 커브, 내곡구(opp.outcurve), 안쪽으로 굽히다
incurved : a, 안으로 굽은
incus : n, (중이의)침골(anvil)
incuse : n, 각인을 찍은, (화폐등의)찍어낸 무늬, 각인
Ind : n, (고, 시)INDIA
IND : x, (예)investigational new drug
ind. : x, independence, independent, index, indicated, indicative, indigo, industrial
Ind. : x, India, Indian, Indiana, Indies
indaba : n, (남아프리카 원주민끼리 또는 그들과의)회의, 협의, (구)관심사
indamine : n, (화)인다민(청록색 염료 재료)
indash : a, (자동차의)계기판(dashboard)a, 에 다니는
indebt : vt, ..에게 빚을 지게 하다, ..에게 은혜를 입히다
indebted : a, 부채가 있는, 신세를 진
indebtedness : n, 부채, 신세, 은혜, 부채액
indecency : n, 예절(버릇)없음, 외설, 추잡한 행위(말)
indecent : a, 버릇없는, 점잖지 못한, 꼴불견의, 추잡한, 음란(외설)한
indecent assault : (법)강제외설죄, 
indecent exposure : (법)공개적 외설죄, 
indecently : ad, 
indeciduous : a, (직)잎이 지지 않는, 상록의(evergreen)
indecipherable : a, (암호등이)판독(해독)할수 없는(illegible)
indecision : n, 우유부단
indecisive : a, 결정적이 아닌, 우유부단한, (태도가)미적지근한, (윤곽이)뚜렷하지 않은
indecisively : ad, 엉거주춤하게, 미적지근하게
indecisiveness : n, 
indecl. : x, indeclinable
indeclinable : a, (문법)어미가 변화 하지 않는, 불변화의, 불변화사(particle), (격변화를 하지 않는 말, (대)명사, 형용사 이외의 품사)
indecomposable : a, 분해(분석)할수 없는
indecorous : a, 버릇없는
indecorously : ad, 
indecorousness : n, 
indecorum : n, 버릇없음, 버릇없는행동(impropriety)
indeed : ad, int, (강조)정말로, 실로, 참으로, 실제로, 정말, 대단히, (질문의 답을 강조)정말, 아주, (의 말을 반복하여 공감을 나타내어, 때로, 반어적), (양보)하기는 그래, 과연그래, 설마, (관심, 회의, 분개, 빈정댐, 의문등)
indef' : x, indefinite
indefatigability : n, 끈덕짐, 인내, 참을성
indefatigable : a, 지치지 않는, 질리지 않는, 끈기있는
indefatigably : ad, 
indefeasibility : n, 파기(무효로)할수 없음
indefeasible : a, 파기할수 없는, 무효로 할 수 없는
indefeasibly : ad, 
indefectible : a, 부족(결손)이 없는, 썩지 않는, 결점이 없는
indefensibility : n, 방어(변호)할수 없음
indefensible : a, 막기 어려운, 변호의 여지가 없는, 옹호할수 없는
indefinable : a, 정의하기 어려운, 형용하기 어려운, 막연한(vague)
indefinableness : n, 
indefinably : ad, 
indefinite : a, 명확(분명)하지 않은, 애매한, 막연한, (수량, 크기등이)일정치 않은, 한계가 없는, (특히)(시간, 기한이)정해져 있지 않은, (문법)부정의 
indefinite article : x, (문법)부정관사
indefinite integral : (수)부정적분
indefinitely : ad, 불명확하게, 막연히, 무기한으로
indefiniteness : n, 무한정, 불확정, 부정
indefinite pronoun : x, 문법에서 부정 대명사
indefinite tense : 문법에서 부정, 시제(완료, 계속을 나타내지 않는것)
indehiscenec : n, 
indehiscent : a, (직)(열매가 여물어도)열개하지 않는
indelibility : n, 지울(씻을, 잊을)수 없음
indelible : a, (잉크등)지울(씻을)수없는, (오점, 인상등)잊혀지지 않는
indelibly : ad, 
indelicacy : n, 상스러움, 야비, 버릇없음, 외설, 상스러운언동
indelicate : a, 상스러운, 외설한, 야비한, 버릇없는
indelicately : ad, 
indemnification : n, 보증, 보장, 면책, 배상, 보상, 배상금, 보상물
indemnifier : n, 
indemnify : vt, 보호하다, (법률적으로)보증(보장)하다, 갚다, 배상하다, 
indemnity : n, 보장, 배상, 변상, (형벌의)면책, 사면, 보장이 되는것, 보상금, (전승국이 요구하는)배상금
indemonstrable : a, 증명할수 없는, 자명한
indemonstrably : ad, 
indene : n, (화)인딘(합성수지의 원료)
indent : 톱니모양을 자국을 내다, 톱니모양으로 만들다, 만입시키다, 쑥들어가게 하다, (두 통으로 작성한 계약서등을)톱니모양으로 찢다, (계약서 등을)두통작성하다, (인)새로 시작되는 줄의 첫머리를안으로 약간 넣어 짜다, 9영)두장 잇달린 주문서로 주문하다, (한장은자기가 보관), (영)두장 잇달린 주문서를 발행하다, 톱니 모양, 오목함, 옴폭함, 옴폭한 땅, 두장잇달린 계약서, (영)신청청구, (상)주문서, 구매위탁, 수탁구매품, (해외로부터의)주문, (인)새로 시작되는 줄의 첫머리를)들여짜기
indentation : n, 톱니모양으로 함, 톱니모양, 오목함, 벤자국(notch)(해안선 등의)만입, (인)INDENTION
indented : a, 톱니 모양으로 된, 톱니 모양의, 들쭉날쭉한, 기한부, 도제로들어간
indented mold : x, (건)맞물린 곡면
indention : n, (새줄을)들어짬, 들여 짠 스페이스
indenture : n, vt, (두통으로 만들어서 날인한)계약서, 증서, 도제계약 문서, 새김눈을 붙임, 톱니모양으로 만듦, (고용을)계약서로써 정하다, 기한부 도제로 넣다
independence : n, 독립, 자주, 자립, 독립심, (고)독립해서 지낼 만한 수입
Independence Day : x, (미)독립 기념일(7월4일, the Fourth of July라고도 함)
Independence hall : x, (미) 독립기념관(Philadelphia소재, 독립이 선언된곳)
independency : n, 독립, 독립심, 자주, (기독교)독립 조합 교회주의(Congregationalism)독립국
independent : 독립한, 자주의, 자유의, 독립심이 강한, 자존심이 강한, 마음대로 하는, 일 않고 지낼수 있는(수입)(사람이)자활하는, 남에게 의존하지 않는, 독자적인, (기독교)조합 교회파의, (정)무소속의, 독립당의, (문법)(절이)독립의, 독립한 사람(것), 무소속자(의원), 조합교회파 신도
independent adoption : x, (미)공적인 알선 기관을 통하지 않은 입양
Independent Broadcastind Authority : x, (영)득립 방송 공사(1972년 설립)
independent church : x, (주로 미)(기독교)독립 교회(기성 교파에 속하지 않는)
independent clause : x, (문법)독립절, 주절
independentiste : n, (캐나다)Quebuc주의 독립주의자(cf.PEQUISTE)
independently : ad, 독립하여, 자주적으로, ..와 관계없이
independent school : x, (영) (정부 보조가 없는)사립학교
Independent Television Authority : x, (영)독립 텔레비젼 공사(현재는 Independent Broadcastind authority)
independent variable : x, (수)독립변수
indepth : a, 면밀한, 상세한, 완전한, 철저한, 심층의
indescribability : n, 형언할수 없음
indescribable : a, 형언할 수 없는, 막연한
indescribably : ad, 
indestructibility : n, 파괴할수 없음, 불멸성
indestructible : a, 파괴할 수 없는, 불멸의
indestructibly : ad, 
indeterminable : a, 확정할수 없는, 해결할길 없는, 확인할수 없는
indeterminableness : n, 
indeterminably : ad, 
indeterminacy : n, 불확정(성)
indeterminacy principle : x, UNCERTAINTY PRINCIPLE
indeterminate : a, 불확정한, 부정의, 막연한
indeterminately : ad, 
indeterminateness : n, 
indeterminate sentence : x, (법)부정기형
indetermination : n, 부정, 불확정, 우유부단
indeterminism : n, (철)비결정론, 자유의지론, (일반적으로)불확정, (특히)예측(예견)불능(성)
indeterminist : n, 
index : n, vt, (책등의)색인, 카드식 색인, 지시하는것, (계기등의)눈금, 바늘, 표시, 지침, 지표, 집게손가락, (인)손가락표, (수)지수, (책에)색인을 달다, 색인에 올리다, ..의 지수가 되다, (경)(급여, 이율, 세금등을)물가(지수)에 슬라이드시키다
indexation : 경)전면적 물가 슬라이드제, 지수화방식에 의한 가치 수정
index card : x, 색인카드
index crime : x, (FBI의 연차 보고에 공표되는 중대 범죄
indexed : a, (경)물가지수(생계비지수)로 조정한, 물가 슬라이드방식의
indexed sequential data set : x, (전산)색인 순차 데이타 세트
indexer : n, 색인작성자
index error : x, 지시오차
Index Expurgatorius : x, (천주교) 삭제 부분 지시금서 목록
index finger : x, 집게손가락
index fossil : x, (지질)표준화석
index fund : x, (미)지표채
index futures : x, 주가지수 선물거래
indexical : a, 
indexiless : a, 
indexing : n, INDEXATION
Index Librorum Prohibitorum : n, (천주교)금서 목록(신자가 읽어서는 안되는)
indexlink : vt, (경)(연금, 세금등을 물가에 슬라이드 시키다
index mark : INDEX, 
index number : x, 지수
India : n, 인도(아 대륙)인도(공화국)
India ink : x, 먹(Chinese ink)
Indiaman : n, (사)인도 무역선, (동인도 회사의) 
Indian : a, n, 인도의, 인도제의, 인도사람의, 인도거주 유럽인의, 아메리칸 인디언의 아메리칸 인디언의 말, 인도사람, 인도에 사는 유럽사람, (미)아메리칸 인디언, (속)인디언말, (천)인도인자리
Indiana : n, 인디애나(미국 중부의 주, 수도Indianapolis)
Indian agent : x, (미 캐나다)인디언 관리관
Indianapolis : n, 인디애나 폴리스(Indiana주의 수도)
Indian ballot : x, (미)정당별 후보자 명단이 적힌 투표지(party column ballot이라고도함)(cf. MASSACHUSETTS BALLOT)
Indian club : x, 체조용 곤봉
Indian corn : x, 옥수수
Indian Empire : x, 인도 제국(독립이전의 영령 식민지로서의 인도의 총칭)
Indian file : x, (아메리칸 인디언의 종렬공격 대형에서)일렬 종대(single file)
Indian gift : x, 답례(대가)를 바라고 주는 선물
Indian giver : x, (아메리칸 인디언의 습관에서) 한번 준것을 되찾는 사람, 보답을 바라고 서비스 하는 사람
Indian giving : n, 
Indian hay : x, (미)마리화나(marijuana)
Indian hemp : x, 인도대마, 인도대마로 만드는 마(취)약, 마리하나, (미)개정향풀의 관목
Indianian : x, Indiana주의(사람)(cf.HOOSIER)
Indianiaztion : n, 인도인화 정책
Indian ink : x, INDIA INK
Indianize : vt, (성격, 습관, 외모등을)인도인화하다, (영국인 지배하의 제도를)점차 인도인 지배에 맡기다
Indian meal : x, (주고 영)(체질하지 않은)옥수수가루(corn meal)
Indian mutiny : x, 인도 폭동(1857-59년 Bengal의 Sepoy반란)
Indian National Congress : x, 인도 국민회의(파)(1885년에 결성)
Indian Ocean : x, 인도양
Indian pacific : x, 인디안 퍼시픽(호주의Sydney perth간 대륙 횡단 열차, 3, 961km)
Indian paper : x, 인디언지(얇고 불투명한 인쇄용지, 사전등에 씀
Indian pipe : x, 구상난풀(북미, 아시아산)
Indian print : x, 인도 무늬로 날염한 평직 면직물
Indian proofs : x, 인디언지의 시험인쇄
Indian pudding : x, 옥수수가루로 만든 푸딩
Indian red : x, 누르스름한 적색 안료
Indian rubber : x, 지우개, 탄성고무
Indian sign : x, 마법
Indian silk : x, INDIA SILK
Indian silk : x, 인도 비단
Indian summer : x, 늦가을의 봄날 같은 화창한 날씨, 평온한 만년
Indian Territory : x, (미사)인디언 특별 보호구(인디언 보호를 위해 특설한 준주, 지금의 Oklahoma동부지방, 1907년에 폐지
Indian tobacco : x, (직)로벨리아(북미원산)삼 대마(hemp)
Indian weed : x, 담배
Indian wrestling : x, 인디언씨름(팔씨름, 밀고 당기는 씨름등
Indic : a, n, 인도반도의, (인구어족의)인도어파의, (언)(인구어족의)인도어파
indic. : x, indicating, indicative, indicator
indicant : a, n, 표시(지시)하는 , 지시물, 적응증, 징후
indicate : vt, 가리키다, 지적하다, 지시하다, 나타내다, 보이다, 표시하다(show)(운전자, 차가 방향지시기로)도는 방향을 표시하다, (몸짓등으로)은연중 나타내다, ..의 징조이다, (치)(어떤 치료법을)사용할것을 지적하다, (좌우로 가는)지시를 내다
indicated horsepower : x, 지시(도시)마력, 실마력
indication : n, 지시, 지적, 임시, 표시(의)징후, 계기의 시도, 표시도수, 필요한 조치
indicative : a, n, 지시하는 , 표시하는, 암시하는, (문법)직설법의 (문법)INDICATIVE MOOD
indicatively : ad, (문법)직설법으로
indicator : n, 지시하는 사람(사물), 척도(계기의)시도(신호)표시기, 표지(영)(자동차의)방향지시기, (화)반응 지시약(리트머스 시약등), 압력지시기, 지침, (생능)지표종, (특정 지역의 환경 조건을 나타내는 동식물), (경)경제 지표
indicatory : a, 지시(표시의)indicative)
indices : n, index의복수
indicia : n, (미)(요금 별납 우편물의)증인(우표 소인 대용)표시, 징후
indicium : n, INDICIA
indict : vt, 기소(고발)하다
indictable : a, 기소되어야 할
indictee : n, 피기소자, 피고
indiction : n, (로마 제국의 15년 마다의)재산의 재평가(에 의한 세금)그 15년기
indictional : a, 
indictment : n, 기소(절차)고발, 기소(고발)장
indictor : n, 기소자
indie : n, (미구)(영화, 텔레비전등의)독립 프로덕션, 독립 방송국
Indies : n, pl, 인도제국(인도, 인도지나, 동인도 제도를 총칭하는 옛이름)
indifference : n, 무관심한, 냉담, 개의치 않음, 중립, 무차별, 중요치 않음
indifference curve : x, (경) 무차별곡선
indifferency : x, (고)INDIFERENCE
indifferent : a, 무관심한, 냉담한, 개의치 않는, 치우치지 않는, 공평한, 중립의, 중요치 않은, 관계없는, 아무래도 좋은, 좋지도 나쁘지도 않은, 평범한, 변변치 않은(물)중성의, (종교 또는 정치에) 무관심한 사람
indifferentism : n, 무관심의, (종)신앙 무차별론
indifferentist : n, 
indifferently : ad, 
indigen : n, INDIGENE
indigence : n, 빈곤, 곤궁
indigene : n, 본토박이, 토착민, 원주민(native), (생)원산종
indigenist : n, 현지 우선주의자, 현지인 채용론자
indigenization : n, 현지(기업)우선, 현지인 우선 채용
indigenize : vt, (정부, 기업등을)현지인화하다, ..에 현지인을 우선 채용하다
indigenous : a, 토착의, (그)지역 고유의, 원산의 재래의, 자생의
indigent : a, (문어)궁핍(빈곤)한, (고)..이 없는(부족한), 결합이 있는, 불완전한
indigently : ad, 
indigested : a, 소화 안되는(계획등이)조잡한, 서투른, 어설픈(crude)혼란상태의
indigestibility : n, 소화불량, 이해할수 없음
indigestible : a, 소화 되지 않는, 다루기 힘든, 이해되지 않는, 받아들이기 어려운(학설등), 참을수 없는, 불유쾌한
indigestibly : ad, 
indigestion : n, 소화 불량(증), 위약, (생각의)미숙, 지적 소화불량, 이해부족
indigestive : a, 소화 불량의(에 걸린)(cf.DYSPEPTIC)
indign : (고, 시)가치없는, 수치스러운, 부당한, 어울리지 않는;a, 
indignant : a, 분개한, 성난
indignantly : ad, 분개하여, 분연히
indignation : n, 분, 의분, 분개
indignation meeting : x, 항의집회
indignity : n, 경멸, 모욕, 무례(insult), 모욕적인 대우, 냉대
indigo : n, 인디고(남색 염료)남색 쪽빛, (직)인도쪽
indigo blue : x, (화)인디고 파랑, 청람색
indigoblue : a, 청람색의
indigo bunting : x, 멧새과에 속하는 멋쟁이새의 일종(북미, 중미산, 수컷이 남색)
indigo snake : x, (미)(동)인디고 뱀(미국 남부산의 독 없는 큰 뱀)
indigotic : a, 남빛의 남빛 비슷한
indigotin : n, (화)인디고틴, 청람
indigo white : x, 백람(남을 환원시켜 얻은 무색의 결정분말)
indirect : a, (opp.direct), (길등)똑바르지 않은, 우회하는, (말등)빙둘러대는, 에두른, 간접의, 간접적인, 이차적인, 방계의(secondary), 솔직하지 않은, 정직하지 않은, (문법)간접화법의
indirect aggression : x, (대외)방송전, 선전, 간접침략, 비군사적 공격
indirect cost : x, (경)간접비, 일반비용
indirect discourse : x, (문법)간접화법
indirect fire : x, (군)간접 조준사격
indirection : n, 에두름, 부정직, 사기, 부정수단, 무목적
indirect lighting : x, 간접조명
indirectly : ad, 
indirect narration : x, INDIRECT DISCOURSE
indirectness : n, 간접, 이차성, 우회성
indirect object : x, (문법)간접 목적어
indirect primary : x, (미)간접 예비 선거
indirect speech : x, (영)INDIRECT DISCOURSE
indirect tax : x, 간접세
indiscernible : a, 식별할수 없는, 분간하기 어려운, 잘보이지 않는
indiscernibleness : n, 
indiscernibly : n, 분간하기 어려운 것
indiscipline : n, 규율이 없음, 훈련(자제심)이 결여, 무질서
indiscreet : a, 지각(분별)없는, 경솔한(언동)
indiscreetly : ad, 
indiscreetness : n, 
indiscrete : a, (따로따로)나뉘어져 있지 않은, 밀착한(compact)
indiscretion : n, 무분별, 지각없음, 경솔한 언동, 근신하지 않는 행위, 비밀누설
indiscriminate : a, 무차별의, 가리지 않는, 마구잡이의, 난잡한
indiscriminately : ad, 
indiscrimination : n, 무차별, 무분별, 마구잡이
indiscriminative : a, 무차별의
indiscriminatively : ad, 
indispensability : n, 긴요성, 필요 불가결한일
indispensable : a, n, 없어서는 안되는, 필요 불가결한, 피치못할(의무등), 필요불가결한 사람(것)
indispensably : ad, 반드시
indispose : vt, (문어), , 할마음을 없애다, 싫증나게 하다, 부적당하게 하다, 할수 없게하다, (가벼운)병이 나게 하다
indisposed : a, 기분이 언짢은, 몸이 좀 아픈, 마음이 내키지 않는
indisposition : n, 기분이 언짢음, (가벼운)병, (두통, 감기등)마음이 내키지않음, 싫증, 부적당, 알맞지 않음
indisputability : n, 당연성, 명백함
indisputable : a, 논의의 여지가 없 는, 명백한(확실한)
indisputably : ad, 
indissolubility : n, 비분해(비용해)성, 영구(불변)성
indissoluble : a, 분해(분리, 용해)될수 없는, 확고한, 굳은, 영속적인, 불변의
indissolubly : ad, 
indistinct : a, (형상 기억등이)뚜렷하지 않은, 희미한, 흐릿한
indistinctive : a, 두드러지지 않은, 흐릿한, 특색이 없는, 차별(구별)이 없는
indistinctly : ad, 
indistinctly : ad, 
indistinctness : n, 
indistinguishable : a, 구별(분간)할 수 없는, 인정받지 못하는
indistinguishableness : n, 
indistinguishably : ad, 
indite : vt, (시, 글따위를)짓다, 쓰다(compose)
inditement : n, 
inditer : n, 
indium : n, 인듐(금속 원소 기호 In 번호49)
indium antimonide : x) (화)인듐, 안티몬(화합물 반도체
indiv. : x, 
indivertible : a, 딴데로 돌릴 (전환할)수 없는
individ : x, individual
individual : a, n, (집단의 일원으로서의)개인의, (철)개체, (사물의)한단위, (생)개체, 개개의, 개별의 일개의, 단일의, 개인의, 개인적인, 개인용의, 독특한, 특유의 개성을 발휘한
individualism : n, 개인주의, 이기주의, 개성, 독자성
individualist : n, 개인주의자, 이기주의자(eoist)
individualistic : a, 개인주의적인, 이기주의적인, 개성이 강한
individuality : n, 개성, 개체성, 인격, 개체, 개인, 단일체, (개인적인)특성, 특질
individualization : n, 개별(개성)화, 차별, 구별, 특기
individualize : vt, 개성을 발휘시키다(부여하다), 개별적으로 취급하다, 특기하다, 개인의 기호(개개의 사정에)맞추다
individual medley : 개인 메들리
individualy : ad, 하나하나, 개별적으로, 개인적으로, 개인으로, 낱낱이, 개성(독자성)을 발휘하여
individuate : vt, 낱낱으로 구별을 짓다, 개별(개체)화하다
individuation : n, 개별(개체)화
indivisibility : n, 분할할 수 없음, 나눌수 없는
indivisible : a, n, 분할할 수 없는, 불가분의, 나눌수 없는, 분할할수 없는것, 극미분자, 극소량
indivisibleness : n, 
indivisibly : ad, 
Indo : x, (연결형)인도(사람)의 뜻
Indoaryan : a, n, 인도아리아 사람(의), 인도아리아말(의)
Indochina : n, 인도차이나 반도, 넓은 뜻으로 Vietnam, Cambodia, Laos, Burma, Thailand, Malay를 포함하는 경우와, 옛 프랑스령 인도차이나를 가리키는 경우가 있음
Indochinese : a, n, 인도차이나의, 인도차이나 사람
indocile : a, 교육하기 힘드는, 순종하지 않는, 말을 잘듣지 않는
indocility : n, 가르치기 힘듦, 순종치 않음
indoctrinate : vt, (교의 사상등을)주입하다(imbue), 가르치다
indoctrination : n, (교의등의) 주입, 가르침, 교화
Indoeuropean : a, n, 인도 유럽(인도게르만)어족(의), 인구어족(의)(인도, 서부 아시아, 유럽각국에서 쓰는 언어의 대부분을 포함하는 대어족, 영어도 그 중의 하나)
Indogermanic : n, a, INDOEUROPEAN, 언어학 용어로서는 지금은 쓰지 않음
Indohittite : n, 인도 히타이트 어족
IndoIranian : n, a, 인도 이란어, 인도 이란어의
indole : x, (화)인돌(저온에서 녹는 무색 결정의 화합물, 향료, 시약용)
indoleacetic acid : x, 인돌초산(식물의 성장 호르몬)
indolence : n, 게으름, 나태, 무통
indolent : a, 게으른, 나태한, 빈둥빈둥하는(lazy)무활동의(inactive)무통(성)의
indolentlence : n, 
indolently : ad, 
Indologist : n, 
Indology : n, 인도학
indomitable : a, 굴복하지 않는, 불굴의 지지 않으려고 하는
indomitableness : n, 
indomitably : ad, 
Indonesia : x, 인도네시아 공화국
Indonesian : a, n, 인도네시아 사람, 인도네시아의, 인도내시아 말
indoor : a, 옥내의, 실내의
indoor baseball : x, 실내 야구
indoors : ad, 옥내(실내)에서
indorse : x, =ENDORSE
Indra : n, (힌두교)인타라(우뢰나 비를 주관하는 veda교의 주신, 불교의 제석천에 해당
indraft : n, 끌어 (빨아)들임, (공기, 물의)유입
indraught : n, 
indrawn : x, 들이마신(숨등)내성적인(introsepective)
indubitable : a, 의심할 여지 없는, 확실한
indubitable : ad, 
indubitableness : n, 
induc : x, induction
induce : vt, vi, 권유하다, 설득하여(권하여)..시키다(persuade), 일으키다, 야기하다, 유발하다, (진통분만을)인공적으로 일으키다, (아기를)인공적으로 출산시키다, 귀납하다, (opp.deduce)유도하다, 인공분만하다
induced drag : x, (공)유도항력
inducement : n, 유인, 유도, 유인(유도)하는것, 유인, 자극, 동기, (법)예비진술
inducer : n, induce하는 사람(것), 유도자, 유도물질
inducible : a, 유치(유인, 유도)할수 있는, 귀납할수 있는
induct : vt, 인도하다, (자리에)안내하다(lead), (비결등을)가르치다, (문어)(성직자를)취임시키다, 정식입회시키다, (미)병역에 복무시키다(draft), (전)INDUCE
inductance : n, 인덕턴스
inductee : n, 징집병
inductile : a, 잡아 늘일 수 없는, 유연성이 없는, 유순하지 않은
induction : n, 유도감응, (논)귀납(법)(opp.deduction), (고)전제, 머리말, 서론, (성직)취임식, (미)징병, (진통, 분만의)인공적 유발, INDUCTION COURSE
induction accelerator : x, BETATRON
induction coil : x, 유도코일, 감응 코일
induction course : x, (신입사원등의)연수
induction heating : x, 유도 가열(전자)유도로 전류를 도입하여 가열함
induction motor : x, 유도전등기
inductive : a, 귀납적인(opp. deductive), 유도의, 감응의, (생)(조직에) 반응을 유발하는 
inductively : ad, 
inductivity : n, 
inductometer : n, (전)인덕턴스계
inductor : n, 성직 수여자, (전)유도자, (화)감응 물질, 유도질
indue : x, =ENDUE
indulge : (욕망, 환락 등에)빠지다, 탐닉하다, 마음대로 하게하다, (아이를)버릇없이 가르다(spoil), 기쁘게(즐겁게)하다, (상)지불유예를 주다, (천주교)대사를 베풀다, (욕망, 환락에)빠지다, 탐닉하다, 마음대로 하다, (구)술을 많이 마시다
indulgence : n, 마음대로 하게 함, 너그럽게 봐줌, 응석받음, 관대, 도락, 방자, 방종, 탐닉, 빠짐, 은혜, 지불유예, (천주교)대사, 은사, 대사부, (영사)신앙의 자유
indulgency : n, INDULGENCE
indulgent : a, 멋대로 하게하는, 관대한, 엄하지 않은, 어하는, 응석을 받아주는 부모
indulgently : ad, 
indult : n, (천주교)특전, 특권, 특허
indurate : vt, vi, n, 단단하게 하다, 경화하다, 무감각하게 하다, 익숙하게 하다, 단단해지다, 경화하다, 무감각하게되다, 익숙해지다, 경화된, 무감각한
induration : n, 단단하게 됨, 경화, 경결, 완고
indurative : a, 굳어지는 경화성의 완고한
Indus : n, (인도의) 인더스강(인도 북서부의 강)
indusium : n, (직)포막, 포피, 포막, 포피층
industrial : a, n, 산업(상)의, 공업(상)의, 실업의, 공업용의, 산업(공업)이 고도로 발달한, 산업(공업)에 종사하고 있는, 산업(공업)노동자의, 산업근로자, 생산회사, 생산업자, 공업(산업)제품, 공업주, 산업주
industrial action : x, 노동자측의 쟁의 행위
industrial alcohol : x, 공업용 알코올
industrial archaeology : x, 산업 고고학(산업혁명 초기의 공장, 기계 제품을 연구)
industrial arts : x, (단수취급)(미)(초, 중등 교육, 공업 학교에서 하는)공예기술
industrial bank : x, 기업은행
Industrial Court : x, (영)노동 재판소
industrial democracy : x, 산업민주주의
industrial design : x, 공업 디자인
industrial designer : x, 공업(산업)디자이너
industrial discharge : x, 공장(산업)폐기물
industrial disease : x, (의)직업병
industrial effluent : x, 공장폐수
industrial engineering : 생산(경영, 산업)공학 생산관리
industrial espionage : x, 산업스파이
industrial estate : x, INDUSTRIAL PARK
industrial goods : x, 산업용 제품 생산제
industrialism : n, 산업(공업)주의
industrialist : n, 특히 생산관계의, 대기업가
industrialization : n, 산업(공업)화
industrialize : vt, 산업(공업)화하다
industrial life insurance : x, 노동자 생명보험, 간이 생명보험
industrially : ad, 산업상, 공업상
industrial maintenance : x, 실업자 구제제도
industrial market : x, 산업용품시장, 생산재 시장
industrial microbiology : x, 응용미생물학
industrial music : x, 전자악기의 기계적 음을 강조한 록 음악
industrial park : x, 공업단지
industrial policy : x, 산업정책
industrial pollution : x, 산업공해
industrial psychology : x, 산업심리학
industrial relations : x, 노사관계
Industrial Revolution : x, (18세기 말부터 19세기 초에 걸친) 산업 혁명
industrial robot : x, 산업용 로봇
industrial school : x, 실업학교, 직업 보도 학교
industrial show : x, (연예인에 의한)상품공고쇼
industrial spy : x, 산업스파이
industrial union : x, 산업별 노동조합
industrial waste : x, 공장폐기물
industrious : a, 근면한, 부지런한, 애쓰는(diligent)
industriously : ad, 부지런히, 열심히, 꾸준히
industriousness : n, 
industry : n, 산업, 공업, 제조업, 생산업, 사업, 기업, (집합적)산업계, 경영자측(management), 근면, 열심, 노력, 근로(diligence), (구)(특정 작가, 제목등에 관한)연구 저술, (조직화된)노동, 근로(선사시대의 도구류등의)유물
indwell : vt, vi, 안에 살다(dwell in)내재하다, 깃들다
indweller : n, 
indwelling : a, 내재하다
ine : n, (형용사 어미), ..에 속하는, ..성질의 뜻, 추상명사어미, (염기 및 원소명어미)
inebriant : a, n, 취하게 하는 (것)(intoxicant)
inebriate : vt, a, n, 취하게하다, 취한, 대주가, 술꾼(drunkard)
inebriation : n, 취하게하다, 술취한 상태, 음주벽, 명정
inebriety : n, 취함, 술마시는 버릇, (opp.sobriety)명정
inedibility : n, 식용 부적성
inedible : a, 먹을 수 없는, 식용에 적합치 않은
inedited : a, 미간행의, 미편집의
ineducable : a, (정신, 장애등으로)교육할수 없는
ineffability : n, 
ineffable : a, 말로 표현할 수 없는, 말해서는 안될 만큼)신성한
ineffably : ad, 
ineffaceable : a, 지울 수 없는, 가실수 없는
ineffaceably : ad, 
ineffective : a, 무효의, 효과 없는, 무능한, 무력한, 효과적인 아닌, 쓸모없는(useless)
ineffectively : ad, 
ineffectiveness : n, 
ineffectual : a, 효과 없는, 쓸데없는, 무력한
ineffectuality : n, 무효, 무익, 무력
ineffectually : ad, 효과 없는
inefficacious : a, 효력(효험)이 없는
inefficaciously : ad, 효력 없는
inefficaciousness : n, 
inefficacy : n, 무효과, 무효력
inefficiency : n, 비능률, 무능, 무효력, 비능률적인것
inefficient : a, (사람이)무능한, (사물이)효력(효과)이 없는, (기계등이)비능률적인, 낭비가 많은
inefficiently : ad, 
inelastic : a, 탄력(탄성)이 없음, 적응(융통성)이 없는(rigid) 
inelasticity : n, 탄력(탄성)이 없음, 부적응성, 비융통성 
inelegance : n, 
inelegancy : n, 우아하지 못함, 멋없음, 몰취미, 무뚝뚝함, 아취 없는 행위(말, 문체)
inelegant : a, 우아하지못한, 아취 없는, 멋적은, 세련되지 못한(unrefined)
inelegantly : ad, 
ineligibility : n, 선출될 자격이 없음, 무자격, 부적격, 부적임
ineligible : a, n, (선출될) 자격이 없는, 부적당한, 부적격의(unqualified), 부적격자
ineligibleness : n, 
ineligibly : ad, 
ineloquence : n, 
ineloquent : a, 능변이 아닌, 눌변의
ineloquently : ad, 
ineluctability : n, 피할수 없음, 필연성
ineluctable : a, 불가항력의, 불가피한, 면치못할
ineluctably : ad, 
inept : a, 바보 같은, 부적당한, 부적절한, 적성이 없는, 서투른, 터무니없는, 어리석은
ineptitude : n, 어리석음, 부적당, 어리석은 행위(말)
ineptness : n, 
inequable : a, 불균등한, 고르지 못한
inequality : n, 같지 않음, 고르지 못함, 부동, 두등, 사회적(경제적), 불평등, 불공평, (표면이)거침, 고저, 기복, 부적당, 균차, 부등식
inequilateral : a, 부등변의
inequitable : a, 불공평한, 불공정한(unjust)
inequitableness : n, 
inequitably : ad, 
inequity : n, 불공평(unfairness), 불공정, 불공평한 사례
ineradicable : a, 근절할수 없는, 뿌리 깊은
ineradicably : ad, 
inerrability : n, 
inerrable : a, 틀리지 않는
inerrably : ad, 
inerrance : n, 
inerrant : a, 잘못(틀림)이 없는
inerrantis : n, 성서전면, 신봉자(성서 내용은 다옳다고 믿는 사람)
inerratic : a, 방황하지 않는, 탈선하지 않는, (항성등이)부동의
inert : a, (물)자동력이 없는, 활성이 없는, 화학작용을 일으키지 않는, 둔한, 원만한, 활발하지 못한, 느린(inactive)
inertia : n, (물)관성, 타성, 타력, 불활발, 굼뚬, 지둔, 무력증, 완만
inertia effect : x, 관성효과
inertia guidance : x, (미사일, 항공기등의)관성유도
inertial : a, 활발치 못한, 타력의
inertia navigation : x, 관성항법
inertia navigation system : x, 관성 항법 시스템
inertia platform : x, 관성 유도장치의 설치대
inertia reel belt(seat belt) : x, (자동차등의)자동 조절식 좌석벨트
inertia selling : x, 타성 판매 강매 (멋대로 상품을 보내놓고 반품하지 않으면 대금을 청구하는 방식
inertly : ad, 
inertness : n, 
inescapable : a, 피할수 없는, 면할수 없는, 불가피한(inevitable)
inesse : ad, a, 실재하여, 실재의(actual)
inessential : a, n, 긴요(중요)하지 않은, 없어도 무방한, 없어도 되는 것, 불필요한것
inestimable : a, 헤아릴수 없는, 더할나위 없이 귀한, 평가할 수 없는, (가치 등)측량할 수 없을 정도의
inestimably : ad, 헤아릴 수 없이, 더할나위 없이
inevitability : n, 피할 수 없음, 불가피함, 필연성
inevitable : a, 피할 수 없는, 면하기 어려운, 부득이한, 필연적인, 당연한, (인물, 묘사, 이야기 줄거리가)꼭들어 맞는, 변함없는, 어김없는, 판에 박은, 고정적인, 피할길 없는, 어쩔수 없는 운명
inevitably : ad, 
inexact : a, 부정확한, 엄밀하지 못한
inexactitude : n, 부정확한(inexactness)
inexactly : ad, 부정확하게, 엄밀하지 못하게
inexactness : n, 
inexcitable : a, 냉정한, (cool)쉽사리 흥분하지 않는, 자극에 동하지 않는, 자극을 느끼지 않는
inexcusable : a, 변명할 도리가 없는, 용서할수 없는
inexcusably : ad, 
inexcutabl : a, 실행(수행)하기 어려운, 불가능한
inexcution : n, (명령, 법률의)불이행
inexertion : n, 게으름, 노력부족, 불활발
inexhaustibility : n, 무진장, 지칠줄 모름, 끄떡없음, 굳셈
inexhaustible : a, 무진장한(very abundant)a, , 지칠줄 모르는, 아귀센
inexhaustibly : ad, 
inexhaustive : a, (고)INEXHAUSTIBLE최선을 다하지 않은, 철저하지 않은
inexistent : a, 존재하지 않는
inexorability : n, 사정없음, 용서없음, 무정, 냉혹
inexorable : a, 냉혹(무정)한, 용성없는(relentless)굽힐수없는, 움직일수 없는
inexorableness : n, 
inexorably : ad, 
inexpediency : n, 불편, 부적당한, 부적절
inexpedient : a, 불편한, 부적당한, 적절하지 않은
inexpensive : a, 비용이 많이 들지 않는, (별로)비싸지 않은, 헐한, cheap처럼 싸구려의 느낌이 없음
inexpensively : ad, 
inexpensiveness : n, 
inexperience : n, 무경험, 미숙, 서투름, 세상을 모름
inexperienced : a, 경험이 없는 서투름
inexpert : a, 미숙한, 서투른, 솜씨없는
inexpertly : ad, 서투르게
inexpertness : n, 
inexpiable : a, 속죄할 길 없는, 죄많은, (분노등)달랠길 없는, 앙심먹은, 집념깊은(적의등)
inexpiably : ad, 
inexplainable : a, INEXPLICABLE
inexplicability : n, 불가해, 설명할수 없음
inexplicable : a, 설명(해석)할 수 없는, 불가해한
inexplicableness : n, 
inexplicably : ad, 불가해하게, (문장 전체를 수식하여)설명할수 없는, 일이지만, 알수없는 일이지만
inexplicit : a, (말이)명료하지 않은, 알쏭달쏭한, 명확하게 말하지 않는, 말이 모호한(cf.IMPLICIT)a, 
inexplicitly : ad, 
inexplosive : a, 불폭발성의 , 폭발하지 않는
inexpressible : a, n, 말로 표현할 수 없는, 이루 말할수없는(indescribable), (익살)양복바지
inexpressibly : ad, 말하기 어렵게, 표현하기 어려울 정도로, 대단히
inexpressive : a, 무표정한, 말없는, 뚱한, (고)INEXPRESSIBLE
inexpressively : ad, 
inexpressiveness : n, 
inexpugnable : a, (문어)정복(격파)하기 어려운, 난공불락의, 논파할수 없는(주장)등, 확고부동한
inexpugnably : ad, 
inextensible : a, 넓힐수없는, 확장할수 없는, 늘어지지 않는
inextension : n, 불확장
inextenso : ad, 상세히, 생략하지 않고
inextinguishable : a, (소멸(말살)할수 없는, (불등)끌(지울)수 없는, (감정등)억제할수 없는, 억제할 수 없는
inextirpable : a, 근절할수 없는
inextirpableness : n, 
inextremis : ad, 임종시에, 죽음에 이르러, 극단적 상황에서
inextricable : a, 풀수 없는, 해결 할 수 없는, 뒤얽힌, 풀리지 않는, 탈출할수 없는(opp.extricable)
inextricably : ad, 
Inez, Ines : n, 여자이름(Agnes)별칭
inf : n, (수)최대하한
INF : x, intermediate rande nuclear forces 중거리 핵전력
inf, : x, infantry, inferiorinfinitive, infirmary, information
infall : n, 침입, 침략, 합류점, 유입
infallibilism : n, (천주교)교황 무류설
infallibility : n, 오류절무, 절대확실, (천주교)(교황, 공의회의)무류성
infallible : a, 전혀 오류가 없는, 반드시 일어나는, 틀리는 일이 없는, 절대적으로 확실한
infallibleness : n, 절대 확실한 사람(것)
infallibly : ad, 
infamous : a, 수치스런, 불명예스러운, 파렴치한, 악명높은, 악랄한, 악독한(나쁘기로)이름난, 지긋지긋한, 지독한, 아주나쁜, (법)파렴치죄로)공민권을 박탈당한
infamously : ad, 악명높게, 불명예스럽게도
infamy : n, 악평, 오명, 불명예, 추행, 비행, 파렴치한 행위, (법)파렴치죄에 의한 공민권상실
infancy : n, 유소, 유년, 유년시대, (집합적), 유아(infants), 초기, 요람기, (법)미성년에, 초기에
infant : n, a, 유아, 유아, 소아(7세미만), (법)미성년자(미 21세 미만, 영에서는 18세미만), 유아의, 소아의 , 유아용, 유치한, 초기의, (법)미성년의
infant(infantile) prodigy : x, (천재아, 신동)
infant(s') school : x, (영)유아학교 국민학교, 유아부(보통 5-7세의 의무 교육학교)cf.KINDERGARTEN, PRIMARY SCHOOL
infanta : n, 왕녀, 공주
infante : n, 왕자, 대군(왕세자를 제외한)
infanticidal : a, 유아살해의
infanticide : n, 유아(영아) 살해(범죄), 유아(영아)살해자
infantile : a, 유아(기)의, 소아의, 어린아이 같은, 유치한, 초보의, 천진난만한
infantile paralysis : x, 소아마비(지금은poliomyelitis라고함
infantilism : n, 유치증(성인이면서도 체구지능이 어린아이 같음)어린아이 같은 언행
infantility : n, 유아성
infantine : a, INFANTILE
infant mortality : x, (1세미만의)유아사망률
infantry : n, 보병, 보병과, 보병연대
infantryman : n, (개개의) 보병
infarct : n, (병리)경색
infarction : n, (병리)경색, 경색형성
infatuate : vt, 얼빠지게 만들다, (사람을)호리다, 열중하게 하다
infatuated : a, 얼빠진, 미친, 홀린, 
infatuatedly : ad, 
infatuation : n, 정신을 잃게, 열중케 함, 흘림, 심취, 열중(심취)하게 하는것
infauna : n, (성)매재동물(해양호소하천 등의 수역의 바닥 흙속에서 사는 동물의 총칭)
infeasibility : n, 실행불가능성
infeasible : a, 실행 불가능한
infect : vt, vi, (공기물, 등에)병독(병균)을 혼입하다, 오염하다, 병을 전염시키다, 감염시키다, (나쁜버릇에)물들이다, 젖게하다, 영향을 미치다(affect), 감화하다
infection : n, (병독의)공기전염, 감염(cf.CONTAFION)(도덕적으로)나쁜 감화(영향), 오염(CONTAMINATION)전염병, 감염증
infectionless : a, 굴곡이 없는, 굴절이 없는, 역양이 없는
infection point : x, 변곡점
infectious : a, 전염성의, 전염병의, 전염되기 쉬운(catching), 옮기(전달되기)쉬운
infectious hopatitis : (의)전염성(유행성)간염, 
infectiously : ad, 
infectious mononucleosis : x, 전염성 단핵세포층
infectiousness : n, 전염력(성)
infective : a, INFECTIOUS
infective : a, 굴곡하는(음이) 억양이 있는, 어미 변화를 하는
infecund : a, 열매를 맺지 않는, 불임의 불모의
infecundity : n, 불임, 불모
infelicitous : a, 불행(불운)한, 부적절한(표현행위)
infelicitously : ad, 
infelicity : n, 불행, 불운, 부적절, 부적절한 표현
infelt : a, (고)마음으로 느낀 마음내부에서 경험된
infer : vi, vt, v, 추론하다, 추단(추량)하다, 추측하다, (결론으로서)의미하다, 암시하다, 추론(추찰)하다, (결론으로서)의미(암시)하다(imply)
inferable : a, 추단, 추론추리할 수 있는
inference : n, 추론, 추정, 결론, 추리, 함축(implication)
inference engine : x, (전산)추론기구
inferential : a, 추리(추론)(상)의 추단한
inferentialy : ad, 
inferior : a, n, 하위의, 아래쪽의, 하등의 , 열등한, 하급의, ..보다 못한 이류의, (인)밑에붙이는, 꽃받침, (자방)이하위의, 밑에 붙은, 손아랫사람, 하급자, 열등한 사람(물건), 후배, 아래에 붙는 문자(숫자)하급품
inferior court : x, 하급법원
inferior figure : x, (인)밑에 붙는 숫자
inferior goods : x, 하급(열등)재 (소득이 늘면 소비량이 주는 저급 대용품)
inferiority : n, 하위, 열세, 조악, 열등, 하급
inferiority complex : x, 열등 콤플렉스, 열등감, 열등의식, 주눅, 왜곡된 마음
inferiorly : ad, 
inferior planet : x, (천)내혹성(지구와 태양 사이에 있는, 수성, 금성)
infernal : a, 지옥의, 명부의, 악마와 같은, 비인간적인, 악독한(hellish), 지독한, 지긋지긋한
infernality : n, 극악무도
infernally : ad, 악마처럼, 지독하게
inferno : n, 지옥(hell), 지옥같은 광경
inferrer : n, 추론자, 추측자
inferrible : a, INFERABLE
infertile : a, 메마른, 불모의(sterile), 불임의 생식(번식)력이 없는
infertility : n, 불모, 불임
infertilization : n, 생화확적 피임
infest : vt, (쥐, 해충, 해적 병등이)횡행하다, 만연하다, 몰려들다, 꾀다, 창궐하다
infestation : n, 침략, 횡행만연
infeudation : n, 봉토수여, 봉건적 군신관계
infidel : n, a, (고)불신자, (사)이교도, 이단자(일찍이 그리스도교도와 이슬람교도가 서로를 부르던 말)신앙심이 없는 사람(unbelieving) 이교도의, 이단자의
infidelity : n, 신앙심이 없음, 무신앙(그리스도교, 이슬람교를 밑지 않음), 불신, 배신, 부정, 불의, 간통, 배신행위
infield : n, 내야, 내야수, 농가 주변(부근)의 밭, 경작지
infielder : n, 내야수
infield fly : x, 내야 플라이
infield hit : x, 내야 안타
infield out : x, 내야 땅볼 아웃
infighter : n, 접근전에 능한 선수
infighting : n, 접근전, 내부 항쟁, 내분, 난투
infill : (비어있는 장소를 )메우다, 막다, 채우다 
infilling : n, 내부 건재(기둥, 지붕 이외의 건재)충전재, 공간, 메우기, 기존 건물사이의 공간에 건물 짓기
infilltrate : vi, vt, n, 침투(침윤)시키다, 스며들게하다, 스며들다, 잠입하다, 스며드는(침입하는)침윤물, 침윤병소
infilltration : n, 침투, 침입, 잠입, 침윤
infilltration gallery : x, 집수암거
infilltrative : a, 스며드는, 침투(침윤)하는, 침윤성의
infilltrator : n, 
infin, : x, infinitive
infinite : a, n, 무한한, 무수한, 막대한, 끝없는(boundless), 무한의, 부정형의, 부정의, 완전무결한, 무한한 공간(시간), 무한대, 무한량
infinitely : ad, 무한히, 대단히, 몹시, 지독히, (비교급에서)훨씬
infiniteness : n, 
infinitesimal : a, n, 미소한, 극미한, 무한소의, 미분의, 극소량, 무한소
infinitesimal calculus : x, 미적분
infinitesimaly : ad, 
infinitival : a, INFINITIVE의
infinitive : n, a, 부정사, 부정사의
infinitively : ad, 
infinitude : n, 무수한, 무한, 무궁, 무한한 수량(넓이)
infinity : n, INFINITUDE, 무한히, 무한대
infinity microphone(transmitter, bug) : x, 고성능 전화 도청기(스파이용)
infirm : a, 약한(weak), 가냘픈, 연약한, 박약한, 결단력없는, 우유부단한
infirmary : n, 진료소, 병원, (학교, 공장등의)의무실, 치료소
infirmatory : a, (논거등을)약화시키는, 무효로 하는
infirmity : n, 허약, 병약, 연약, 질병, 질환, 결점, 약점
infirmly : ad, 
infirmness : n, 
infix : vt, n, 고정시키다, 꽂아넣다, 끼워넣다, 스며들게 하다, 명심시키다, (문어)(삽입사를)삽입하다, 삽입사
infl. : x, influence
inflagrantedelicto : ad, 현행범으로, 범죄를 저지르고 있는 중에
inflame : vt, vi, 불태우다, (사람을)노하게 하다, 흥분시키다, (감정, 식욕등을)과도히 자극하다, (흥분등으로)(얼굴등이)새빨개지게 하다, 염증을 일으키다, (눈을)충혈시키다, 불타오르다, 격노(흥분)하다, 빨갛게 부어오르다, 염증이 생기다
inflamed : a, 염증을 일으킨, 충혈한, 흥분한, 얼굴이 빨개진
inflamer : n, 
inflammability : n, 연소성, 인화성, 흥분성
inflammable : a, n, 불타기 쉬운, 가연성의, 인화성의, (감정, 성질이)열화같이 격분하기 쉬운, 흥분하기 쉬운, 가연물, 인화물질
inflammableness : n, 
inflammably : ad, 
inflammation : n, 점화, 연소, 염증, 격노, 흥분
inflammatorily : ad, 
inflammatory : a, 염증을 일으키는, 염증성의, 격앙시키는, 선동적인
inflatable : a, (공기 등으로)부풀게 할수 있는
inflate : vt, vi, (공기, 가스 등으로) 부풀게하다, (물가등을)올리다.(통화를)팽창시키다, (종종수동형)득의 양양하게 하다, 뽐내다, 우쭐거리다, 과장하다, 팽창하다, 부풀다, 인플레가 일어나다
inflated : a, (공기, 기체로)부풀은, 팽창한, (사람이)우쭐해진, (문체 말투가)과장된, (물가가)폭등한, 크게 팽창한
inflatee, inflator : n, 
inflation : n, 팽창, 통화 팽창, 인플레이션, (물가등의) 폭등, 물가상승, 자만심, 과장
inflation accounting : x, 인플레이션 회계, 화폐 가치 변동회계
inflational languge : x, 굴절(언)어
inflation allowance : x, 인플레이션 수당
inflationary : a, 인플레이의 통화팽창의), 인플레이션을 일으키는
inflationary gap : x, 인풀레이션 갭(총수요가 총공급을 웃돌았을 때의 차)
inflationary hedge : x, 인플레이션헤지(화폐가치 하락에 따르는 손실을 막기위해 부동산, 귀금속, 주식등을 사는일)
inflationary spiral : x, 악성 인플레이션
inflationism : n, 인플레(정책), 통화 팽창론
inflationist : n, 통화팽창론자
inflationproof : a, 인플레이션 방위 수단으로서의, 인플레이션 헤지를 위한
inflect : vt, vi, 안으로 구부리다, 굴곡시키다(bend)(문법)어미를 변화시키다, 활용시키다, (음성을)조절하다, 억양을 붙이다(moulate)반음 높이다(낮추다), 낱낱이 활용하다
inflected : a, 말이 변화된(언어가)굴절되는
inflection : n, 굴곡굽음, 음성의 조절, 억양, 굴절, 어형변화
inflectional : 굴곡의, 굴절, (활용어미)변화의, 억양의
inflexed : a, 축의 , (안)쪽으로 구부러진
inflexibility : n, 굽힐 수없음, 불요성, 불요, 불굴, 강직, 단호한 태도 불가변성
inflexible : a, 확고한, 꿋꿋한, 불굴의 강직한, 완고한, 굽힐수 없는, 고칠수 없는, 굽지 않은
inflexibly : ad, 
inflexion : n, =INFLECTION
inflict : vi, (구타, 상처등을)가하다, (입히다), (벌등을)주다, 과하다, (싫은것을) 짊어지우다, 과하다, 괴롭히다
infliction : n, (고통, 벌, 타격을)가함(줌), 형벌, 고통, 시련, 폐
inflictive : a, 보태는, 과하는, 형벌의, 고통의, 곤란한
inflictor : n, 
inflight : a, 비행중의, 기상의
inflight refueling : x, 공중급유
inflorescence : n, 꽃이핌, 개화, 꽃차례, 화서, (집합적), 꽃
inflorescent : a, 꽃이핀
inflow : n, 유입(influx)(물), 유일량
influence : 영향, 감화력, 작용, 세력, 권세, 명망, 위력, 설득력, 영향을 끼치는 사람(사물), 세력가, 유력자, (전)유도, 감응(induction), (천체로부터 발생하는 흐름이 사람의 성격, 운명에 미친하고 하는)감응력, 영향을 끼치다, .감화를 주다, 좌우하다, 움직이다, (완곡)뇌물을바치다, 매수하다(bribe)(미구)(음료수에)술을 타다
influenceable : a, 
influencebuying : n, 매수(영향력을 돈으로 사는 일)
influence peddler : x, 지위 이용자, 지위를 이용한 오직자
influence peddling : x, 지위의 남용, 지위를 이용한 부정행위
influencer : n, 
influent : a, 유입하는, 흘러들어가는(flowing in)지류, 유입(물), (생)영향종
influential : a, 영향력이 있는, 동기가 되는, 세력있는, 유력한(powerful)
influentially : ad, ad, 세력을 부려서, 위세를 떨쳐
influenza : n, 인플루엔자, 유행성 감기
influx : n, 유입, 밀어닥침, 쇄도, (본류와지류가 합치는)유입점, 강어귀(estuary)
info : n, =INFORMATION, 정보
infold : vt, 싸다, 안다, 포옹하다, 접다, 주름잡다
inform : a, (운동 선수등이)컨디션이 좋은, 호조의, (분명한)모양이 없는, 보기흉한, (괴물등)
inform : vt, vi, 알리다, 알려주다, 통지하다, 기별하다, 채우다, 불어넣다(fill)..에 정통하다, 알다, 분별하다(learn), 밀고하다, 고발하다(against)
inform : n, (문법)ing형
informal : a, 비공식의, 약식의, 형식(격식)을 따지지 않는, 탁 터넣은, 평상복의, (말등이)회화체(구어체)의
informal group : x, (사회)비공식적 집단(관청공장등에서의)
informality : n, 비공식, 약식, 약식행위
informally : ad, 비공식으로, 약식으로, 형식에 구애되지 않고, (구어)로
informal vote : x, (오스, 뉴질)무효투표(용지)
informania : n, 정보광
informant : n, 통지자, 보고자, 정보제공자, 밀고자(언)피조사자, (그 지방 고유의 문화, 언어등의), 정보(자료)제공자
informapauperis : ad, (법)소송 비용을 면제받는)극빈자로서
INFORMART : n, 인포마트(Texas주 Dallas에 있는 세계최초의 정보산업 전시장)
informatics : n, pl, INFORMATION SCIENCE
information : n, 통지, 정보, 통보, 보고, 보도, 교시, 자료, 지식, 견문, 접시(안내처)범죄, 신고, 고발(charge)고소, 밀고
informational : a, 정보의, 정보를 제공하는
informational picketing : x, (미)홍보피케팅(요구 불만등을 호소하는 피켓시위)
information art : x, 정보예술(정보의 전달, 표현에 관한예술)
information bank : x, (전산)데이타 뱅크(정보 데이타 라이브러리의 집합체)
information bureau : x, 정보부(국)
information desk(booth) : x, 안내소
information engineer : x, 정보공학 전문가
information engineering : x, 정보공학
information explosion : x, 정보폭발(정보량의 폭발적 증가 현상)
information gap : x, 정보 격차(정보기술의 국제적갭)
information girl : x, 안내양, 여자 접수계원
information industry : x, 정보산업
informationintensive society : x, 정보(화)사회
information marketplace : x, 정보시장
Information Network System : x, 고도 정보 통신 시스템
information office : x, (역등의)안내소
information officer : x, 공보관, 공보장교
information pollution : x, (정보 공해(방송 출판등으로 인한 정보 과다)
information processing : x, (컴퓨터 등에 의한)정보처리
information provider : x, 정보 제공(업)자
information retrieval : x, (전산)정보 검색
information revolution : x, 정보혁명
information science : x, 정보과학
information system : x, 정보시스템(특히)데이타처리 시스템
information theory : n, 정보이론
information utility : x, 정보의 공공시설, 정보공사
information worker : x, 정보노동자
informative : a, 정보를 제공하는, 소식을 알리는, 지식을 주는, 교육적인, 유익한
informatively : ad, 
informativeness : n, 
informed : a, 지식(학식)이 있는, 견문이 넓은, 소식통의, 지식의 필요한
informed consent : x, (의)고지에 입각한 동의(승낙)수술의학 실험에 대한 환자의)
informedly : ad, 
informer : n, 통지자, (특히 범죄의)밀고자, 고발자, 스파이, 정보제공자
informercial : n, (소비자의 이익을 위한)정보 광고
informing : a, 유익한, 교육적인
informingly : ad, 
infra : pref, 아래에, 아래쪽에(below), ..안에의 뜻
infract : vt, (법률등을)어기다, 위반하다
infraction : n, 위반, 위반행위, (의)불완전 골절
infractor : n, 
infradig : a, INFRADIGNITATEM
infradignitatem : a, (익살)품격을 떨어뜨리는, 체면에 관계되는
infralapsarian : n, (신학)(칼뱅파의)후정론자
infrangible : a, 파괴할수 없는, 침범해서는 안되는, 배반해서는 안되는
infrangibleness : n, 
infrangibly : ad, 
infrared : a, n, (물)적외선, 적외선의, 적외선에 민감한
infrared detector : x, 적외선 검파기
infrared film : x, 적외선 필름
infrared radiation(rays) : x, 적외선
infrared spectrometer : x, 적외 분광계
infrasonic : a, (가청 이하의)초저주파(음)의
infrasound : n, (물)초 저주파 불가청음
infrastructure : n, (단체등의)하부 조직(구조), (사회의)기본적 시설, NATO의 항구적 기지(군사시설)
infrequence : n, 드묾
infrequency : n, 드묾
infrequent : a, 드문, 좀처럼 없는, 보통이 아닌, 진기한
infrequently : ad, 드물게, 어쩌다
infression : n, 인플레하의 불황
infringe : vt, vi, (법등을)어기다, 위반하다, 범하다, 침해하다
infringement : n, (법규)위반, 위배, (특허권, 판권등의)침해 위반(침해)행위
infructuous : a, 열매를 맺지 않는, 볼모의, 무익한(useless)
infula : n, 주교관뒤의 드림, (의식용)소매 없는 외의
infuriate : vt, 격노하게하다, 격분시키다
infuriately : ad, 
infuriation : n, 
infuse : vt, vi, 붓다, 부어넣다, (사상 등을)주입하다(inspire)불어넣다, 고취하다, (약차등을)우리다, (차등이)우러나다
infuser : n, 주입자, 주입기, 우러내는 기구, 고취자
infusibility : n, 
infusible : a, 주입할수 있는, 용해되지 않는, 불용해성의
infusibleness : n, 
infusion : n, 주입, 불어넣음, 고취, 주입물, 혼합물, 우려낸물, 우려냄(정맥에의)주입, 주입액
Infusoria : n, pl, (동)적충류(원생동물Protozoa의 한강)
infusorian : a, n, 적충류의(동물)
ing : suf, 현재분사를 만듦, 동명사를 만듦
ingather : vt, vi, (수확물등을)거둬들이다, 모으다, 수확하다, 모이다
ingathering : n, 거둬들임, 수확, 집합, 집회
ingeminate : vt, 되풀이하다, 반복하다
ingemination : n, 
ingenerate : (고)자생의, 자존의, 발생시키다, 타고난, 생득의(innate)
ingenious : a, (재간(재치)있는, 영리한, 교묘한, 정교한, 독창적인, 창의력이 있는
ingeniously : ad, 
ingeniousness : n, INGENUITY
ingenue : n, 천진난만한(순진)한 소녀, 그역을하는  여배우)
ingenuity : n, 발명의재주, 고안력, 독창력, 정교, 교묘함
ingenuous : a, 솔직담백한, 소박한(frank), 천진난만한, 순진한, 꾸밈없는(artless)
ingenuously : ad, 
ingenuousness : n, 
ingest : vt, (음식물을)섭취하다
ingesta : n, pl, 섭취물
ingestion : n, 음식물 섭취
ingestive : a, 음식섭취의
ingle : n, 화롯불, 화로
inglenook : n, =CHIMNEYCORNER
inglorious : a, (문어)불명예스러운, 면목없는, 창피한, 수치스러운(dishonorable), 이름도없는, 무명의
ingloriously : ad, 
ingloriousness : n, 
ingoal : n, (럭비)본진
ingoing : a, n, 들어오는, 들어옴, 새로 집터를 빌린 사람이 치르는)정착물건비
ingot : n, vt, 주괴, 잉곳(특히)금은괴, (지금을)금괴로 만들다
ingraft : vt, ENGRAFT
ingrain : vt, a, n, (감으로 짜기 전에)섬유, 실에 물들인, 깊이 베어든, 뿌리깊은, 섬유에 물들인, (미)물들인 실로 짠 양탄자, (습관, 생각등)스며(배어)들게하다
ingrained : a, 깊이 베어든, 뿌리깊은, 타고난, 바탕부터의, 철저한, 물이든
Ingram : n, 남자이름
ingrate : n, a, 은혜를 모르는, 은혜를 모르는 사람, 배은 망덕한 사람
ingratiate : vt, 환심을 사다, ..의 비위를 맞추다
ingratiating : a, 알랑거리는, 애교부리는, 매력있는
ingratiatingly : ad, 
ingratiation : n, 
ingratitude : n, 배은 망덕, 망은
ingravescence : n, 악화, 앙진
ingravescent : a, (병이)악화되는, 앙진하는
ingredient : n, (혼합물의) 성분, 합성분, 원료, 재료, 구성요소, 인자
Ingres : n, 앵그르 Jean Auguste Dominique(1780-1867)(프랑스의 신고전파화가)
ingress : n, 들어감(옴), 진입, 입장, 입장권, 입장의 자유, 들어가는 수단, 입구, (천)(식이 일어날때 등의)침입
ingression : n, 들어감, 진입, (생)이입, 내식
ingressive : a, 들어가는, 진입하는, (문법)기동의
Ingrid : n, 여자이름
ingroup : n, (사회)배타적인 소집단, 내집단(opp.autgroup)
ingrowing : a, 안으로 자라는, (특히)발톱이 살속으로 파고드는
ingrown : a, 안쪽으로 성장한, (발톱등이)살로 파고 든, 타고난
ingrowth : n, 안으로 자람
inguinal : a, (해)사타구니(부분)의, 서혜부의
ingulf : vt, =ENGULF
ingurgitate : vt, 탐식하다, 게걸스럽게 마구 들이키다, (소용돌이처럼)빨아들이다(engulf)
inhabit : vt, vi, ...에 살다, 거주(서식)하다, (비유적)..에 존재하다, ..에 깃들다, 살다
inhabitable : a, 살기에 적합한
inhabitancy : n, (특히 특정기간의)거주, 거처
inhabitant : n, (장기 거주의)주민, 거주자, 서식동물
inhabitation : 주거, 주소, 거주, 서식
inhabited : a, 사람이 살고 있는
inhabiter : n, 
inhalant : n, a, 빨아들이는, 들이쉬는, 흡입용의, 흡입기
inhalation : n, 흡입, 흡입제
inhalator : n, 흡입기 장치
inhale : vt, vi, (공기, 가스등을)빨아들이다, 들이쉬다, 담배연기를 폐까지 들이마시다
inhaler : n, 흡입자, 흡입기, 흡입용 마스크, 공기여과기
inharmonic, -ical : a, 조화되지 않은, 불협화의
inharmonious : a, 조화되지 않은, 가락(음)이 어울리지 않는, 불협화의, 원만하지 않은, 불화의
inharmoniously : ad, 
inharmony : n, 부조화, 불협화, 불화
inhaul : n, 끄는 밧줄
inhere : vi, (성질 등이)타고나다, (권리 등이)부여되어 있다, (뜻이)포함되어 있다
inherence : n, 고유의, 타고남, 천부
inherency : n, 
inherent : a, 고유의, 타고난, 본래부터의
inherently : ad, 
inherit : vt, vi, (재산, 권리등을)상속하다, 물려받다, (육체적, 정신적 성질등을)물려받다, 유전하다, 재산을 상속하다, 계승하다
inheritability : n, 상속(계승)할수 있음
inheritable : a, 상속자가 될수있는, 상속시킬수 있는, 유전하는
inheritance : n, (법)가독, 상속, 상속재산, 유산, 물려받은 것, (생)유전질(성), 타고난 재능
inheritor : n, (유산)상속인, 휴계자(heir)
inheritress : n, 
inheritrix : n, INHERITOR의 여성형
inhesion : n, INHERENCE
inhibit : vt, 억제하다, 제지하다, 금하다, 못하게막다, (영국교)(성직자에게)성무집행을 금지시키다
inhibited : a, 억제된, 억압된
inhibition : n, 금지, 금제, 억제, 억압, (영국교)성무집행금지명령, (영법)소송진행정지영장
inhibitive : a, 억제하는(inhibitory)
inhibitor : n, 억제자(물), 반응억제제
inhibitory : a, 금지의, 제지(억제)하는
inhome : a, 집에서의, 집에서 할수 있는
inhomogenous : a, 동질(균질, 등질)이 아닌
inhospitable : a, 손님을 냉대하는, 야박한, 불친절한, 머무를 곳이 없는, 황폐한, (황야등)
inhospitably : ad, 
inhospitality : n, 냉대, 푸대접, 박절, 불친절
inhouse : 조직내의(에서)사내의(에서)
inhuman : a, 몰인정한, 냉혹한, 잔인한(cruel), 비인간적인, 초인적인
inhumane : a, 몰인정(잔학)한, 무자비한
inhumanely : ad, 
inhumanity : n, 몰인정, 잔인, 무자비, 몰인정한 행위, 잔인한것
inhumanly : ad, 
inhumanness : n, 
inhumation : n, 매장(burial)토장
inhume : vt, 토장하다, 매장하다
inimical : a, 적의 있는, 반목하고(있는)불화한, 적대하는, 불리한, 해로운
inimically : ad, 
inimicalness : n, 
inimitable : a, 흉내낼 수 없는, 추종을 불허하는
inimitablness : n, 
inimitably : ad, 
iniquitous : a, 부정(불법)의, 사악한, 간악한
iniquitously : ad, 
iniquitousness : n, 
iniquity : n, 부정, 불법, 죄악, 부정(불법)행위, 죄
init. : x, initial
initial : a, n, vt, 처음의, 최초의, 시초의, 낱말 첫머리, 머리글자, 머리글자로 서명하다, (국제 협정을)가조인하다
initialism : n, 두문자어(DDD, NATO등의 머리글자로 된 약어)
initialization : n, 
initialize : vt, 준비동작에 들어가게 하다, (컴퓨터의 카운터등을)초기치에 맞추다
initially : ad, 처음에, 시초에
Initial Teaching Alphabet : x, 초등 교육용 44문자의 표음알파벳(1자 1음식, 영국의 Sir James Pitman이 고안)
initial word : x, INITIALISM
initiate : vt, a, n, 시작하다, 일으키다, 창시하다, 가입(입문)시키다, (..에게 비법(비결)을)전하다, 전수하다, 초보를 가르치다, 초학의 지도를 하다, (법령등을)제안하다, 발의하다, 초보지도를 받은, 비법을 전수받은, 착수된, 시작된, 창업기의, 전수받은 사람, 신입자, 입회자
initiation : n, 개시, 창시, 창업, 가입, 입문, 입회식, 입문식, 초보지도, 비법(비결)을 전함, 전수
initiative : a, n, 시작, 솔선, 선창, 주도(권)의안, 제출권, 발의권, 이니시어티브, 국민발의권, 독창력, 창업의 재간, 기업심, 선제, 기선, 처음의, 발단의
initiator : n, 창시(전수)자, 교도자, 기폭약, 선창자
initiatory : a, 처음의, 초보지도의, 입회(입문, 입당)의
inject : vt, 주사(주입)하다, (새것, 다른것을)삽입하다, 도입하다, (우주)인공우성등을 궤도에 쏘아 올렸다
injectable : a, n, (약물이)주사가능한, 주사가능물질
injected : a, 주사(삽입)된 충혈된
injection : n, 주입, 관장, 관장약, 주사(액), (우주)(인공위성이나 우주선을)궤도에 진입시킴, 인젝션, (기)(연료, 공기등의)분사
injection molding : 플라스틱의 사출성형
injector : n, 주수(주사기), (엔진의)연료분사장치, 주사하는 사람
injector razor : x, (외날을 갈아 끼우는)인젝터식 안전 면도기
injoke : n, 특정 그룹에만 통용되는 조크
injudicious : a, 분별없는(unwise), 지각없는
injudiciously : ad, 
Injun : n, 아메리칸 인디언, 화를내다
injunct : vt, 금지하다, 억제하다
injunction : n, 명령, 훈령, 지령, (법)(법정의)금지(강제)명령
injure : vt, 상처를 입히다, 다치게 하다, 부상시키다, (명예, 감정등을)해치다, 손상시키다, 손해를 주다
injured : a, 상처입은, 부상한, 다친, 감정이 상한, (명예가)손상된
injurer : ;n, 
injuria : n, 권리침해, 위법행위
injurious : a, 해로운(harmful), 불법의, 부정한(unjust)사람을 헤치는, 중상적인(언사)
injuriously : ad, 
injuriousness : n, 
injury : n, 상해, 손해, 상해, 위해, 손해(감정, 평판등을)해침, 무례, 무욕, 명예훼손, (법)권리침해, 위법행위
injury benefit : (영)산재 보험금(나라가 매주 지불)
injustice : n, 불법, 부정, 불공평, 부정(불법)행위, 권리침해
ink : n, vt, 잉크, 인쇄용 잉크, 먹물, (동)(오징어가 내뿜는)먹물, 잉크로 쓰다, 잉크를 칠하다, 잉크로 더럽히다(지우다)서명하다
ink bag : x, INK SAC
inkberry : n, 감탕나무속의 상록 관목, 그 열매, 아메리카자리공, 그열매
inkblot : n, (심리 테스트용의)잉크얼룩
inkblot test : x, RORSCHACH TEST
inkblottle : n, 잉크병
inker : n, 잉크롤러, (전신)수신인자기
inkfish : n, 오징어(cuttlefish)
inkholder : n, 잉크그릇, (만년필 속의)잉크집
inkhorn : n, (뿔로 만든)잉크 그릇
inkiness : n, 새까맘
inking : n, 잉크로 그림(전신)인자, 스탬프대
inkjet : x, 잉크제트방식의(프린터등)
inkle, incle : n, (가두리 장식용의)폭이 넓은, 린네르 테이프
inkling : n, 어렴풋이 알고 있음, 암시(hint)
inkpad : n, 스템프, 인주
inkpot : n, 잉크 병
ink sac : x, (오징어의)먹물 주머니, 고락
ink slab 1 : x, (인)잉크개는 판, 벼루
ink slinger : n, 삼류작가, 마구 써대는 사람, 편집자, 기자
inkstand : x, 잉크스탠드, INKWELL
inkstone : x, 벼루, (화)녹반(green vitriol)
inkwell : x, (책상에 박혀 있는) 잉크병
inky : a, 잉크로 표를 한, 잉크묻은, 잉크같은, 새카만
inlace : vt, ENLACE
inlaid : a, 상감 세공을한, (무늬를)박이 넣은
inland : n, a, ad, 내륙, 오지, 국내, (바다, 국경에서먼)오지로, 내륙의, (영)국내의, 내국의, 내지의, 국내에 한정된, 국내에서, 발행 지불되는, 내륙으로(에), 국내로(에)
inlander : 내륙사람;n, 
Inland Revenue : x, 내국세, 세입청, 내국세 수입(미)
inland sea : x, 내해
inlaut : n, (음, 음절의)중간음
inlaw : n, 인척
inlay : vt, n, 박아 넣다, 상감하다, 새겨넣다, 아로새기다, (컷등을)끼워넣다, (접붙일 눈을)대목에 끼워넣다, 상감, 박아넣기장식, 충치의 봉박기, 눈 접붙임
inlayer : n, 상감공
inlet : n, vt, 후미, 입구, 들이는물, 박아(끼워)넣다
inlier : n, (지질)내좌층
inline : a, 인라인의, 그때마다 즉시 처리하는, (내연기관이)직렬의, (부품 장치가)일렬로 늘어선
in loc. cit. : x, (in the place cited)앞에 인용한 곳에
in loco paraentis : ad, 부모 대신에, 부모 입장이 되어
inly : ad, (시)속으로, 내심에, 충심으로, 친하게(intimately)
inlying : a, 안쪽(내부)의
inmarriage : n, ENDOGAMY
INMARSAT : n, International Marine Satellite Organization, 국제 해사 위성 기구
inmate : n, (병원, 교도소등의)피수용자, 입원환자, 입소자, 동거인, 한집안사람, 거주자
in medias res : ad, 사건의 중심에서, 사건 도중부터
in memoriam : ad, n, prep, 기념하여, 추도하여, ..의 기념으로, ..을 추도하여, 추도문, 묘비명
inmesh : vt, ENMESH
inmigrant : n, 국내(영토내)이주자
inmigrate : vi, (같은 나라안의 다른 지역으로부터) 이주해 오다
inmigration : n, (같은 나라안의 다른 지역으로부터의) 이주
inmost : a, 맨 안쪽의, 가장 깊은속의, 마음 깊은곳의, 내심의, 깊이 간직한(감정등)
inn : n, 여관, 여인숙, 주막(tavern), (작은)호텔, 거소, 주소, (영고)법학생의 숙사선술집
innards : n, 내장, (사물의)내부(inner parts)내부 구조
innate : a, 타고난, 천부의, 선천적인, 본질적인, 본유적인
innate ideas : x, 본유(생득)관념
innately : ad, 
innateness : n, 
inner : a, n, 안의, 안쪽의, 내적인, 정신의, 보다친한, 은밀한, 비빌의, 과녁의 내권(과녁으 중심과 외권 사이의 부분)내권 명중(탄)
inner bar : x, 칙선 변호인단
inner caninet : x, 각내으 실력자 그룹
inner circle : x, 권력 중추부의 측근 그룹
inner city : x, 도심부, 대도시 중심부의 저소득층이 거주지역
innerdirected : a, (사회)내부 지향적인, 비순응형의
inner ear : x, 내이
Inner Light : x, 내적인 빛(퀘이커 교도가 마음 속에 느끼는 그리스도의 빛
inner man(woman) : x, 정신, 영혼, (익살)밥통(위)식욕
inner marker beacon : x, (공)계기 착륙장치의 일부
Inner Mongolia : x, 내몽고
innermost : a, n, INMOST가장깊은 부분
inner product : x, 내적
inner reserve : x, (대차 대조표에 싣지 않은)내부 유보금, 비밀 적립금
innersole : n, INSOLE
inner Space : x, 해면밑의 세계, 정신의 영역
inner speech form : x, 내부 언어 형식
innerspring : x, (미)(매트리스등)속에 스프링이 든
Inner Temple : x, (영국의) 네 법학 학원( Inns of Cour)중의 하나
inner tube : x, (자전거 등의)튜브
innervate : vt, 신경이 통하게 하다, (신경을)자극하다, 신경자극을 주다
innervation : n, (의)신경분포, (생)신경감응, 신경자극전달
innervational : a, 
innerve : x, ..에 활기를 주다, 고무하다, INNERVATE
inning : n, (야구)회, 이닝, (크리켓)칠차례, (정당의)정권담당기간, (개인의)재임(재직)기간, 활동기 좋은 기회, 행운기, 토지개량, 매립지
innkeeper : n, 여관 주인, 주막주인
innocence : n, 무죄, 결백, 때묻지 않음, 순결, (도덕적)무해(harmlessness), 순진, 천진난만(simplicity)
innocency : n, 무죄, 결백, 때묻지 않음, 순결, (도덕적)무해(harmlessness), 순진, 천진난만(simplicit)
innocent : a, 때묻지 않은, 흠없는, 순결한, 죄없는, 결백한, 순진한, 천진난만한, 악의 없는, 사람좋은(머리가)단순한, 무해의, ..이없는, 결백한 사람, 천진난만한 아이, 호인, 바보
innocently : ad, 
innocent passage : x, 무해 통항
Innocents'Day : x, HOLY INNOCENTS'DAY
innocuous : a, 해(독) 없는(뱀)
innocuously : ad, 
innocuousness : n, 
innominate : a, 무명의, 익명의(anonymous)무명골, 좌골(hipbone)
innovate : vi, vt, 혁신(쇄신)하다, (새로운 사물을)받아들이다, 시작하다
innovation : n, 신기축, 새제도, 새로 도입한것, 혁신, 쇄신, 일신, 기술혁신
innovational : a, 
innovative : a, 혁신적인
innovator : n, 혁신자
innovatory : a, INNOVATIVE
innoxious : a, 해(독) 없는
innoxiously : ad, 
innoxiousness : n, 
Innsbruck : n, 인스브루크(오스트리아의 관광도시, 
innubibus : a, 구름속의, 막연함
innuendo : n, vi, 풍자, 빈정대는말, 빈정거리다
Innuit : n, 이뉴잇(북미, 그린란드의 에스키모, 캐나다에서 부르는 에스크모족의 공식 호칭)그언어
innumerable : a, 셀수 없는, 무수한
innumerableness : n, 
innumerably : ad, 
innumerate : a, n, 수학(과학)을 모르는(사람)
innumerous : a, INNUMERABLE
innutrition : n, 자양분 결핍, 영양 불량(부족)
innutritious : a, 자양분(영양분)이 없는
inobservance : n, 부주의, 태만(inattention), (관습, 법규등의)위반, 무시
inobservant : a, 부주의한, 태만한, (법률, 관례, 약속등을)지키지 않는, 무시하는
inoccupation : n, 무직
inocula : n, INOCULUM의 복수형
inoculable : a, 병균등을 심을 수 있는, 접종가능한
inoculant : n, INOCULUM
inoculate : vt, vi, (병균을)접종하다, (토지 개량을 위해)미생물을 섞어 넣다(사상 등을)부식하다, 접붙이다, 접목하다, 접종하다, 우두를 놓다
inoculation : n, (예방) 접종, 종두, (사상 등의)부식, 감화, 접붙임, 접목, (농)토양의 개량
inoculative : a, 접종의, 종두의
inoculator : n, 
inoculum : n, 접종물(세균, 포자, 바이러스등)
inoffensive : a, (동물, 약등)해를 안끼치는, (사람태도등)악의가 없는, 불쾌감을 느끼게 하지 않는, (말등)거슬리지 않는
inoffensively : ad, 
inoffensiveness : n, 
inofficious : a, 직책(임무)이없는, (법)도덕상의 의무를 다하지 않는
inoperable : a, (병리)수술불가능한, 실행(실천)할수 없는
inoperative : a, 작용하지 않는, 효력(효과)없는
inopportune : a, 시기를 놓친, 시기 나쁜, 부적당한, 형편이 나쁜
inopportunely : ad, 
inopportuneness : n, 
inordinacy : n, 과도 지나침, 과도한 행위
inordinate : a, 과도한(excessive), 지나친, 난폭한, 무절제한
inordinately : ad, 
inordinateness : n, 
inorganic : a, 생활 기능이 없는, 무생물의(inanimate), 유기조직이 없는, 비유기적인(사회등), 무기의 , 무기성의
inorganically : ad, 
inorganic chemistry : x, 무기 화학(cf.ORGANIC HEMISTRY)
inornate : x, 꾸미지 않은, 간소한
inosculate : x, (철관등)접합하다(시키다), 섬유등결합하다(시키다), 섞이다, 섞다, 합체하다(시키다)
inosculation : n, (혈관등의)접합, 결합, 합체
inosinic acid : n, 이노신산
inositol : n, 이노시톨, 근육당, (비타민 B복합체의 하나
inotropic : a, 근육의 수축을 지배하는
inpatient : n, 입원 환자
in perpetuum : ad, 영원히
inperson : a, 생생한, 실황의
inphase : a, (전)동상의
inplace : x, (미정)반대당에 잠입한)정치 스파이
inplant : a, 공장내의(에서 실시되는)
in posse : ad, 가능하게
inpour : vt, vi, 주입하다, 흘러들어가다
inpouring : a, n, 흘러들어오는, 유입
in propria persona : ad, 스스로, 몸소, 친히
input : n, vt, vi, 입력, (전산)입력(신호), 인풋, 입력조작, (기술적 문제의 해결을 위한)정보데이타, 투입(량)(스코)기부(contribution), (전산)정보등을 넣다(기억시키다)
inputoutput : n, 입출력
inputoutput analysis : 투입산출분석, 
inquest : n, (배심원에서의) 심리, 배심, (검시관이 행하는)검시, 집합적 검시배심원, 검시관
inquietude : n, 불안, 동요(restlessness)근심
inquire : vt, vi, 묻다, (질문)문의하다, 조사하다
inquirer : n, 묻는 사람, 문의자, 조사원, 탐구자
inquiring : a, 묻는, 미심쩍은, 알고 싶어하는, 캐묻기 좋아하는(inquisitive), 호기심에찬
inquiringly : ad, 
inquiry : n, 문의, 질문, 조회, 조사, 취조, 심리, 연구, 탐구
inquiry agency : x, 흥신소
inquiry agent : x, (영)사실 탐정
inquiry office : x, 안내소
inquiry station : x, (전산)문의 스테이션(중앙 계산 시스템에 원격 문의를 보낼수 있는
inquisition : n, (엄격한)조사, 심문, (배심공적기관의)심리, 조사(보고소), (중세의 이단 심리의)종교재판
inquisitional : a, 조사(취조)의 , 종교재판소의
inquisitive : a, 호기심이 강한, 알고(듣고)싶어하는
inquisitively : ad, 
inquisitor : n, 조사(심문)관, 종교재판관
inquisitorial : a, 심문자(종교 배판관)의(같은), 캐묻기 좋아하는(inquistive)
inquisitorially : ad, 
in re : ..의 소건으로, 에 관하여
inresidence : a, (예술가, 의사등이)대학 연구소등에 상주하는
inroad : n, 침략, 침입 , 내습, 침식, 침해, 잠식, 먹어 들어감
inrush : n, 돌입 , 침입, 난입, 유입, 쇄도
INS : x, inertial navigation system, Information Network System, Information Network SystemInternational News Service
ins. : x, inches, inscribed, inspector, insulted, insulation, insulator, insulted, insurance
insalivate : vt, (씹어서 음식물에)침을 섞다
insalivation : n, (생리)힘을 섞음, 타액혼화
insalubrious : a, (기후, 토지가)건강에 좋지 못한
insalubrity : n, (토지 기후등의)건강에 부적당함, 비위생
insane : a, 제정신이 아닌, 미친, 광기의(mad), 정신이상자를 위한, 미친 듯한, 환장한 것 같은, 몰상식한
insanely : ad, 
insanitary : a, 건강에 해로운, 비위생적인(unhealthy)
insanitation : n, 비위생 상태(환경)
insanity : n, 정신이상(착란), (급성)정신병, 광기, 미친것, 어리석은 짓
insatiability : n, 만족할줄 모름, 탐욕
insatiable : a, 만족할줄 모르는, 탐욕스러운(GREEDY)
insatiably : ad, 
insatiate : a, =INSATIABLE
insatiately : ad, 
insatiateness : n, 
inscape : n, (문학, 에술에서 표현되는)심상풍경, 인간의 본성, 구성요소, 본질
inscribe : vt, (비석등에)새기다, 파다, 헌정사를 적다, 헌정하다, 명심하다, (주주, 신청자의 이름을)등록하다, 기명하다, 내접시키다
inscription : n, 명, 비명, 비문, (화폐등의)명각, (책의)제명, (영)공채(주식)의 등록, 등록공채(주식)
inscription : a, 
inscriptive : a, 명의, 제명(비명)의
inscrutability : n, 헤아릴수 없음, 불가해, 불가사의, 불가사의한것(일)
inscrutable : a, 헤아릴수 없는, 불가해한, 수수께끼같은
inscrutably : ad, 
inseam : n, (바지, 구두, 장갑등의)안쪽솔기
insect : n, a, 곤충(일반적으로), 벌레, 벌레같은 놈, 소인, 곤충(용의)인색한, 비열한
insectan : a, 
insectarium : n, 곤충사육장, 곤충관
insecticidal : a, 살충(제)의
insecticide : n, 살충제
insectifuge : n, 구충제
insectival : a, 곤충다운
insectivore : n, 식충동물(식물)
insectivorous : a, 곤충을 먹는, 식충성의
insectology : n, 곤충학(entomology)
insect poweder : x, 제충분, (특히)제충국분
insecure : a, 불안정한, 확실치 않은, 위태로운, 무너져 내릴 것같은, 불안한, 걱정스러운, 확신이 안가는
insecurely : ad, 
insecurity : n, 불안정, 위험, 불확실, 불안정(불확실)한것
inseminate : vt, (씨를) 뿌리다, 심다, 수태(인공수정)시키다
inseminatee : n, 수정자
insemination : n, 씨뿌림, (생)수정, 수태, 정액주입
insensate : a, 감각이 없는, 비정의, 무정(잔인)한, 이성이 결여된(senseless)
insensately : ad, 
insensateness : n, 
insensibility : n, 무감각, 둔감, 무의식, 인사불성, 무신경, 태연, 냉담
insensible : a, 무감각한, 감지할수 없는, 의식이 없는, 인사불성의, 감수성 없는, 무신경인, 무관심한, 눈에 보이지 (띄지)않을 정도의
insensibly : ad 눈에 띄지 않을 정도로(서서히)
insensitience : n, 지각력이 없음, 비정, 생기가 없음
insensitive : a, 무감각한, 둔감한, 머리가 기만하게 돌지 않는, 반응없는, 영향을 받지 않는
insensitiveness : n, 
insensitivity : n, 무감각, 둔감
insentient : a, 지각(감각)이 없는, 비정의, 생기가  없는
inseparability : n, 분리할수 없음, 불가분성
inseparable : a, n, 분리할 수 없는, 나눌수없는, 떨어질수 없는, 떨어지기 어려운것(사람), 친구
inseparably : ad, 
insert : vt, n, 끼워넣다, 삽입하다, 써넣다, (신문기사등에)게재하다, 삽입물(신문등의), 삽입광고, 삽입자막
inserted : a, 끼워넣은, (꽃의부분등에)착생한, (근육의 한부분에)부착된
insertion : n, 삽입, 끼워넣음, 삽입물(어구등을)써넣은것(신문잡지등의)삽입광고, (기관일부의)착생, 점, 유착, (레이스나 수놓은것등)사이에 꿰매어 넣은 천
insertion : a, 
insertion sequence : x, 삽입배열
inservice : a, 근무중의, 현직의
insessorial : a, (새발이)나무에 앉기에 알맞은, (새가)나무에 앉는(습성을가진)
inset : vt, n, 삽입하다, 끼워 넣다, 삽입, (책장사이의)삽입지, 삽입광고, 삽입화(도, 사진), (꿰매어 넣은)헝겊조각, 유입수로
inshallah : (이슬람교)알라신이 허락하신다면
inshoot : n, 인커브, 인슈트
inshop : a, 사업소 내의, 사업소 전속의, 사업소 안에서 만든
inshore : 해안에 가까운(가까이), (연해(근해)의)
inshrine : vt, ENSHRINE
inside : 안쪽, 내부, (도로등의)인가에 가까운 부분, 보도의 건물쪽, 내막, 속마음, 본성, (마차등의)차내석의 손님, 차내석, 배, 인사이드, 내각, 내부에 있는, 내부의, 안쪽의, 비밀의, 내면의, 내부에 있는 , 내부의 안쪽의, 비밀의, 내면의, 내부(내면)에, 안쪽의, 비밀의, 내면의, 내부(내면)에, 안쪽에, 마음속으로, (영)교도소에 갇히어, ..의 내부에(로), 의 안쪽에, ..이내에
inside address : x, 우편물 내부에 적는 주소
inside book : x, 내막을 적은책, 내부사정을 밝힌책
inside job : x, 내부범죄
insider : n, 내부 사람, 회원, 부원, 내막에 밝은 사람, 소식통
inside skinny : x, (미 기밀정보)
inside the park home run : x, 펜스를 넘지 않는 홈런
inside track : x, (경기장등의) 안쪽 주로, 유리한 입장(처지)
insidious : a, 사람을 함정에 빠뜨리는, 흉계의, 교활한, 음흉한, 방심할수 없는, (병등이)잠행성의
insidiously : ad, 
insidiousness : n, 
insight : n, 통찰(력), 간파력, 안식, 견식, 식견
insightful : a, 통찰력이 있는
insignia : n, pl, 기장, 표장, 표시, 훈장, 휘장
insignificance : n, 무의미한, 무가치, 사소한, 일, 하찮음, 비천한신분
insignificancy : n, INSIGNIFICANCE대, 하찮은 사람(것)
insignificant : a, 대수롭지 않은, 하찮은, 시시한, 무의미한, (신분등이)천한
insignificantly : ad, 
insincere : a, 성의 없는, 성실치 못한, 거짓의(deceitful)
insincerely : ad, 
insincerity : n, 불성실, 무성의, 위선, 불성실한 언행
insinuate : vt, 넌지시 비추다, 둘러서 말하다, 빗대어 말하다, (사상등을)교묘하게 불어넣다, 스며들게하다
insinuating : a, 넌지시 비추는, 교묘하게 환심을 사는, 간사한
insinuatingly : ad, 
insinuation : n, 암시, 풍자, 빗댐, 천천히 들어감, 교묘하게 환심을 삼
insinuative : a, 교묘하게 환심을 사는, 간사한, 넌지시 말하는
insinuator : n, 알랑쇠, 넌지시 말하는 사람
insipid : a, 풍미가 없는, 맛없는(tasteless), 무미건조한(dull), 재미없는
insipidity : n, 맛없음, 평범, 무미건조, 평범한말(생각)
insipidly : ad, 
insipidness : n, 
insipience : n, (고)무지 은둔
insist : vt, vi, 주장하다, 역설(강조)하다, 고집하다, 우기다, 강요하다, 강력히 주장하다, 끝까지 우기다, 강요하다
insistence : n, 주장, 고집, 강조, 강요
insistency : n, 주장, 고집, 강조, 강요
insistent : a, 강요(주장)하는, 주의를 끄는, 끈덕진, 눈에 띄는, 뚜렷한
insistently : ad, 고집세게, 끈덕지게
insitu : ad, 본래의 장소에, 원위치에
insnare : x, =ENSNARE
insoak : n, (물이)스며듦, (물을)흡수함
insobriety : n, 무절제, 폭음
insofar : ad, ..하는 한에 있어서는
insol. : x, insoluble
insolate : 햇볕에 쐬다;vt, 
insolation : n, 햇빛에 쐼(말림), 일광욕, 일사병, (어떤 물체 지역에 대한 )일사
insole : n, (구두의 )중창, 안창
insolence : n, 건방진, 거만함, 오만, 건방진태도(말)
insolent : a, 건방진, 오만한, 무례한
insolently : ad, 
insolubility : n, 불용해성, 해결할수 없음
insoluble : a, 녹지 않는, 불용해성의, 풀수없는, 해결(설명, 해석)할 수 없는
insolubleness : n, 
insolubly : ad, 
insolvable : a, INSOLUBLE
insolvency : n, 지불불능, 채무초과, 파산(상태)
insolvent : a, n, 지불불능한, 파산한사람, 지불불능자, 파산자
insomnia : n, 불면증
insomniac : a, n, 불면증의 (환자)
insomuch : ad, ...의 정도로, ...만큼
insonify : vt, (광)(HOLOGRAM작성을 위하여)(피사체에)고주파음파를 발사하다
insouciance : n, 무심한, 태평
insouciant : a, 무심한, 태평한
insoul : vt, ENSOUL
insp. : x, inspected, inspector
inspan : vt, vi, (소등에)달구지를 메우다(harness)
inspect : vt, 면밀하게 살피다, 점검(검사)하다, 시찰하다, 검열하다, 사열하다
inspection : n, 정밀검사, 점검(서류의)열람, (공식, 정식)시찰, 감찰, 검열, 사열
inspectional : a, 
inspection cal : x, 감시차(레일의 이상유무를 조사)
inspective : a, 주의 깊은, 검사(시찰)하는, 검열(검사, 시찰)의
inspector : n, 검사자(관), 조사자(관), 시찰자, 검열(사열)관, 장학사, (경찰의)경위
inspectoral : a, INSPECTOR
inspectorate : n, INSPECTOR의 직(지위, 임기, 관할구역), (집합적)INSPECTOR들
inspector general : x, 감찰관, 감찰장관
inspectorial : a, INSPECTOR의
inspector ship : n, 
inspectress : n, INSPECTOR의 여성형
inspiration : n, 영감, 인스피레이션, 영감에 의한 착상, 신통한 생각, 고취, 고무, 격려가 되는 사람(일)암시, 시사, 교시, 감화, (기독교)성령감응, 감화, 들이마시는 숨, 숨을 들이마심
inspirational : a, 영감의 고무적인
inspirationism : n, 영감설
inspirationist : n, 영감론자
inspirator : n, 흡입기, 주사기, (증기 기관의)주수기
inspiratory : a, 흡수성의, 들이마시는
inspire : vt, vi, 고무(격려)하다, (감정, 사상을)불어넣다, 고취하다, (사람에게 사상 감정을)일어나게하다, 영감을 주다, 시사하다, 들이쉬다, 빨아들이다, 영감을 주다, 숨을 들이쉬다
inspired : a, 영감을 받은, 영감으로 쓰여진, (어떤 계통의)내의를 받은, (추측등)사실(확실한 정보)에 기인하지 않는, 숨을 들이마신
inspiring : a, 영감을 주는, 용기를 주는, 고무하는, (종종 복합어를 이루어)..한 감정을 불어넣는(일으키는)
inspiringly : ad, 
inspirit : vt, 활기를 띠게 하다, 기운을 북돋우다, 고무하다
inspiriting : a, 기운을 북돋우는, 고무적인
inspissate : vt, vi, (증발 시켜)짙게하다(짙어지다), 농축시키다(되다)
inspissation : n, 짙게함, 농화
inst. : x, instant, instrument, instrumental
Inst. : x, Institute, Institution
instability : n, 불안정(성), (마음의)불안정, 변하기 쉬움
instable : a, 불안정한, 마음이 변하기 쉬운(unstable)
install : vt, 취임시키다, 자리에 앉히다, (난방장치등을)놓다, 장치(설비)하다
installation : n, 취임, 임명, 임관, 임명(임관)식, 설치, 설비, 가설, (설비된)시설, 장치, 군사시설(기지)
installment : a, n, 분할 불입, 분할 불입금, (전집, 연재물등의)1회분, 한권, 분할불입방식의
installment plan : n, 분할불 판매법
instance : n, vt, 보기(example)실례, 사례, 실증, 단계, 경우(case)의뢰, 부탁, 권유, 제의, (소송)절차, 보기로 들다, 예거하다, 예증하다
instancy : n, 강요, 긴박, 절박, 즉각
instant : a, n, 즉시, 찰나, 순간, 순식간, 인스턴트식품, (특히)인스턴트커피, 즉각(즉시)의, 긴급한, 절박한(urgent), 이달의, 인스탄트의 즉석요리용의)
instantaneous : a, 순간의, 즉시(즉석)의, 즉시일어나는, 그순간의, 동시에 일어나는, 도시적
instantaneous (water)heater : x, 순간온수기
instantaneous book : x, 즉석본(재판처럼 편집이 거의 필요없는 책)
instantaneous camera : x, 인스턴트 카메라
instantaneously : ad, 
instantaneousness : n, 
instanter : ad, (보통익살)즉시, 당장에(instantly)
instantiate : vt, (학설등을)예를 들어 설명하다, 실증하다
instantize : vt, 인스턴트화하다
instantly : 즉시로, 즉석에서, ..하자마자
instanton : n, 인스탄톤(가설상의 양자 단위)
instant photography : x, 즉석 사진술
instant replay : x, (스포츠 중계등에서 특정 장면을 보이는)비디오의 즉시 재생
instar : n, 영(곤충의 탈피와 탈피의 중간단계)
instate : vt, a, 주내의, (사람을)임명하다, 취임시키다
instatement : n, 
in statu quo : ad, a, 현상 유지로(의), 원상태로의
instauration : n, 복구, 회복, 재흥, 부흥
instead : ad, ...의 대신에, ~ of ...의 대신에
instep : n, 발등, 구두(양말)의등
instigate : vt, 추기다, 충동하다, 선동하여..시키다, (사건을)유발시키다, 조장하다
instigation : n, 선동, 교사, 자극, 유인
instigative : a, 
instigator : n, 선동자
instill : vt, (한방울씩)떨어뜨리다, 스며들게 하다, 서서히 가르쳐주다
instiller : n, 
instillment : n, 
instilltion : n, (한방울씩)떨어뜨림, 적화, 점적(법)적하물, (사상등을)서서히 주입시킴
instinct : a, n, 본능, 천성, 가득 찬, 넘치는, 배어든
instinctive : a, 본능적인, 직관적인, 천성의
instinctively : ad, 본능적으로, 직관적으로
instinctual : a, INSTINCTIVE
institute : vt, n, 세우다, 설립(제정)하다, (조사, 소송을)시작하다, 임명하다, (학술, 미술의)협회, 학회, 연구소, (학회등의)회관, (이공과계통의)전문학교, 대학, (교원등의)강습회, 집회, 규칙, 관습, 원리
institution : n, 설립, 창립, 제정, 설정, 학회, 협회, 원, 단, 제도, 법령, 관례, 공공시설(학교, 병원교회등)명물, 잘알려진 사람(것일)
institutional : a, (공공)시설의, (공공)기관의, 공공단체의, 회의 제도상의, 제도적인, 성직 수임의, (사회사업교육활동을 위해)조직된, (판매증가보다는)이름을 알리기 위한
institutional advertisement : x, 기업광고
institutional investor : x, 기관투자가 생명보험회사등)
institutionalism : n, 제도(조직)존중주의
institutionalization : n, 
institutionalize : vt, 공공단체로 만들다, 규정하다, 제도화하다, (범죄자, 정신병자등을)공공시설에 수용하다
institutionary : a, 협회(학회, 공공단체)의 제도상의, 설립(창설)의, 성직수여의
institutive : a, 제정(설립)에 관한, 관습(법등)에 의하여 확립된, 관습적인
institutively : ad, 
institutor : n, 제정자, 설립자(founder).(미)성직 수임자
instn. : x, institution
instn. : x, instructions
instore : a, 가게 안에 있는(설치된)
instr. : x, instruction(s), instructor, instrument(s), instrumental
instruct : vt, 가르치다, 교육하다, 통고하다, 알리다(inform), 지시(명령)하다
instructible : a, 
instruction : n, 교수, 교육, 교훈, 가르침, 훈령, 지령, 명령, 지시, 소송위임장, (전산)명령
instructional : a, 교육상의
instructional television : x, (미)(유선방송에 의한)교육용 텔레비전
instructive : a, 교육적인, 교훈적인, 유익한
instructively : ad, 
instructiveness : n, 
instructor : n, 교사, 가르치는 사람, 지도자, (미)(대학의)전임강사
instructorial : a, 
instructorship : n, 
instructress : n, INSTRUCTOR의 여성형
instrument : (정밀)기계, 기구, 도구(유의어 instrument 복잡하고 정밀한 도구를 가리키는 경우가 많다, implement 어떤 목적이나 일을 위해 사용하는 도구를 가리키는 일반적인 말이다 tool직공이 사용하는 비교적 단순한 도구), (비행기등의)계기, 악기, 수단, 방법, 매개자, (법)증서, 문서, (남의)앞잡이, 도구, ..기계를 설치하다, (악곡)을 기악용으로 편곡하다
instrumental : a, 수단이 되는, 도움이 되는, 기계의(를 사용하는), (악기용의), (문법)조격의, (문법)조격(수단을 표시하는 격)
instrumental condjitioning : x, 도구적 조건부여 (포상등의강화로 옳은반응을 통하여 학습시킴)
instrumentalism : x, (철)기구(도구)주의(사상이나 관념은 환경지배의 도구로서의 유용성에 따라 가치가 정해진다고 하는John Dewey의 학설
instrumentalist : n, 기악가
instrumentality : n, 수단, 방편, 도움, (정부등의)대행기관
instrumental leatning : x, (심, 교육)도구적 학습(법)(어떤 행위의 결과로 받는 상벌에 의하여 경험적으로 학습하는)
instrumentally : ad, 수단으로써, 간접으로, 기계로, 악기로, (문법)조격적으로
instrumentation : n, 기악 편성법, 기계(기구)사용, 수단, 방편(agency)
instrument board : x, 계기판(dashboard)
instrument flight rules : x, (공)계기 비행규칙
instrument flying : x, 계기 비행
instrument landing : x, (공)계기착륙
instrument landing system : x, (공)계기착륙장치(방식)
instrumentologist : n, 계측기학자
instrumentology : n, 계측기학
instrument panel : x, INSTRUMENT BOARD
insubordinate : a, 순종하지 않는, 반항하는, 하위가 아닌
insubordinately : ad, 
insubordination : n, 순종치 않음, 반항(종종)반항행위
insubstantial : a, 실체가 없는, 비현실적인, 내용이 없는, 박약한, 견고하지 않은, 무른
insubstantiallty : n, 비실체성, 비현실성
insufferable : a, 참을 수 없는, 비위에 거슬리는
insufferablness : n, 
insufferably : ad, 
insufficiency : n, 불총분, 부족(lack), 불충분한, 결점, (의)심장등의)기능부전
insufficient : a, 불충분한, 부족한, 부적당한, 능력이 없는
insufficiently : ad, 
insufflate : vt, (기체, 액체가루등을)불어넣다, 취입법으로 치료하다
insufflator : n, 취입기, 취분기(분말살포에 의한)지문현출기
insular : a, 섬의, 섬같은, 섬에(살고)있는, 섬사람의, 섬나라 백성의, 섬나라근성의, 편협한, 고립한, 점재하는
insularism : n, 섬나라근성, 편협
insularity : n, 섬(나라)근성, 편협
insularly : ad, 
insulate : vt, 격리시키다, 고립시키다, 절연(단열, 방음)하다
insulated : a, 격리된, (전)절연된
insulating tape : x, FRICTION TAPE
insulation : n, 격리, 고립, 절연(물), 절연체, 단열재, 뚱딴지
insulator : n, 격리자(물), (전)절연체(물, 재), 뚱딴지
insulin : n, 인슐린(췌장 호르몬, 당뇨병의 특효약)
insulindelivery pump : x, 인슐린 방출 펌프
insulinoma : n, (병리)기능성 췌도종양, 인슬리노마
insulin shock(coma) : x, 인슐린쇼크(인슐린 과잉 투여로 일어나는 쇼크)
insult : vt, n, 모욕하다, 욕보이다, ..에게 무례한 짓을 하다, 모욕, 무례, 손상
insulting : a, 모욕적인, 무례한(insolent)
insultingly : ad, 
insuperability : n, 이겨내기 어려움
insuperabl : a, (어려움등이)이겨내기(극복하기)어려운
insuperably : ad, 
insupportable : a, 참을(견딜) 수 없는, 지탱할수 없는
insupportably : ad, 
insuppressible : a, 억누를 수없는, 억제할수 없는
insurability : n, 
insurable : a, 보험에 넣을(들)수 있는, 보험에 적합한
insurance : n, 보험, 보험 계약(증서), 보험금(액), (실패, 손실등에 대한)대비, 보호(agains)
insurance agent : x, 보험대리점
insurance policy : x, 보험증권
insurance premium : x, 보험료
insurant : n, 보험계약자, (생명보험의)피보험자
insure : vt, vi, 보증하다, 보증이되다(guarantee), (위험등에서)지키다, 안전하게하다(ensure), 보험에 들다, (보험업자가)..의 보험을 맡다, 보험에 가입하다, ..을 방지할 수단을 강구하다
insured : a, n, 보험이 걸린, 보험에 가입한, 보험계약자, 피보험자, 보험금 수취인
insurer : n, 보험(업)자(underwriter), 보증인
insurgence : n, 모반, 폭동, 반란(행위)
insurgency : n, INSURGENCE
insurgent : a, n, 반란(폭동)을 일으킨, 모반한, 반도의, (시)(물결이)거친, 거센, 밀려오는(파도), 폭도, 반란자, (미)(정당내의)반대분자, 반정부 운동가(집단)
insuring clause : x, 보험조항, 보험인수약관
insurmountable : a, 능가할수 없는, 이겨내기 어려운
insurmountably : ad, 
insurrection : n, 폭동, 봉기, 반란(cf.REBELLION)
insurrectional : a, 
insurrectionary : a, n, 폭동의, 반란의, 폭동을 선동하는(일삼는), 폭도, 반란자
insurrectionis : vt, (국민등을)선동하여 폭동을 일으키게 하다, (국가등에)폭동을 일으키다
insusceptibility : n, 무감각, 불감수성
insusceptible : a, (치료등을)받아들이지 않는, 영향받지 않는, 감동하지 않는, 느끼지 않는, 무신경한
insusceptibly : ad, 
inswept : a, (비행기 날개, 자동차 앞쪽등이 )끝이가는
int. : x, interest, interior, interjection, internal, international, interpreter, intransitive, interim
int.comb. : x, internal combustion
intact : a, 손 대지 않은, 손상되지 않은, (고스란히)완전한, (의견등이)그대로인, 변하지 않은
intactness : n, 
intagliated : a, 음각된
intaglio : n, vt, 음각, 요조, 음각무늬, 음각인쇄(주형), (무늬를)음각한 보석, (무늬를)새겨넣다, 음각하다
intake : n, (물, 공기 등을)받아들이는곳, (탄갱등의)통풍구멍, 빨아들이는 양, 섭취량, 수입, 매출액, 채용인원(수), (잘룩하게)좁아진 부분(narrowing), 매립지(늪이나 못의)
intangibility : n, 손으로 만질수 없음, 만져서 알수 없는것, 막연하여 파악할수 없음, 불가해
intangible : a, 손으로 만질 수 없는, 감지할수 없는, 실체가 없는, 무형의, 파악할수 없는, 막연한(vague), 불가해한
intangible assets : (property)(상)무형자산(특허권, 영업권등)
intangibly : ad, 
intarisa : x, 상감세공
integer : n, 정수, 완전체, 완전한것
integrable : a, 적분가능한, 가적분의
integral : a, n, 완전한, 완전체의, 결여된 부분이 없는, (완전체를 이루는데)없어서는 안될, 절대필요한, 구성요소로서의, 정수의, 적분의, 전체, 정수, 적분
integral calculus : x, 적분학
integrality : n, 완전(성), 불가결성, 절대필요성
integrant : n, a, 구성요소(의), 성분(의)일부분(을 이루는)
integrase : n, (생화)인테그레이스(숙주 세균의 DNA에 프로파지(PROPHAGE)의 주입을 촉매하는 효소
integrate : (부분, 요소를)전체로 합시다, 통합하다, 완전하게 하다, (부분요소가 모여서)구성하다, ..의 통계를 나타내다, (온도, 풍속, 면적등의)총화(평균치)를 나타내다, 적분하다, 조정하다(coordinate), (미)(군대, 학교등에서)인종차별을 폐지하다, 각 부분이 갖추어져있는, 완전한
integrated : a, (학교등에서)인종차별을 하지 않는, 통합된, 합성된, 완전한, 일관생산의, (심)인격이 원만한, 융화된
integrated battlefield : x, (군)종합(통합)전장(통상, 병기, 화학, 생물병기, 핵병기가 사용되는 형태의전장)
integrated circuit : x, 집적회로(chip)
integrated commercial : x, (라디오TV)방송순서의 일부를 구성하고 있는 텔레비젼광고
integrated data processing : x, (전산)집중데이타처리
integrated injection logic : x, 아이스퀘어엘(반도체 논리집적 회로의 한형식
integrated optics : x, (물)광집적회로
integrated system : x, (전자)집적시스템(집적회로전반을 가리킴)
integration : n, (부분, 요소의)통합, 완성, 집성, (인격의)통합, 융합, (수)적분법(cf.DIFFERENTIATION)인종적차별의 폐지
integrationist : n, a, 인종차별 폐지론자, 인종차별 페지론의
integrative : a, 통합하는, 완전하게 하는, 인종 차별폐지의
integrator : n, 완성(통합)자(물), (수)적분기, 구적기
integrity : n, 고결, 성실, 완전, 흠없음, 보전
integrodifferential : a, 미적분의
integument : n, 외피, 포피, 외피씌우개
integumentary : a, 
inteist : vt, ENTWIST
intellect : n, 지력, 지성, 식자, 지식인
intellection : n, 사고(작용)이해, 관념, 개념
intellective : a, 지력의, 지적인, 이지적인, 총명한
intellectual : 지적인, 지력의(cf.PHYSICAL MORAL)(유의어 intellectual 인간에 대해서만 사용하며 날카로운 지성과 고도의 지식이 있는, intelligent 사람외에 동물에게도 사용되며, 원래 전반적인 이해력이 뛰어난), 머리를 쓰는, 지력이 발달한, 이지적인, 지식인, 식자
intellectualism : n, 지성을 작용시키는일, 지적작업, 지성편중, 지성주의, (철)주지주의, 이지주의
intellectualist : n, 
intellectuality : n, 지성, 지력, 총명
intellectualize : vt, vi, 지적으로 하다, 지성적으로 처리(분석)하다, (감정적, 심리적 의미를 무시하고)(문제를)이치로 설명하다, 이지적으로 말하다(쓰다)사색하다
intellectual junkfood : x, 핫도그 정보(손쉽게 입수할수 있는, 별로 가치없는정보
intellectually : ad, 
intelligence : n, 지성, 지능, 이해력, 사고력, 총명, 지혜, 지성적 존재, 정보, 보도, 첩보기관
intelligence bureau(department) : x, 정보부(국)
intelligence office : x, 정보국, (미)직업소개소
intelligence quotient : x, 지능 지수
intelligencer : n, 정보제공자, 간첩
intelligence satellite : x, 첩보위성
intelligence ship : x, 정보수집함
intelligence test : x, 기능검사
intelligent : a, 이해력있는, 이성적인, 지적인, 총명한, 재치있는, (전산)정보처리 기능을 가진
intelligential : a, 지성의, 지적인, 지력을 가진(이 뛰어난)통보하는, 정보를 주는
intelligently : ad, 
intelligent printer : x, (전산)인텔리전트프린터(편집, 연산등 어느 정도의 처리능력을 가지고 대형 컴퓨터 기능을 대신하는 프린터)
intelligentsia, izia : n, 지식 계급
intelligent terminal : x, (전산)인텔리전트 단말기(자료의 입출력 외에 편집, 연산, 제어등 어느 정도의 처리능력을 가진것)
intelligibility : n, 이해할수 있음, 알기쉬움, 명료(도)
intelligible : a, 이해할수 있는, 알기쉬운, (철)지성만으로 알수 있는, 지성적인(cf.SENSIBLE)
intelligibleness : n, 
intelligibly : ad, 
Intelpost : n, (영)인텔셋 위성(Intelsat)을 통한 국제 전자 우편
Intelsat : n, (Internation Telecommunications Satellite Consortium)(국제 상업 위성 통신 기구)
intemperance : n, 무절제, 방종, 과도, 폭음대주
intemperate : a, 절제하지 않는, 과도한, 사나운, 험악한, 술에빠지는
intemperately : ad, 
intemperateness : n, 
intend : vt, ...할 작정이다, 하려고 생각하다, 의도하다, 기도하다, 고의로하다, (사람, 물건을)어떤 목적으로 쓰고자하다, , (..으로 만들), 셈이다, 예정하다, 지정하다(design), 의미하다, 가리키다(mean)
intendance : n, 감독(행정)관리, 경리(국), 행정청, 지방청, 관리청
intendancy : n, INTENDANT의 직, (지위, 신분), (집합적)감독자, INTENDANT의 관할구, 지방행정구
intendant : n, 감독(관리)관
intended : a, n, 의도된, 계획된, 고의의, 약혼자
intender : n, 
intending : a, 미래의.지망하는
intendment : n, (법)(법률상의)참뜻, 진의(법의)진의해석, (고)의도, 목적
intenerate : vt, 부드럽게하다, 연화하다
intense : a, 강한, 격렬한, (감정등이)열정적인, 긴장된, (성격이)감정적인, (명암도가)강한, (색이)매우 짙은
intensely : ad, 
intenseness : n, 
intensification : n, 강화, 극화, 증대, 보력
intensifier : n, 강화(증강)시키는 것, 증강장치, (문법)강의어, 증감액(제)
intensify : vt, vi, v, 세게하다, 강렬하게 만들다, 보력하다, 세어(격력해)지다
intension : n, (정신적)긴장, 노력, 세기, 강도, 강화, 보강, (논)내포(connotation), (경)집약적 경영
intensity : n, 강렬, 격렬, 맹렬, 세기, 강도(strength), 효력, 명암
intensive : a, n, 강한, 격렬한, 철저한, 집중인, 집약적인, (보통복합어를 이루어)..집약적, (문법)강의의 , 강조하는(emphasizing), (논)내포적인, 점진적인, (문법)강의어
intensive care : x, (중증 환자에 대한)집중(강화)치료
intensive care unit : x, 집중(강화)치료부(병동)
intensively : ad, 
intensiveness : n, 
intensivism : n, (가축의)집중사육(좁은 지역에서 동물을 집중적으로 번식, 사육함)
intent : n, a, 의지, 의향(intention), 의미, 취지, 열심인, 집중된, 열중하여, 여념없는(bent)
intention : n, 의지, 의향, 목적, 결혼할 의사, 의미(meaning), 취지, (논)개념first(second), 유합, 치유
intentional : a, 고의의(cf.ACCIDENTAL), 계획적인
intentionally : ad, 
intentional walk(pass) : x, (야구)경원의 4구, 고의의 4구
intentioned : a, (복합어을 이루어)할 작정의
intently : ad, 골똘하게, 여념이 없이, 오로지
intentness : n, 
inter : vt, 매장하다
inter : pref, (속, 사이, 상호)의 뜻, intercollegiate, interact
interabang : n, INTERROBANG
interact : vi, 상호작용하다, 서로 영향을 끼치다
interact : n, 막간, 막간극
interaction : n, 상호작용, 상호의 영향
interactive : a, 서로 작용하는(영향을 미치는)
interactive cable television : x, TWO WAY CABLE TELEVISON
interactive information retrieval : x, 쌍방향 정보검색
interactive video : x, 쌍방향 텔레비전(비디오)
interagency : a, n, 중간적(중개)(정부)기관, 관계부처간의, 각기관간의, 관계부처 합동의
inter alia : ad, (사물에 대하여)그중에서도 특히
inter alios : ad, (사람에 대해)그중에서도, 특히
interallied : x, 동맹국간의, 연합국측의(제 1차 대전에서)
interAmerican : a, 미 대륙(국가들)간의
InterAmerican Development Bank : x, 미주 개발은행
interatomic : a, 원자 사이의(상호간의)
interblend : vt, vi, 섞다, 섞이다, 혼합하다
interborough : a, n, 자치도시간의, (cf.INTER URBAN), 도시간 교통(지하철 버스등)
interbrain : n, 간뇌
interbreed : vt, vi, 이종 교배시키다(하다), 잡종 번식하다
intercalary : a, 윤(연, 월, 일)의, 사이에 낀, (지질)다른 층사이의
intercalate : vt, 윤일(달, 년)을 넣다, 사이에 끼어넣다(insert)
intercalation : n, 윤일(달), 윤일(달)을 둠, 사이에 끼움, 삽입, 삽입한것, (지)다른 암질층 사이에 낀층
intercede : vi, 중재하다, 중간에 들어 조정하다
intercelluar : a, 세포 사이에 있는
intercensal : a, 국세조사와 국세조사 사이의
intercept : vt, (사람, 물건을)도중에서 잡다(빼앗다)가로채다, (통신을)가로채어 듣다, 방수하다, (빛, 열등을)가로막다, 방해하다, 차단하다, 두점선으로 잘라내다, 구분하다, , (군)(적기를)요격하다
intercepter : n, INTERCEPTION
interception : n, 도중에서 잡음(빼앗음)가로챔, (통신의)방수, 차단, 가로막음, 방해, 요격, 저지
interceptive : a, 가로막는, 방해하는
interceptor : n, 가로채는 사람(것)가로막는 사람(것), 요격기
intercession : n, 중재, 조정, 알선, (남을위한)기도(간청, 진정)
intercessor : n, 중재자, 조정자, 알선자
intercessorial : a, 중재(조정)(자)의
intercessory : a, 중재의
interchangability : n, 교환(교대)할수 있음
interchangable : a, 교환(교대)할 수 있는
interchangably : ad, 
interchange : 서로 교환하다, 주고받다, 바꾸다, 서로바꾸어 놓다, 교대시키다, 번갈아 일어나게 하다, 교환, 교역, 교체(고속도로의)입체교차점, 철도의 바꿔타는 역
intercity : a, 도시간의(을 연결하는)
interclass : a, 학급간의, 학급대항의(경기등), 계급간의(결혼등)
intercollege : a, INTERCOLLEGIATE
intercollegiate : a, 대학(전문학교)간의, 대학 대항의
intercolonial : a, 식민지(상호)간의
intercolonially : ad, 
intercolumnar : a, 기둥사이의
intercolumniation : n, (건)기둥사이, 기둥배치(기둥의 굵기 위치를 정하는일)
intercom : n, INTERCOMMUNICATION SYSTEM
intercommunicate : n, 서로교제(통신)하다, (방등이)서로통하다
intercommunication : n, 상호 교통, 연락, 교제
intercommunication system : x, (배, 비행기, 전차등의)내부통화(장치)인터콤, 인터폰
intercommunion : n, (친교, 상호교제(연락)(기독교)다른 종파 교도간의 성찬식
intercommunity : n, a, 공통성, 공유, 공동사용, 공유의
interconceptional : a, 임신과 다음임신사이의(사이에 일어난)
interconnect : vt, vi, 서로 연결, 연락시키다(하다)
interconnection, nexion : n, 상호연결(연락)
intercontinental : a, 대륙간의, 대륙을 잇는
intercontinental ballistic missile : x, 대륙간 탄도탄
intercooler : n, (기)(다단압축기의), 중간냉각기
intercostal : a, 늑간의, 엽맥 사이의
intercostally : ad, 
intercourse : n, 교제, 교통, 영적인 교통, 성교
intercrop : vt, vi, (농작물을)간작하다
intercross : (선등을)서로 엇갈리게하다, 서로 교차시키다, 이종 교배시키다, 잡종을 만들다(interbreed), 서로교차하다, 이종교배하다, 이종교배, 잡종
intercrural : a, 하지, 가랑이 사이의
intercultural : a, 이(종)문화간의
intercurrent : a, 사이에 일어나는, 중간의(에 생기는), (병이)병발성의
intercut : vt, 화면에 대조적인 장면을 삽입하다
interdate : (미)종교(종파)가 다른 사람과 데이트하다
interdenominational : a, 종파간의
interdental : a, (해)치간의, (음)치간의
interdentally : ad, 
interdepartmental : a, 각부(국)간의
interdepend : vi, 서로의존하다
interdependence : n, 상호 의존
interdependency : n, 상호 의존
interdependent : a, 상호 의존하는
interdependently : ad, 
interdict : vt, n, 금지(제지)하다, 방해하다, (천주교)성직(성무)을 정지시키다, (미)(폭격등으로)수송을 방해하다, 금지(명령), 금제, (천주교)파문, 성직정지
interdiction : n, 금지, 금제, 정지명령, (법)금치산선고, 통상금지, (군)저지(군사행동을 저지하기 위한 폭격, 포격)
interdictory : a, 금지의, 금제의
interdigitate : 깍지끼다, 서로 맞물(리게 하)다, 서로 얽히(게하)다
interdisciplinary : a, 둘이상의 학문이 관여(제휴, 이용, 공헌)하는 이분야 제휴의, 여러분야에 걸치는, 학제적인
interdit : a, 금지된(prohibited)
interest : 흥미, 관심, 감흥, 재미, 호기심, 관심사, 취미, 중요성, 이해관계, 이익관계, 물권, 이권, 권익, (가진)주, 이익, 이, 득, 사리, 사심, 사욕, 세력, 신용, (같은 이해관계의)동업자들, 주장을 같이하는 사람들, 이자, 흥미를 일으크게하다, 관심을 갖게하다, 관계(가입)시키다, 관여하게 하다, 끌어넣다
interested : a, 흥미를 가진, 이해 관계 있는, 이해 관계가 있는, 타산적인, 사심이 있는
interested group : x, (사회)이익공동체, 공통이해단체(국가 정당클럽등)
interestedly : ad, 
interesting : a, 재미있는, 흥미있는, 임신하여
interestingly : ad, 
interest rate : x, 금리이율
interface : n, vi, vt, (자간의)경제면, 접점, 공유(접촉)영역, (전산)인터페이스(CPU와 단말장치의 연결부분을 이루는회로), 조화시키다, 조정하다(전산)인터페이스로 접속연결하다, 결부하다, 조화되다
interface verification : x, (로켓)인터페이스 검사(로켓 발사시 관련기기의 상호 작동을 점검하는 검사
interfacial : a, (면과 면사이에 끼인), (물, 화)계면의
interfacing : n, (접는 부분의)심
interfaith : a, 이종교단체(교도)간의, 종파를 초월한
interfere : vi, 방해하다, 훼방하다, (이해등이)충돌하다, 대립하다, 손상하다, 해치다, 간섭하다, 참견하다, 중재(조정)하다, (물)광선음파등이)간섭하다, (불법으로)방해하다
interference : n, 간섭, 참견, 방해, 저촉, 불법방해, (광파, 음파, 전파등의)간섭, (통신)방해, 혼신(워)(동일 발명의)우선권 다툼
interfering : a, 간섭(방해)하는, 남의 일에 참견하는
interferingly : ad, 
interferometer : n, (광)간섭계
interferon : n, 인터페론(바이러스 증식 억제 물질)
interflow : 합류하다, 혼류하다, 혼합하다, 혼류, 혼합, vi, n, 
interfluent : a, 합류(혼류)하는
interfold : vt, 접어넣다, 맞접다
interfuse : vt, vi, 배어들게 하다, 침윤케하다, 혼합시키다, 스며들다, 혼합하다
interfusion : n, 침윤, 침투, 혼합
interfutures : n, 인터퓨처스, 미래상관(OECD 가맹국의 전문가로 구성된 미래예측 프로젝트)
intergenerational : a, 세대사이의
interglacial : a, (지질)빙하시대 중간의, 간빙기의
interglactic : a, 은하계의, 우주간의
intergovernmental : a, 정부간의
intergrade : 중간단계(형식정도), (진화등으로인하여)서서히 다른 종류(단계로)변화하다n, vt, 
intergroup : a, 그룹(집단)사이의
interim : n, a, 한동안, 중간의, 잠시, 잠정조치, 가협정, 잠정협정, 당분간(임시)의 중간의, 가
interim dividend : x, 중간배당
interim report : x, 중간보고
interindividual : a, 개인간의, 개인간에 일어나는
interior : a, n, 안의(에있는)내부의, 안쪽의, 내륙의, 내지의, 내국의, 국내의, 국내무역, 내면의, 정신적인, 내부, 안쪽, 실내(도)내지, 오지, 내정, 내무, (건물의)내부사진, 내심, 본성
interior angle : x, 내각
interior ballistics : x, 내부탄도학
interior decoration(design) : x, 실내장식
interior monolog : x, 내적독백(등장인물의 의식의 흐름을 나타내는 소설내의독백)
interj, : x, interjection
interjacent : a, 개재하는, 사이에 있는
interject : vt, (말을)불쑥 끼워넣다, 던져넣다, 사이에 끼우다
interjection : n, 갑자기 지르는소리, 감탄, 감탄사
interjectional : a, 감탄사의, 감탄사적인, 갑자기 지르는(소리의)
interjectionally : ad, 
interjectiory : a, 감탄사의, 감탄사적인, 갑자기 지르는(소리의)
interknit : vt, 짜엮어맞추다
interlaboratory : a, 연구실간의, (서로다른)학문 분야간의
interlace : vt, vi, 서로 엇갈리게 짜다, 섞어 짜다, 얽히게 하다, 서로 엇갈리게 꼬이다, 섞어 짜지다, 얽히다
interlaced : a, (도형이 섞어짜여진, 
interlaced scanning : x, 비월주사(어른거림이 눈에 띄지 않게 하기 위하여 1개 건너 주사하는방식)
interlacing : n, INTERLACED SCANNING
interlard : vt, (이야기등에)섞다
interlay : vt, 사이에 끼어넣다
interleaf : n, 책갈피에 삽입한 백지, 간지
interleave : vt, (책 등에) 백지를 삽입하다..에(끼워)놓다
interlibrary loan : x, 도서관 상호 대출 제도
interline : vt, (책등의) 행간에 글씨를 써넣다(인쇄하다)번역, 교정등을 행간에 서넣다
interline : vt, a, (의류등에)심을 넣다, (수송기관, 운임등)둘이상의 노선에 걸치는(을 이용하는)
interlinear : a, (책등의 )행간에 쓴, (2개국어의 본문을)한줄씩 띄어쓴(인쇄한)
interlinearly : ad, 
interlineation : n, 행간에 써넣음
interline passenger : x, (다른 항공회사 비행기에)갈아타는 승객
interliner : x, INTERLINEPASSENGER
interlingua : n, 과학자용 인공어, 국제어, 국제어
interlingual : a, 
interlining : n, (의복의)겉과 안사이에 넣은심
interlink : vt, 이어 붙이다, 연결하다
interlock : vt, 연결하다, (시키다)결합하다, 맞얽히게하다
interlocking directorate : x, (몇개 회사의)임원 겸직, 겸직 임원회의제도
interlocution : n, 대화, 문답(dialoguge
interlocutor : n, 대화자, 대담자, 질문자, 흑인연주단의 사회자
interlocutory : a, 대화의, 문답체의, 대화중에 삽입하는, (법)중간의, 최종적이 아닌)
interlocutress : n, INTERLOCUTOR의 여성형
interlocutriks : n, 
interlope : (남의 일에)참견하다, 주제 넘게 나서다, 허가없이 영업하다
interloper : n, 남의 일에 참견하는 사람, (불법)침입자, 무면허 상인(남의 특허권등을 침범하는)
interlude : n, (시간과시간의)사이, 중간, 짬, (두중대사건)사이에 일어난, 에피소드, 막간, 막간의, 막간여흥, 중간극(초창기의 희극)간주곡
interlunar : a, 달이 보이지 않는기간의(음력 그믐, 초승사이의 약 4일간)
interlunation : n, 달없는 기간, 무월기간
intermarriage : n, (다른 종족 계급, 씨족간의)결혼, 근친(혈족)결혼
intermarry : vi, (다른 종족등과)결혼하다, 근친(혈족)결혼을 하다
intermeddle : vi, 간섭하다, 참견하다
intermedia : n, intermedium의 복수형의 하나, 인터미디어(음악 영화 무대 회화 등을 복합한 예술)
intermediary : a, n, 매개(중개)자(물)중재인, 중개, 매개, 중간단계, 중간의, 중계의, 중개(매개)의
intermediate : a, n, vi, 중간의, 개재하는, 중간에 일어나는, 중간물, 중재(중개)자 중간시험, 중형차, 사이에 들어가다, 중재하다, 중개하다
intermediate frequency : x, 중간주파수
intermediate host : x, 중간숙주(기생충의 유생기의 숙주)
intermediate range ballistic missile : x, 중거리 타도탄
intermediate school : x, 중학교, (미)국민학교4-6학년 과정의 학교, (영)국민학교 상급과 중학교의 중간학교(12-14세 학생을 수용)
intermediate technology : x, 중간 공학(소규모적이고 간단한 방법이나 기술을 현대의 첨단 기술이나 기계에 결부시킨 공학)
intermediation : n, 중개, 매개, 중재
intermediator : n, 중개(매개, 중재)자
intermedium : n, 중간물, 중개(매개)물
interment : n, 매장, 토장
intermezzo : n, (극, 가극등의)막간연예, 간주곡
intermigration : n, 상호이주
interminable : a, 끝없는, 한없는, 지루하게 긴
interminably : ad, 
intermingle : vt, vi, 섞(이)다, 혼합하다, 섞이다, 혼합되다, 
interminglement : n, 
intermission : n, 중지, 중단(열 발작의)가헐(휴지)기 (미)수업시간 사이의 휴게시간(break)(연극등의)막간, 막간에연주되는 곡
intermit : vt, vi, 일시 멈추다, 중절(중단)하다, 단절하다, 일시 멎다, (열, 아픔등이)단속되다, (맥박이)결체하다
intermitence : n, 간간이 중단됨, 단속, 간헐(상태)
intermitent : a, n, 때때로 중단되는, 단속(간헐)적인, 간헐열
intermitently : ad, 
intermiter : n, 
intermitor : n, 
intermitten fever : x, (병리)간헐열, 말라리아열
intermix : vt, vi, 섞(이)다, 혼합하다, 
intermixture : n, 혼합(물)
intermodal : a, 각종 수송기관을 통합한
intermodal transportation : x, 각종 수송기관을 통합 이용하는 협동일관수송
intermodulation : n, (전)상호변조
intermodulation distortion : x, (전자)상호 변조 왜곡, 혼변조왜곡
intermolecular : a, 분자사이의
intermontane : a, 산간의
intermountain : a, 산간의
intermural : a, 벽사이에 끼인, 도시(단체)사이의
intern : vt, n, (포로등을)(일정 구역 안에)억류(구금)하다, 피억류자(internee)
intern : vi, n, (미)인턴, 수련의(interne), 교육실습생, 교생, 인턴으로 근무하다
internal : a, n, pl, 내부의, 체내의, 내복용의, 내면적인, 내재적인, 본질적인, 내국의, 국내의, 내적인, 심적인, (사물의)본질, 실질, 내장
internal angle : x, 내각(cf.EXTERNAL ANGLE
internalcombustion : a, (기) 내연의
internal ear : x, 내이
internality : n, 내재(성), 내면성, 내적성질
internalization : n, 내면화, (미증권)(거래의)내부화(주의 매매를 거래소 아닌 증권 회사에서 함)
internalize : vt, (사상등을)자기것으로 하다, 내면화(주관화)하다, (문화, 습관등을)흡수하다, 습득하다
internal medicine : x, 내과학
internal pollution : x, 체내 오염(식품, 약품등을 과도하게 섭취하여 생기는)
internal revenue : x, (미)내국세 수입INLAND REVENUE
Internal Revenue Service : x, (미)국세청
internal secretion : x, (생리)내분비물, 호르몬
internal storage : x, (전산)내부기억장치
internaly : ad, 내부로, 내면적으로, 심적으로, 국내에서
internat. : x, international
international : a, n, 국제(상)의, 국제(간)의, 국제적인, 만국의, 국제간에 정해진, 국제신호의, 국제경기출전자, 국제 경기대회, 국제 노동자 동맹, 인터내셔널(International Workingmen's Association)
International Air Transport association : x, 국제 항공운송협회(IATA)
International Amateur Athletic Federation : x, 국제 육상경기연맹(IAAF)
International Atomic Energy Agency : x, (UN의)국제 원자력기구(IAEA)
International Bank for Reconstruction and Development : x, 국제 부흥개발은행(IBRD)통칭(the world bank)
international candle : x, 국제 촉광(1909년 프랑스, 영국, 미국에서 정한 광도의 단위)
international candle : x, (광)국제 표준촉광(1940년 까지 사용된 광도 단위, 현재의 단위는(candela)
International Chamber of Commerce : x, 국제 상업회의소(ICC)
International Civil Aviation Organization : x, (UN의)국제 민간항공기구(ICAO)
International Code : x, (선박등의)국제 기 신호, 국제 전신부호
International Committee of the Red Cross : x, 적십자 국제 위원회(ICRC)
international copyright : x 국제 저작권
International Court of Justice : x, 국제 사법 재판소(ICJ)
International Criminal Police Organization : x, INTERPOL
International Date Line : x, 국제 날짜 변경선(IDL)
International Development Association : x, (UN의)국제 개발 협회(IDA)
Internationale : n, 인터내셔널의 노래(공산주의자들이 부르는 혁명가)국제 노동자동맹(International)
International Energy Agency : x, 국제 에너지 기구(IEA)
International Film Festival : x, 국제영화제(IFF)
International Geophysical Year : x, 국제 지구 관측년(IGY)
International Institute for Strategic Studies : x, (영)국제 전략연구소(I.I.S.S)
internationalism : n, 국제주의, 국제성, 세계성, (인터내셔널의)국제 공산주의
internationalist : n, 국제주의자, 국제 법학자, 국제 공산(사회)주의자, 국제 경기 출전자
internationality : n, 국제적임, 국제성
internationalization : n, 국제화, 국제관리화
internationalize : x, 국제화 하다, 국제 관리하에 두다
International Labor Organization : x, 국제 노동 기구(ILO)
international law : x, 국제(공)법
internationally : ad, 국제적으로, 국제간에
International Militart Tribunal : x, 국제 군사재판(IMT)
International Monetary Fund : x, 국제 통화 기금(IMT)
International Olympic Committee : x, 국제 올림픽 위원회(IOC)
International Organization of Journalists : x, 국제 저널리스트 기구(IOJ)
International Peace Conference : x, 만국 평화회의(1899년 헤이그에서 열린)
International Phonetic Alphabet : x, 국제 음표 문자, 국제 음성기호(IPA)
International Phonetic Association : x, 국제 음성학 협회(IPA)
International Red Cross : x, 국제적십자(사)(IRC)
international relations : x, 국제 관계, (단수취급)국제 관계론
international servant : x, 국제 공무원(국제 기관의 직원)
International Standard Book Number : x, 국제 표준 도서번호(ISBN)
International Standardization Organizational : x, 국제 표준화 기구(ISO)
International Standard Serial Number : x, (미)국제 표준 간행물일련번호
International Telecommunications Satellite Consortium : x, 국제 상업위성통신기구(cf.INTELSAT)
International Trade Organization : x, 국제 무역기구(ITO)
international unit : x, 국제 단위(국제규약으로 정한 열, 전기 등의단위)
International Workingmen's Association : x, 국제 노동자 동맹(별칭First INTERNATIONAL)
interne : x, =INTERN
internecine : a, 서로 죽이는(파멸시키는)내분의, 살인적인(DEADLY)
internee : n, 피(수용)억류자
internist : n, 내과전문의사
internment : n, 유치, 수용, 억류, 역류기간
internment camp : x, 포로 수용소(미)detention camp
internode : n, (마디와 마디사이의 부분)절간
internos : ad, 우리끼리 이야기지만, 이건 비밀인데
internuclear : a, (생)핵간의, (물)원자핵간의
internuncial : a, (신경세포가)개재하는, 각 기관을 연락하는
internuncio : n, 로마 교황대리사절
interoceanic : a, 대양사이의, 두대양을 잇는
interoceptor : n, (생리)내부감각수용기(체내에 발생하는 자극에 감응하는cf.EXTEROCEPTOR)
interoffice : a, (동일 조직내에서)office와office간의, 부국간의
interoperability : n, 정보처리상호(의 가능성)동맹국의 시설, 서비스 상호이용
interoperable : a, 공동이용이 가능한, (다른기기와)조작(운전)이 공통인
interosculate : 서로섞이다(침투하다), (혈관등이)접합(연결하다), (이종생물간에)공통성을 가지다
interpandemic : a, (병의)대유행기 사이의
Inter Parliamentary Union : x, 세계의원 연맹(IPU)
interpellant : x, INTERPELLATOR
interpellate : vt, (의회)(장관에게)질문(질의)하다, 설명을 요구하다
interpellation : n, (의회에서 장관에대한) 질문, 설명요구
interpellator : n, (의회에서)(대표)질문자
interpenetrate : vt, 상호 침투하다, 스며들다, 서로 꿰둘다
interpenetration : n, 상호침투(관통)
interpenetrative : a, 서로 관통(침투)하는
interpersonal : a, 인간사이에 존재하는(일어나는)대인관계의
interphone : n, (배, 비행기건물 내부등의)내부전화(intercom), 인터폰(원래상표명)
interplane : a, (공)상하 두날개 사이의, 비행기 상호간의
interplanetary : a, (천)행성간의
interplay : n, vt, 상호 작용(운동)교차, 상호작용(영향)하다
interplead : (법)경합권리 확인 수속을 밟다
Interpol : n, 국제 형사 경찰 기구(the International Criminal Police Organization의 통칭)
interpolate : vt, vi, (책, 사본에)수정 어구를 써넣다, (이야기등에)의견을 삽입하다, (수)급수에 중간항을 삽입하다, 써넣다, 기입하다
interpolation : n, 써넣음, 써넣은 어구(사항), (통계)보간법, 내삽법
interpolator : n, (사본등의)가필(개찬)자
interpolymer : n, (화)공중합체
interpopulational : a, 이집단(이민족, 이문화)간의
interposal : n, INTERPOSITION
interpose : vt, vi, 사이에 끼우다(두다)삽입하다, (방해등을)넣다(이야기 도중에)(이의 등을)제기하다, 간섭(개입)하다, (영)화면을 중복 촬영하여 바꿔넣다, 중재하다, 조정에 나서다, 간섭하다, 방해하다, 차단하다
interposition : n, 사이에 넣음, 삽입물, 중재, 조정, 간섭, (미)각주의 연방정부에 대한 간섭 허용주의
interpret : vt, vi, 해석하다, 설명하다, 해몽하다, (..뜻으로)이해하다, 판단하다, 통역하다, (자기 해석에 따라 음악, 연극등을)연주(연출)하다, (컴퓨터에서 데이타등을 )기계번역하다, 통역하다, 설명하다, 해석하다, 
interpretable : a, 해석(설명, 통역)할수 있는
interpretant : n, (철)해석경향, INTERPRETER
interpretation : n, 해석, 설명, (꿈수수꼐끼 등의)판단, 통역, 극, 음악등의 자기 해석에 따른, 연출, 연주
interpretative : a, 해석(통역)의, 해석(설명)적인(explanatory)
interpreter : n, 해석자, 설명자, 통역자(관), 연출자, (전산)해석프로그램
interpretership : n, 
interpretive : a, INTERPRETATIVE
interpretive semantics(theory) : x, (언)해석 의미론
interpretress : n, INTERPRETER의 여성형
interprovincial : a, 주사이의(에 있는)
interpulse : n, (천)중간펄스(맥동성이 발하는 두가지 펄스중 2차적인 펄스)
interracial : a, 이인종 간의, 인종 혼합의
interradial : a, (극피 동물등의)사출부(radius)간의
interregnal : a, (왕위등의 )공위기간의, (정치의)공백기간의
interregnum : n, (제왕의 서거, 폐위등에 의한)공위기간, (내각 경질등에 의한)정치 공백기간, 휴지(중절, 중단)기간
interrelate : vt, vi, 상호 관계를 갖게하다, 상호관계에 두다, 상호관계를 가지다
interrelated : a, 서로 관계가 있는 밀접한, 관계의
interrelateness : n, 
interrelation : n, 상호 관계
interrelationship : n, 상호관계가 있음
interrex : n, 공위 기간중의 집정자, 섭정
interro. : x, interrogation, interrogative(ly)
interrobang : x, 감탄 의문 부호(bang은 인쇄 속어로 감탄 부호)
interrogate : vt, vi, 질문하다, 심문하다
interrogation : n, 질문, 심문, 의문, 의문부호
interrogation mark : x, 의문부, 물음표(question mark)
interrogative : a, n, 의문의, 질문의, 의문을 나타내는, 미심쩍어 하는, (문법)의문, (문법)의문사(특히)의문대명사, 의문문
interrogative adverb : x, (문법)의문 부사
interrogatively : ad, 의문스럽게, 미심쩍게
interrogative pronoun : x, (문법)의문 대명사
interrogative sentence : x, (문법)의문문
interrogator : n, 질문자, 심문자, (통신)질문(호출)기
interrogatorly : ad, 
interrogatory : a, n, 의문(질문)의, 질문, 의문을 나타내는, 의문, 질문, 심문(서), (법)(피고 증인에 대한)질문서, 심문조서
interrorem : ad, a, (법)경고로서(유언에 대한 이의 신청자는 유산을 못받는다는
interrupt : vi, vt, 가로막다, 저지하다, (말등을)도중에서 방해하다, 중단시키다, (전산)끼어들다, 방해하다, 중단하다)
interrupted : a, 중단된, 가로막힌, 단속적인, 중절된
interruptedly : ad, 
interrupted screw : x, 나선이 단속적으로 된 나사못
interrupter, ruptor : n, 방해자(전류), 단속기, (무기의)안전장치
interruption : n, 중단, 방해, 중절, 불통
interscholastic : a, 각학교간의, 학교 대항의
interschool : a, INTERSCHOLASTIC
interse : ad, 그들끼리만, 비밀히
intersect : vt, vi, 가로지르다, (선, 면등이)교차하다, 엇갈리다
intersection : n, 횡단, 교차, (도로의)교차점, 교선, 교점
intersectional : a, 교차하는, 공통부분의
intersectional : a, 각부(지역)간의
intersensory : a, 둘 이상의 감각 기능을 동시에 사용하는
interservice : a, 각군사이의, (육, 해, 공군의)3군사이의
intersesion : n, 학기와 학기사이의
intersex : n, (생)간성(의 생물)
intersexual : a, n, 이성간의, (생)간성의
intersexuality : n, 
intership : n, INTERN의 신분(기간, 직, 지위)
interspace : n, vt, 사이의 공간(시간)짬, ..사이에 공간을 두다(남기다), 빈데를 차지하다
interspecific : a, (생)이종간의, (잡종등이) 두종 사이에서 생긴
intersperse : vt, (사이에)흩뜨리다, 산재시키다, 점철하다
interspersion : n, 산포, 산재, 점재
interstadial : n, 야간 빙기(빙상의 생장과 축소사이의 휴지기
interstate : a, (오스트레일리아 미국 등에서)각주간의, 각주 연합회, 주관고속도로, (미)주간 고속도로
Interstate Commerce Commission : x, (미)주간 통상 위원회(ICC)
interstellar : a, 별과별사이의, 성간의
intersterile : a, 이종, 교배가 불가능한
interstice : n, 틈새기, 갈라진 데, 틈, 열극(crevice), 구멍
interstitia compound : x, 화 침입형화합물
interstitial : a, 틈(금)의 , 간질(성)
interstitial cell stimulating hormone : x, 간세포 자극 호르몬(ICSH)
interstratify : 지층과 지층사이에 개재하다(시키다)
intersubjective : a, (철)상호(공동, 집합)주관적인, 간주관적인
intertextuality : n, (문학)텍스트 간의 관련성, 간텍스트성
intertexture : n, 섞어짬, 섞어 짠것
intertidal : a, 만조와 간조사이의, 한사리와 조금사이의, (생물이)조간대, 해안에 서식하는
intertribal : a, (다른)종족간의, 부족간의
intertrigo : n, (간찰진)
intertropical : a, (남북)양회귀선 사이의, 열대 지방의
intertwine : vt, vi, 서로 얽히게하다, 서로 엮다, 얽어짜다, 한데 얽어넣다(interlace), 서로 뒤엉키다
intertwist : vt, vi, 합쳐 꼬이다, 서로 얽히게 하다(interwine)
Intertype : x, 인터타이프 자동식자기(기)(Linotype와 유사, 상표명)
interuniversity : a, 대학간의(cf.INTERCOLLEGIATE)
interurban : a, 도시간의
interval : n, (시간, 장소의) 간격, (정도, 질양등의)차거리, 틈(영)(연극등의)막간, 휴게시간, (미)intermission, (발작등의)휴지기, 때때로, 이따금
intervale : n, (미)강가또는 산과 산사이의 낮은땅
interval signal : x, (라디오 프로사이의)송신계속신호
intervarsity : a, (영)INTERUNIVERSITY
intervein : vt, (정맥처럼)얽히게하다, 교차시키다
intervene : vi, 사이에 들어가다, 사이에 일어나다, 끼이다, 개재하다, (어떤일이)방해하다, 중재하다, (법)소송에 참가하다
intervener : n, 
intervenient : a, n, 개재하는, 사이에 일어나는, 간섭하는, 중간개재물, 중재(간섭)자
intervenor : n, 
intervention : n, 사이에 듦, 조정, 중재, 간섭, 개입, (법)제3자의 소송참가
interventionism : n, 간섭주의의
interventionist : n, (다른 나라의 경제 정치에 대한)간섭주의자
intervertebral disk : x, (추간판)
interview : n, vt, vi, 회견, 대담, 인터뷰, 면접, (신문기자의)방문(면담), 회견(방문)기사, 회견하다(기자가 사람을)방문하다, 방문하여 의견을 묻다, 면접(인터뷰)하다
interviewee : n, 회견을 당하는 사람, 인터뷰 당하는사람
interviewer : n, 회견자, 면담자, 탐방기자
Intervision : n, 인터비전(동유럽 8개 텔레비젼국간의 프로 교환방식)
intervivos : ad, a, (생)생존자 사이에(의)(증여, 신탁등)
intervocalic : a, (음성)모음간의, 모음사이에 있는(자음)
intervolve : vt, 서로 얽히게 하다, (뒤얽히다)한데 감기게 하다(감다)
interwar : a, (제 1, 2차)양대전간의
interweave : vt, vi, 짜넣다.섞다, 섞이다, 섞어짜다, 섞여짜이다
interwind : vt, vi, 한데 감다, 얽히게하다
interwork : 섞어 짜다, 짜넣다, 서로작용하다
interzonal : a, 지역간의
interzone : a, 지역간의
intestacy : n, 유언을 남기지 않고 죽음, 그 사망자의 유산
intestate : a, n, (합법적)유언을 남기지 않고 죽음, 그사망자의 유산
intestin : a, n, 창자, 장, 내부의, 국내의
intestinal : a, 창자의, 장의(에 있는)
intestinal bacteria : x, (생)장내 세균
intestinal flu : x, 설사를 일으키는 유행성 감기
intestinal fortitude : x, (미)용기, 끈기, 담력, 배짱(guts)의 완곡한 표현
intestinally : ad, 
inthing : n, 유행하는 것
inthral : vt, =ENTHRAL(L)
inthrall : vt, =ENTHRAL(L)
inthrone : vt, =ENTHRONE
intimacy : n, 친밀, 친교, (완곡)정교, 간통, 친밀함을 나타내는 행위(포옹, 키스등)
intimate : a, n, 친밀한, 친숙한, 깊은, 자세한, 상세한(close), 마음속으로 부터의 충심의, (완곡)정교를 맺고 있는 사통하고 있는, 친한(허물없는)친구
intimate : vt 암시하다, 넌시지 알리다, (고시하다, 공표하다)
intimately : ad, 친밀히, 충심으로, 직접적으로, 상세하게
intimation : vt, 암시넌지시 비춤(hint)통고, 발표, 고시(announcement)vt, ad, n
intimidate : vt, 협박하다, 위협..시키다, 협박하다
intimidation : vt, a), 협박하다, 위협하여 시키다, 어떤일을 하게되는
intimidator : a, 위협, 협박자
intimism : n, 
intimist : n, a, 앵티미스트(일상적 대상을 개인적인 정감을 강조하여 그리는 화가, 작가), 앵티미스트의 소설이(심리를 그린)
intimity : n, 친밀, 은밀, 비밀
intinction : n, (천주교)성찬의 빵을 포도주에 적시기)
intitle : vt, ENTITLE
intitule : vt, (영)(특히 의회가 법안책등에)명칭(제목)을 붙이다
intl. : x, international
into : prep, 속에, 속으로
intoed : a, 발가락이 안쪽을 굽은
intolerable : a, 참을수 없는, 견딜 수 없는(unbearable), (구)애타는, 약오르는, 과도한
intolerableness : n, 
intolerably : ad, 참을(견딜)수 없이(없을 만큼)
intolerance : n, 참을수 없음, 아량이 없음, 옹졸, 편협(narrowmindedness)
intolerant : a, 참을수 없는, 옹졸한, 편협한, (이설등을)용납하지 않는
intolerantly : ad, 
intomb : vt, =ENTOMB
intonate : v, =INTONE
intonation : n, 옳음, 영창, 음창, (음악)소리의 억약, 인토내이션, 어조(cf.STRESS), (악)음의 정조법, (성가의)첫악구
intone : vt, vi, (기도문등을) 읊다, 영창하다, 억양을 붙이다
intoto : ad, 전체로서, 완전히
Intourist : n, 소련의 외국인 관광국(국영여행사)
intown : a, 도시 중앙에 있는
intoxed : a, (미속)마리화나에 취한
intoxicant : n, a, (술마약등)취하게 하는(것), 취하게 하는
intoxicate : a, n, 취하게하다, 흥분(도취)시키다, 열중시키다
intoxicated : a, 술취한, 취하다, 흥분한, 도취된
intoxicating : a, 취하게 하는 열중(도취)케하는
intoxicatingly : ad, 
intoxication : n, 취함, 흥분, 열중, 도취, 중독
intr. : intransitive, 
intra : prep, 안에, 내부(안쪽)에의 뜻 결합사
intraarterial : a, 동맥 내의(을 통하는)동맥주사의
intractability : n, 고집스러움, 다루기 힘듦, 처치곤란
intractable : a, 억지(고집)스러운(stubborn), 처치(가공)하기 어려운, (병이)고치기 어려운
intractably : ad, 
intraday : a, 하루동안에 일어나는, 하루의
intradermal : a, 피내의
intradermal test : x, (의)피내(면역)테스트
intradermic : a, 
intrados : n, (아치의) 내륜, 안둘레(면)(opp.extrados)
intragalactic : a, 한은하계안에 있는(에서 일어나는)
intragenic : a, 유전자 내의
intragovernmental : a, (정부내의)항쟁협력
intramolecular : a, (화)분자내의(에서 일어나는)
intramural : a, 교내의, 도시안의, 건물안의
intramuros : ad, (도시의)성안에(서)(대학)구내에서, 비밀로
intramuscular : x, (주사등이)근육내의(IM)
intranational : a, (국내만)의
intrans. : x, intransitive
intransigence : n, (정치상의)비타협적인 태도, 타협(양보)하지 않음
intransigency : n, (정치상의)비타협벅인 태도, 타협(양보)하지 않음
intransigent : a, n, 비타협적인(사람)(uncompromising)
intransitive : a, n, 자동의, 자동사
intransitively : ad, 자동사로(로서)
intransitiveness : n, 
intransitive verb : x, (문법)자동사
intrant : n, ENTRANT
intraoperative : a, (외과)수술중의(에 행하는)
intraparty : a, 정당내의
intrapersonal : a, 개인안에서 생기는, 개인내의
intrapopulation : a, 주민 간에 생기는(행해지는)
intrapreneur : n, (경영)사내기업가
intrapreneurship : n, 기업내 기업제도, 독립채산제도
intrastate : a, (미)주내의
intrauterine : a, 자궁내의
intrauterine device : x, 자궁내 피임법(기구)IUD
intravascular : a, 혈관내의
intravehicular : a, 탈것(우주선)안의
intravenous : a, 정맥내의, 정맥주사의
intravenous drip : x, (의)(링게르등의)점적 정주
intray : n, (사무실의)도착(미결) 서류함(cf.OUT-TRAY)
intrazonal soil : x, (토양)간대토양
intreat : n, =ENTREAT
intrench : v, =ENTRENCH
intrepid : a, 용맹한, 대담한(dauntless)
intrepidity : n, 대담, 용맹, 겁없음, 대담한 행위
intrepidly : ad, 
intrepidness : n, 
intricacy : n, 복잡(함), 얽힌(복잡한)사물
intricate : a, 얽힌, 복잡한(complicated)난해한
intricately : ad, 
intrig(u)ant : n, 음모자, 내통자
intrigue : vi, vt, n, 음모, 밀통, 불의, (연극의 줄거리), 음모를 꾸미다, 술책을 쓰다, 밀통하다, ..의 호기심(흥미)을 돋우다(fascinate), (음모, 술책으로)손에 넣다, 달성(성취)하다
intriguer : n, 
intriguing : a, 흥미를 자아내는, 호기심을 자극하는
intriguingly : ad, 
intrinsic, -sical : a, 본래 갖추어진, 고유의, 본질적인(inherent)
intrinsically : ad, 
intrinsic factor : x, (생화)내재성인자
intrinsic semiconductor : x, (전자)진성반도체(N형도 P형도 아닌 반도체)
intro : n, vt, (구)소개, (대중음악의)전주, 서주, 소개하다
intro(d). : x, introduction, introductory
intro- : pref, 안으로의뜻introgression, intropulsive
introduce : 들여오다, 도입하다, 처음으로 수입하다, 채용하다, 전하다, 끼워넣다, 삽입하다, 소개하다, 선도하다, 안내하다, 처음으로 경험하게 하다, 초보를 가르치다, (문법)(접속사가 절을)이끌다, (의안등을)제출하다, (논문)등에)서론을 달다, (이야기 등을)..으로 시작하다
introducee : n, 소개자, 전래자, 창시자
introduction : 도입, 채용, 창시, 첫수입, 소개, 피로, 서론, 서설, (서두의)해설, introduction 책의 일부를 형성하고 그 내용에 관한 정신적인 예비적 해설.preface 본론과는 독립하여 책의 목적, 구성등에 대해 해설한것.foreword preface와 비슷한 것이지만 종종 저자 이외의 인사가 기술한것), 입문(서), 개론, 서설, (악)서주, 전주곡(prelude), 끼워넣음, 삽입
introductive : a, INTRODUCTORY
introductory : a, 소개의, 서론의, 서두의, 예비의(preliminary)
introductory price : x, 시험구독료(새 구독자 개척을  위한 할인 대금)
introgression : n, (생)유전자 이입, 유전질 침투, 들어옴(감)
introit : n, (천주교)입당송, (영국교)성찬식 전에 부르는 성가
introject : vt, vi, (심)남의 특질, 태도를 , 무의식적으로, 자기것으로 받아들이다, 투입(섭취)하다
introjection : n, (심)투입, 섭취(대상의 속성을 자기 것으로 동화시킴)
intromission : n, 입장 허가, 가입허가, 삽입, 들여보냄
intromit : vt, (미, 영고)삽입하다, 들여보내다
intromitent : a, 
intron : n, (생화)인트론, 개재배열
Intropin : n, 인트로핀(심장 활동자극체, 상표명)
introrse : a, (식)안으로 향하는, 내향의(opp.extrorse)
introspect : 내성하다
introspection : n, 내성, 자기반성(self examination)
introspective : a, 내성적인, 내관적인, 자기반성의
introspectively : ad, 
introversible : a, 안으로 향하게 할수 있는
introversion : n, 내향, 내성, (의)내전, 내반, (심)내향성(opp.extroversion)
introversive : a, 내향(적)인, 내성적인, 안으로 굽는
introversively : ad, 
introvert : n, a, vt, (마음, 생각을) 안으로 향하게 하다, 내성시키다, 안으로 구부리다, (동)기관을 내전시키다, 내성적인 사람, 안으로 향하는(굽은), 내성적인
introverted : a, INTROVERT
introvertive : a, INTROVERSIVE
intrude : vt, vi) 억지로 밀어넣다, 강요하다, 강제하다, (지질)관입시키다, 억지로 밀고 들어가다, 침입하다, (남의일에)참견하다, 방해하다
intruder : n, 침입자, 난입자, 방해자, (군)(야간의)침입기(의 조종사)
intrusion : n, (의견등의)강요, (장소에의)침입, (사생활에의)침해, 방해, (법)무권리자의)토지침입점유, (교회 소유지의)점유 횡령, (지질)(암맥의)관입, (스코교회)교도의 동의 없는 목사 임명
intrusive : a, (opp.extrusive)침입적인, 주제넘게 참견하는, 방해하는, (지질)관입의, (언)(비어원적으로)끼어든, 감입적인
intrusively : ad, 
intrust : vt, ENTRUST
intubate : vt, (의)관을 삽입하다
intubation : n, (의)삽관법
intuit : 직각(직관)하다, 직관으로 알다(이해하다)
intuitable : a, 
intuitionism : n, (심, 철)직각설(론)(외계의 사물은 직각적으로 인식된다는)
intuitionist : n, 직관(직각)론자
intuitive : a, 직각(직관)적인
intuitiveism : n, INTUITIONISM
intuitively : ad, 
intuitiveness : n, 
intumescence : n, 부어(부풀어)오름, 부어오른 종기
intumescent : a, 팽창성의, 부어오르는(swelling up)
intussuscept : vt, vi, (병리)(장관등을)함입시키다, 중적을 일으키다, 함입하다, 중적(증)이 되다
intussusception : n, (생)섭취(작용), (병리)장중적, (사상의)섭취 동화
intussusceptive : a, 
intution : n, 직각, 직관, 직감, 육감, 직관적 행위(지식)
intutional : a, 직각의 직각(직관)적인
intutionalism : n, INTUTIONISM
intutionalist : INTUITIONIST
intutionally : ad, 
intwine : vt, ENTWINE
Inuit : n, INNUIT
inulin : n, (생화)이눌린(달리아의 괴근 등에 함유된 저장 다당류)
inunction : a, 기름, 바름(anointing), (의)(고약을)문질러 바름, 그치료법, 연고
inundant : a, 넘치는, 넘쳐흐르는, 압도적인
inundate : vt, (장소를)범람시키다, 물에 잠기게 하다, 침수하다, (장소에)몰려오다, 쇄도하다, 충만시키다, 넘치게 하다
inundation : n, 범람, 침수, 홍수, 충만, 쇄도
inurbane : a, 도시적, 품위가 없는 세련되지 않은, 몰취미한, 촌스러운, 야비한
inurbanity : n, 야비, 조야
inure : vt, vi, 익히다, 단련하다, (법)효력을 발생하다, 도움이 되다, 
inurement : n, 익힘, 익숙, 단련
inurn : vt, 납골단지에 넣다, 매장하다(bury)
inutile : a, (문어)무익한, 무용의
inutility : n 무익, 무용(uselessness), 쓸모없는 사람(물건)
inv, : x, invented, inventor, invoice
in vacuo : ad, 진공속에, 사실과 관계없이, 현실에서 유리되어
invade : vt, vi, (남의 나라를)침략하다, 침입하다, 쳐들어가다, 밀어닥치다, 몰려들다(throng)(병 감정등이)침범(엄습)하다, 내습하다, (소리, 냄새등이..에)퍼지다, 충만하다, (권리등을)침해하다, 침입하다, 대거몰려오다(가다)
invader : n, 침략자(군), 침입자
invaginate : 칼집(모양의것)에 넣다(sheathe), (발생, 의)(관, 기관등의 일부를)함입(중적)시키다, (칼집, 관등에)들어가다, 함입하다, 함입한 칼집(등)에 넣은
invagination : n, 칼집(모양의것)에 넣음(들어있음), (발생, 의)함입 중적(중)장중적, 함입부
invalid : 병약한, 허약한, 환자용의, 병자, 병약자, 병약하게 하다, 병약자로서 면제(송환)하다, 상이 군인 명부에 기입하다, 병약하게 되다, 병약자 취급을 받다
invalid : a, (증거 등이)박약한 가치없는(법)무효의
invalidate : vt, 무효로 만들다
invalidation : n, 무효로 함, 실효
invalid chair : x, 환자용 바퀴 의자
invalidism : n, 병약함, 허약, 인구에 대한 병자의 비율
invalidity : n, 무효
invalidity : n, 폐질(취업불능)INVALIDISM
invalidity benefit : x, (영)(국민 보험에 의한)질병 급부(IVB)
invalidly : ad, 
invaluable : a, 값을 헤아릴 수 없는, 평가 못할 만큼의, 매우 귀중한(cf.VALUELESS)
invaluably : ad, 
invandrare : n, (스웨덴에서 일하는)외국인 노동자
invar : n, 불변강, 인바르(강철과 니켈의 합금)
invariability : n, 불변성
invariable : a, n, 불변의, 변화없는, (수)일정한, 상수의, 변치 않는 것, 상수, 불변량
invariably : ad, 변화없이, 일정 불변하게 늘, 반드시
invasion : n, 침입, 침략, (권리 등의)침해
invasive : a, 침입하는, 침략적인, 침해의
invective : n, a, 비난, 독설, 비난의 말, 욕설, 독설의
inveigh : vi, 통렬하게 비난하다, 독설을 퍼붓다, 욕설하다
inveigher : n, 
inveigle : vt, 꾀다, 유인하다, 속이다, 비위맞추어(감언으로), 얻어내다(끌어내다)
inveiglement : n, 
inveigler : n, 
invenit : x, ..작, ..발명(발명품, 예술품등의)
invent : n, 발명하다, 창안하다, (유의어 invent새로운 것이나 도움이 되는 것(생각)을 처음으로 만들어 내다, discover이미 존재해 있었지만, 그때까지 알려져 있지 않은 것을 발견하다), 날조하다, 조작하다, (미속)훔치다(steal)
invention : n, 발명, 발명품, 창안문, 날조, 조작한것, 꾸며낸 일, 허구, 발명(창안)의 재능, 발명력, (고)발견(discovery)(기독교)성십자가 발견의 축일
inventive : a, 발명의 (재능이 있는), 창의력이 풍부한, 독창적인
inventively : ad, 
inventiveness : n, 
inventor, -venter : n, 발명자, 창출자, 발명가
inventory : (상품, 재산등의)목록, 재고품목록, (자세한)목록, 표, 재고품, (미)재고조사, 재고조사 자산(고), 재고품의 총가격, 천연자원 재고 일람표, (카운슬링용)인물조사기록, (재고품등)을 조사하다, (기능성격등)을 평가한, , (비품, 상품)등의 목록을 만들다, ..을 목록에 기입하다, (미)재고품 조사를 하다
inventory adjustment : x, (경)재고 조정
inventory recession : x, 인벤토리 리세션(재고 과다로 인한 유효 수요의 감퇴로 생기는 경기 후퇴)
inventress : x, INVENTOR의 여성형
inveracity : n, 참되지 않음, 불성실, 허위, 거짓말
inverness : n, 인버네스(남자용의 소매 없는 외투일종)
inverse : n, a, 역의, 반대(의), 거꾸로된, 역(함)수의, 역, 역(함)수, 반대(의것)
inversely : ad, 반대로, 거꾸로, 역비례하여
inverse proportion : x, (수)반역비례
inverse ratio : x, (수)반비, 역비
inverse square law : x, (물)역제곱법칙
inversion : n, 역(전도), (문법)어순전환, 도치(법), (동)역위(염색체의 어느 부분이 절단되어 반대 위치에 부착하는 현상), (논)여환법, (악)전회, (화)전화, (음성)반전, 성도착, 동성애
inversive : a, 전도의, 역(반대)의
invert : vt, n, a, 거꾸로(반대)하다, 전도시키다, (악)전회시키다, (화)저화시키다, (건)역치(inverted arch), (화)전화, 성도착자, (화)전화한
invertase : n, (생화)자당(전화)효소
invertebrate : a, n, 척추가없는, 척골이 없는, 줏대없는, 우유부단한, 무척추 동물, 줏대없는 사람
inverted : a, 역의, 반대의, 반전된, 동성애의, 성도착의
inverted arch : x, (건)역, 아치(기초등에 쓰는
inverted commas : x, 역콤마, 인용부호(quotation marks)
inverted consonant : x, (음성)도설자음(이를테면 미국식 발음의)
inverted snob : x, 자기보다 아래 계급으로 가장하고 자기 계급을 경멸하는 속물
inverter : n, (전)인버터, 변환장치(기)
invertor : n, (전)인버터, 변환장치(기)
invert sugar : x, 전화당
invest : 투자하다, (돈을)쓰다(spend)(시간, 정력등을)들이다, 쓰다, 바치다, 착용시키다, 입히다(dress), 뒤덮다, 둘러싸다, 안개에 싸인 도시, (군)(도시 항구등을)포위하다, (어떤 성질 능력등을)지니게하다, 부여하다, (권력, 훈장등을)주다, (권한등을)부여하다, (관리등을)맡기다, 투자(출자)하다, 돈을 쓰다, (속익살)사다
investigable : a, 
investigate : vt, vi, 조사하다, 수사하다, 연구하다(유의어 examine)
investigation : n, 조사, 수사, 연구(examination)연구, 논문, 조사보고
investigational : a, 
investigative : a, 조사의, 취조의, 연구의
investigative reporting(journalism) : x, (신문, 방송등의)독자적인 조사 보도(범죄, 오직사건등에 관한)
investigator : n, 조사자, 연구자, 수사관
investigatory : a, 조사의, 조사에 종사하는
investiture : n (영)(관직, 성직등의)수여, 임관, 수여식, 임관(인중)식, (자격의)부여, (문어)익힘, 착용), 
investitve : a, 관직(자격)을 수여하는, 임관(자격 부여)의(에 관한)
investment : n, 투자, 출자, 투하 자본, 투자금, 투자대상, 투자의 목적물, (군)포위, 봉쇄, 입힘, 피복(clothing), 서임, 수여(investiture)
investment bank : x, 투자은행
investment banker : x, 증권 인수업자
investment buying : x, 투자매입
investment casting : x, 매몰주조(법), 정밀주조(법)
investment company : x, 투자(신탁)회사
investment fund : x, 투자신탁재산(회사)
investment returns : x, (미)투자 수익
investment tax credit : x, 투자세액공제
investment trust : x, INVERSTMENT COMPANY
investor : n, 투자자, 포위자, 서임자, 수여자
inveteracy : n, (습관등이)뿌리깊음, 끈덕진 원한, 숙원, (병등의)만성, 고질
inveterate : a, (병, 습관등)뿌리깊은, 만성의, 상습적인, (감정등)뿌리깊은, 집념어린
inveterately : ad, 
inviability : n, 
inviable : a, (유전적, 재정적으로) 생존 불가능한
invidious : a, 괘씸한, (불공평하여)불쾌한, 남의 시기를 살만한(지위, 명예등)
invidiously : ad, 
invidiousness : n, 
invigilate : (영)(시험)감독을 하다, vi, vt, 
invigilation : n, (영)시험감독
invigilator : n, 
invigorant : n, 강장제
invigorate : vt, 기운나게(활기띠게) 하다, 상쾌하게하다, 고무하다
invigorating : a, 기운나게 하는, (공기, 미풍등이) 상쾌한
invigoratingly : ad, 
invigoration : n, 기운나게함, 고무, 격려
invigorative : a, 심신을 상쾌하게하는, 고무하는
invigorator : n, 기운을 돋우어 주는 사람(것), 자극물, 강장제
invincibility : n, 무적, 정복불능
invincible : a, 정복할(이길)수없는, 무적의, (정신등)불굴의, (장애등)극복할수 없는, 완강한
Invincible Armada : x, (스페인의)무적함대(1588년 영국 해군에 격파됨)
invincibly : ad, 
inviolability : n, 불가침(성), 신성
inviolable : a, (신성하여)침범할수 없는, 불가침의
inviolably : ad, 
inviolacy : n, 침범되어 있지 않음, 불가침
inviolate : a, 침범되지 않은, 신성한, 모독되지 않은, 더럽혀지지 않은
inviolately : ad, 
inviolateness : n, 
inviscid : a, 점도가 제로인, 무점성의
invisibility : n, 눈에 보이지 않음, 나타나 있지 않음
invisible : a, n, 눈에 안보이는, 얼굴을 보이지 않는, 모습을 나타내지 않는, 영계, 신
invisible balance : x, (경)무역외 수지)
invisible cap : x, 요술모자(이것을 쓰면 남의 눈에 보이지 않게 된다는 전설의)
invisible exports : x, 무역의 수출, 무형수출품(특허료, 외국품 수송료, 보험료등)
invisible glass : x, 불가시유리, 무반사유리
invisible government : x, (미)보이지 않는 정부(CIA)의 별칭
invisible green : x, (검정처럼 보이는)짙은 초록색
invisible hand : x, (경)보이지 않는 손, (Adam Smith의 경제학에서)
invisible imports : x, 무역외 수입, 무형수입품(cf.INVISIBLE EXPORTS)
invisible ink : x, SECRET INK
invisible mending : x, 자국이 남지 않게 수리하기, 짜깁기
invisible trade : x, 무역외 거래, 무형 무역(관광, 보험, 운임등)
invisibly : ad, 눈에 안보이게(보일정도로)몰래
invitation : n, 초대(장), 초빙, 권유, 안내장, 유인, 매력, 유혹, 유언, 도전
invitational : a, 초대받은 사람만이 참가하는, 의뢰한
invitational card : x, 초대장
invitational tournament : x, 초청경기
invitatory : a, 초대의, 초대를 위한, 초대의 뜻을 전하는, 초문, 초사(특히 시편 95)
invite : vt, n, 초청하다, 초대하다(ask), (..에게 할것을)권하다, (정중히)부탁하다, 청하다, 끌다(마음등을) 쏠리게하다, (관심을)자아내다, (비난, 위험등을)가져오다, 초래하다, 당하다, 초대장
inviting : a, 초대하는, 유혹적인, 마음을 끄는, 마음이 동하는(tempting), 좋아(맛있어)보이는
invitingly : ad, 
invitro : ad, a, 시험관(유리관)안에의, (생)생체(조건)밖에서(의)
in vitro fertilezation : x, 체외수정
invivo : ad, a, 생체조건안에서(의)
invocate : x, (고)INVOKE
invocation : n, (신에의)기도, 기원, (시의 첫머리의)시신의 영감을 비는말, (법의)발동, 악마를 불러내는 주문
invocatory : a, 기도(주문)의 간곡한
invoice : n, vt, vi, (상)송장(에 의한송부)인보이스, (화물등이)송장을 만들다(보내다)
invoice book : x, 구입대장, 송장대장
invoke : vt, (천우신조등을)빌다, 기원하다, 간절히 바라다, 염원하다, (법에)호소하다, 발동하다, (법을)실시하다, (혼령등을)불러내다, (마음에)떠오르게 하다, 연상시키다, (사고등을)가져오다, 야기하다
involucre : n, (해)피막, 포피, 총포
involucrum : n, INVOLUCRE
involuntarily : ad, 저도 모르게, 부지불식간에, 본의 아니게
involuntariness : n, 무의식, 본의아님
involuntary : a, 본의아닌, 마음내키지 않는(unwilling)무의식 중의, 부지불식간의, (해)불수의의
involuntary manslaughter : x, (법)과실치사(죄)
involute : a, n, vi, 복잡한, 뒤얽힌, (식)내선의, (동)소용돌이 꼴로 말린, 나선의, (수)신개선, 안으로 말리다(감기다)(출산후 자궁이)원상태로 돌아가다
involute : a, 뒤얽힌, (자궁등)원상태로 돌아간
involution : n, 말아넣음(넣은선)안으로 말림, 회선, 복잡, 혼란, (문법)복잡구문, (수)거듭 제곱법, 누승법, (생리)퇴화(degeneration)(의)복구 작용, 퇴축
involutional : a, 
involve : vt, 포함하다, (필연적으로)수반하다, 뜻하다, 필요하다, (사람을)(사건, 논쟁등에)말려들게하다, 휘말리게하다, 연루(연좌)시키다, 열중시키다, 감다, 싸다, ..에 영향을 미치다, 관계하다, (사물을)복잡하게 하다
involved : a, 복잡한, 뒤얽힌, 혼란한, (경제적으로)곤란한, (사건등에)깊이 관련된, 말려든, 열중하여
involvement : n, 말려들게함, 휩쓸리게함, 연루, 연좌, 어쩔수 없는 관계, 곤란한일, 성가신일, 재정곤란
invt. : x, inventory
invulnerability : n, 
invulnerable : a, 상하게 할수 없는, 죽지 않는, 이겨낼수 없는, 반박할수 없는, (주장등)
invulnerably : ad, 
inward : ad, a, n, 안으로, 속에서, 마음속에서, 은밀히, 안의, 내부의, 안쪽으로의, 내향의, (상)수입의, 내적인, 마음의, (뱃속에서 나오는 듯한)낮은(목소리), 내부, 내심, 창자, 내장, (영)수입세
inwardlooking : n, 안을 봄, 내정중시
inwardly : ad, 내부(안쪽)에, 마음속에 몰래, 작은 목소리로
inwardness : n, 본질(essence)진의, 내적(정신적)임, 영성(spirituality)
inwards : ad, INWARD
inweave : vt, 짜넣다, 한데 짜다, 섞어짜다
inworks : a, 공장내의(에서 일어나는)
inwrap : vt, ENWRAP
inwreathe : vt, ENWREATHE
inwrought : a, (무늬 등을)짜넣은, 수놓은, 박아넣은, (직물등)무늬를 짜놓은, 잘섞은
Io : n, (그신)이오(Zeus의 사랑을 받았으나 hera의 미움을 받아 흰 암소로 변함, (천)목성의 제1위성
Io : x, (화)ionium
IO : x, information officer 공보장교
Io. : x, Iowa
IOC : x, International Olympic Committee
IOCS : x, input/output control system
iodate : n, vt, (화)요오드산염, 요오드로 처리하다(iodize)
iodation : n, 
iodic : a, (화)요오드의, 옥소의, 옥도의
iodic acid : x, 요오드산
iodide : n, (화)요오드화물
iodine : n, 옥소, 요오드(구)요오드팅크
iodinexenon dating : x, (지질)요도드, 크세논 연대 측정법
iodism : n, (병리)요오드 중독
iodize : vt, 요오드로 처리하다, 옥소를 가하다, 옥화하다
iodochlorhydroxyquin : n, (약)요오드염화 수소퀴놀린
iodoform : n, (화)요오드포륨
iodous : a, (화)요오드의, 요오드같은(에 관한)
IOJ : x, International Organization of Journalists
io moth : x, (미국의)노란대형산누에나방
ion : n, (화)이온, 양이온(cation), 음이온(anion)
ion : suf, 라틴어계동사 어미에 붙어서 (상태, 동작)을 나타내는 명사 어미
ion engine : x, (공)이온엔진(ion rocket)
ion etching : x, (물)이온에칭(금속등에 고에너지 이온을 쬐어 부식시키기)
ion exchange : x, (물, 화)이온교환
ionexchanger : n, (화)이온 교환체
Ionia : n, 이오니아(그리스의 Athens를 중심으로 하는 한지방)
Ionian : a, n, 이오니아(사람)의, (약)이오니아식의, 이오니아 사람
Ionian sea : n, 이오니아해
ionic : a, (물, 화)이온의
Ionic : a, n, 이오니아(식)의, 이오니아 방언의, (건)이오니아식의, 이오니아 운각의, 이오니아 방언, 이오니아 운각
ionic bond : x, (화)이온 결합
Ionic order : x, (건)이오니아 양식(기둥면에 flute(세로흠)이 있고 기둥머리 양쪽에 소용돌이 꼴이 붙음)
ion implantation : x, (물)이온 주입(법)(반도체를 얻는 방법의 하나)
ionium : n, (화)이오늄(방사성 우라늄의 동위 원소)
ionization : n, (화)이온화, 전리
ionization chamber : x, 전리함, 이온화함(방사선 측정 장치의하나)
ionize : vt, 이온화하다, 전리하다
ionizer : n, 이온화(전리)장치
ion milling : x, ION ETCHING
ionophore : n, (생화)이온 투과담체
ionosonde : n, 이오노전데(전리층 높이를 관측 조사하는
ionosphere : n, 전리층(성층권의 상부, 무선전파가, 반사됨)이온권, 전리권
ion propulsion : x, (우주선 등의)이온 추진
ion rocket : x, ION ENGINE
IOOF : x, Independent Order of Odd Fellows
ior : suf, 형용사의 비교급을 나타냄
ior, iour : suf, (..하는 사람)의 뜻
IOS : x, Intelligent office system
iota : n, 이오타(그리스말 알파벳의 아홉째 글자
iotacism : n, 이오타화(현대 그리스어에서 모음이나 이중 모음을 이오타음(영어의(i)음으로 발음하는경향
IOU : x, I owe you, 차용 증서
iour : suf, IOR
ious : suf, 의 특징을 가진..으로 가득찬의 뜻
Iowa : n, (북미 인디언의 부족명에서)아이오와(미국 중부의 주)
Iowan : a, n, Iowa주의(사람)
IP, I.P : x, initial point, innihgs pitched, intermediate, pressure
IPA : x, International Phonetic Alphabet국제 음표문자, International Publishers Association국제 음성학협회, International Publishers Association국제 출판인 협회
ipecac : n, (식)토근(남미산 꼭두서니과의 관목)그뿌리(토제, 하제용)
ipecacuanha : n, 
Iphigenia : n, )이피게니아(Agamemmon과 Clytemnestra의 딸)
IPI : x, International press Institute국제 신문편집자 협회
ipm : x, inches per minute
IPR : x, Institute of Pacific Relations태평양 조사회
ips : x, inches per second
ipse dixit : x, 독단, 독단적인 말
ipsilateral : a, (생리)(신체의)동측(성)의
ipsissima verba : x, 바로 그대로의 어구
ipso facto : ad, 그 사실에 의하여, 사실상
ipsojure : ad, 법률의 힘으로 법률상
Ipswich : n, 입스위치(잉글랜드 Suffolk주의 주도)
IPU : x, InterParliamentary Union국제의원 연맹
IPY : x, International Polar Year국제 극년
IQ : x, intelligence quotient
Ir : x, (화)(물)infrared
ir : pref, (r앞에 올때)
Ir. : x, Ireland, Irish
Ira : n, 남자의 이름
irade : n, 터키 황제의 칙령
Irak : n, IRAQ
Iraki : a, n, IRAQI
Irakian : a, n, IRAQIAN
Iran : n, 이란(아시아 남서부의 공화국, 수도 Teheran, 구칭
irani : a, =IRANIAN=PERSIAN
Iranian : n, a, 이란 (사람)의, 이란의말의, 이란(페르시아)사람 
iraq : n, 이라크(아시아 남서부의 공화국, 수도Baghdad)
iraqi : a, 이라크의, 이라크사람(의)
Iraqian : n, a, IRAQI
IRAS : x, IInfrared Astronnomical Satellite(천)적외선 천문 위성
irascibility : n, 
irascible : a, 성마른, 화잘내는, 성급한
irasciblely : ad, 
irate : a, (문어)노한, 성난(angry)
irately : ad, 
IRBM : x, Intermediate Range Ballistic Missile
IRC : x, International Red Cross
ire : n, (시, 문어)화, 분노(anger)
Ire, : x, Ireland
ireful : a, (문어)화난, 성난, 분노한(angry)
irefully : ad, 
irefulness : n, 
ireland : n, 아일랜드(Republic of Ireland와 Northern Ireland로 된섬)아일랜드 공화국
Irene : n, 여자 이름
Irene : n, (그신)평화의 여신(로마신화의 pax에 해당)
irenic : a, 평화의 평화적인, 협조적인peaceful)
irenical : a, 
irenicon : n, EIRENICON
irenics : n, 평화 신학(전체 기독교도 교파의 화합을 연구하는)
irenology : n, 평화학(연구)(국제 관계론의 일부)
IrGael : x, Irish Gaelic
Ir gene : x, (생화)Ir유전자(면역 응답 유전자)
irghizite : x, (지질)이르기스석(소련방Kazakh 공화국에서 발견된 실리카가 풍부한 텍타이트(tektite)
iridaceous : a, (직)붓꽃과의(특히)iris속의
irides : n, iris의 복수
iridescence : n, 무지개빛, 보는 각도에 따라 달라지는 빛, 훈색
iridescent : a, 무지개 빛깔의, 진주빛의, 훈색의
iridescently : ad, 
iridic : a, (화)이리듐(산)의 (을 함유하는), 홍채의
iridium : n, 리듐(금속의 원소, 번호 77, 기호 Ir)
irido : x, (연결형)무지개, 홍채, 이리듐의 뜻
iridologist : n, 
iridology : n, 홍채학, 홍채진단법
iridosmine : n, (화)이리도스민연 오스뮴과 이리듐의 합금)
iris : n, 홍채, 참붓꽃속의, 붓꽃, 훈색(무지개빛)의 석영, 여자이름, (그신)이리스(무지개의 여신)
iris diaphragm : x, (렌즈의)홍채조리개
Irish : a, n, 아일랜드의, 아일랜드 사람의, 아일랜드 사람, 아일랜드말, 아일랜드국민, 아일랜드군, 
Irish American : n, 아일랜드계 미국인
Irish bull : x, 그럴듯하나 모순된 말(표현)
Irish coffee : x, 아이리시 커피(위스키를 타고 생크림을 띄운 뜨거운 커피)
Irish daisy : x, 식용민들레
Irish English : x, 아일랜드 영어
Irish Free State : x, 아일랜드 자유국)
Irish Gaelic : x, 아일랜드에서 쓰는 게일말
Irishism : n, 아일랜드 풍(기질)아일랜드 말투(사투리)
Irishman : n, 아일랜드 사람
Irish moss : x, CARRAGEEN
Irish potato : x, 감자
Irish Renaissance : x, 아일랜드 문예부흥(19세기 말에 yeats, synge등이 일으킨 민족 적 문예운동)
Irish Republic : n, 아일랜드 공화국
Irish Republican Army : x, 아일랜드 공화국군(북아일랜드 민족 주의자의 반영)
Irishry : n, (집합적)아일랜드 사람, 아일랜드식(기질)
Irish Sea : x, 아이리시해(아일랜드섬과 잉글랜드 사이
Irish setter : x, 아이리시 세터(적갈색의 새사냥개)
Irish stew : x, 양고기, 감자, 양파등을 넣은스튜
Irish terrier : x, 아이리시 테리어(털리 붉음)
Irish whiskey : x, 아이리시 위스키(주원료는 보리)
Irish wolfhound : x, 아이리시 울프하운드(대형 사냥개)
Irish woman : n, 아일랜드 여자
irisin : n, (영)화면중앙에서 점점 퍼지기
irisout : n, (영)화면 전체에서 점점 중앙으로 좁히기
iritis : n, (병리)홍채염
irk : vt, 지루하게(지겹게)하다
irksome : a, 진저리(싫증)나는, 지루한(tedious)
irksomely : ad, 
irksomeness : n, 
Irma : n, 여지이름
IRO, I.R.O : x, International Refugee Organization
iron : n, a, 철, 쇠(금속원소), 철제 기구, 아이언, 다리미, 인두, (골프)쇠머리가 다린 골프채, 등자, 족쇄, 수갑, 다리교정기, 철제, 철분, 자동차, 권총, 총, 작살, 은화
iron : a, 쇠의, 쇠 같은 , 철제의, 견고한, 냉혹한
iron : vt, vi, 다림질하다, ...에 수갑을(차꼬를) 채우다, 쇠로 덮어 싸다, 장갑하다
iron age : x, 철기시대, (그신)흑철시대(golden, age, silver age, bronze age에 계속되는 가장 타락했던 시대)
ironbark : n, 단단한 껍질과 재질을 가진 유칼리 나무
ironbound : a, 쇠를 씌운, 단단한, 굽혀지지 않는, (해안등)바위가 많은
Iron Chancellor : n, 철혈 재상(독일의 정치가 Bismarck의 이칭)
ironclad : a, n, 철로 싼, 장갑의 (미)어길수 없는, 엄한(규약, 약속등), 장갑함
Iron Cross : x, (독일의)철십자 훈장
iron crutain : x, 철의 장막(소련측과 서방측을 갈라 놓는 정치적 사상적 벽(cf.BAMBOO CURTAIN
Iron duke : x, wellington공작의 별명
ironfisted : a, 구두쇠인(stingy)무정한, 냉혹한(ruthless)
iron founder : x, 주철 제조업자
iron foundry : x, 주철 공장
iron gray : x, 철회색의
iron gray : a, 철회색의
iron hand : x, 엄격, 압제, 가혹
iron handed : a, 압제적인
iron hearted : a, 냉혹한, 무정한
iron horse : x, 기관차(미)전차(tank)
ironic : a, 반어의, 반어적인, 빈정대는, 빗대는, 비꼬는, ironical()a, 
ironically : ad, 비꼬아, 반어적으로, (문장전체를 수식)얄궂게도
ironing : n, 다림질, (집합적)다림질하는 옷(천)등
ironing board : x, 다리미(인두)판
ironist : n, 빈정대는 사람
ironize : vt, vi, 비꼬듯이 말하다(행동하다)
ironize : vt, (영양소로)..에 철분을 섞다
ironlike : x, 무쇠처럼 강한
iron lung : x, 철폐(철제의 호흡 보조기)
iron man : x, 뛰어난 힘을 가진 사람, (야구의)철완 투수, 철인
iron master : n, 철기 제조없자
iron mold : x, 쇠붙이의 녹, 잉크 얼룩
iron mold : vt, 쇠녹(잉크)얼룩으로 더럽히다
ironmonger : x, (영)철물상(장수)
ironmongery : n, (영)철기류, 철물(업)철물점
ironon : a, 아이언으로 고착시키는
iron oxide : x, 산화철
iron pumper : n, 역기 운동(보디빌딩)하는 사람
iron pyrites : x, 황철광
iron ration : x, 비상 휴대 식량(통조림)
iron rule : x, 냉혹한 정치
iron sand : x, 사철
ironside : n, 굳센사람
ironsmith : n, 대장장이(blacksmith)
ironstone : n, 철광석, 철광
iron triangle : x, (미)철의 삼각지대(정부에 압력을 가하는 기업, 국회, 의원, 관료의3자)
ironware : n, 철기, 철물
ironwood : n, 경질목재, (흑단등)경질 수목
ironwork : n, pl, 9구조물의 철로된부분, 제철소, 철공소, 철제품
ironworker : n, 철공, 철공조립공
irony : n, (부드럽게)빈정댐, 빗댐, 풍자, 찌르는말, 반어, 비꼼, (운명등)예상외의 전개
irony : a, 쇠의 , 쇠로 만든, 쇠같은
iroquoian : a, n, 이로쿼이족(말)의, 이로쿼이 어족, 이로쿼이족의 사람
Iroquois : n, 이로쿼이족(의 사람)(new york주에 살았던 아메리칸 인디언), 이로쿼이말
IRP : x, (이란)Islamic Republican Party
irradiant : a, 찬한히 빛나는
irradiate : vt, vi, 비추다, 빛나다, 밝히다, 계발하다, (얼굴등을)기뻐서 빛나게 하다, (친절, 애교등을 )부리다, 쏟다, x선으로 치료하다, 일광(자외선)을 쬐다, 찬란히 빛나는
irradiated : n, 조사된(중성자)
irradiation : n, 및을 투사함, 조사, 방사, 광휘, 광삼, (배경을 어둡게 하면 발광체가 실물보다 크게 보이는 현상)뢴트겐(라듐)선 치료, (계발), 계몽
irradiative : a, 
irradiator : n, 방사선 조사장치
irrandiance : n, 광휘, (물) (방사선의)조사, (전)방사도
irrandiancy : n, 
irrational : a, n, 불합리한, 이성이 없는, 분별없는, 무리의 부진근수의(opp.rational)무리수
irrationalism : n, 비합리주의 , 무분별, 불합리
irrationality : n, 이성이 없음, 불합리, 부조리
irrationalize : vt, 불랍리(부조리)하게 하다
irrational number : x, 무리수
irrationaly : ad, 
Irrawaddy : n, 이라와디 강(버마에서 벵골만으로 흐르는 강)
irreclaimable : a, 돌이킬 수 없는, 회복(교정)할 수 없는, 개간할 수 없는, 메울(매축할)수 없는
irreclaimably : ad, 
irrecognizable : a, 인식할수 없는, 분간할수 없는
irreconcilability : n, 
irreconcilable : a, n, 화해할 수 없는, 조화되지 않는, 융화하기 어려운, 양립할수 없는, 모순되는, 비타협적인 사람, 서로 상충하는 생각(신념)
irreconcilably : ad, 
irrecoverable : a, 돌이킬 수 없는, 회복(회수)하기 어려운
irrecoverably : ad, 
irrecusable : a, 반대(거부)할수 없는
irredeemable : a, n, 되살 수 없는, 교정할수 없는, 구제하기 어려운, (국채)등이 상환되지 않는, (지폐가)불환의 무상환공채, 정시상환채권(기한전에당겨 상환하지 않는 채권)
irredeemably : ad, 
irredentism : n, (이탈리아)민족 통일주의, 실지회복주의, (이탈리아의 미수복지)를 합병하려는 운동
irredentist : n, a, 
irreducible : a, 뜻하는 상태(형태)로 만들(돌릴)수 없는, 감할(삭감할)수 없는.약불할수 없는, 정복불능의
irreducibly : ad, 
irreformable : a, 교정할수 없는, 구제할수 없는, 변경할수 없는
irrefragable : a, 논박할 수 없는, 다툴여지 없는, 확실한
irrefragably : ad, 
irrefrangible : a, 범할수 없는(법률등), (광)굴절하지 않는
irrefrangibly : ad, 
irrefutability : n, 
irrefutable : a, 반박할 수 없는
irrefutably : ad, 
irreg. : x, irregular(ly)
irregardless : =REGARDLESS
irregular : a, n, 불규칙한, 변칙적인, 고르지 못한, 같지않은, 갖추지 못한, (길등)울퉁불퉁한(행위등이)불법의, 반칙의, 무효의, 규율이 없는, 난잡한, 비정규병, 비정규군, 규격에 맞지 않는 상품, 2등품, 등외품
irregularity : n, pl, 불규칙, 변칙, 고르지 못함, 불규칙적인일(물건)반칙, 불법, 부정행위(사건)난잡한 행실, (길의)울퉁불퉁함
irregularly : ad, 불규칙적으로, 고르지 않게 , 부정기적으로
irrelative : a, 관계(관련) 없는, 연고가 없는, 대중이 틀리는
irrelevance : n, 부적절, 무관계, 엉뚱한, 엉뚱한말(진술)행위, 현대성의 결여
irrelevancy : n, 
irrelevant : a, 대중이 틀린, 엉뚱한 부적절한, 무관계한, 현대성이 없는, 시대에 뒤떨어진, 무의미
irrelevantly : ad, 
irrelievable : a, 구조(구제)할수 없는, 고통등 제거할수 없는
irreligion : n, 무종교, 무신앙, 반종교, 불경
irreligious : a, 무종교, 신앙심이 없는, 반종교적인, 불경한
irreligiously : ad, 
irremediable : a, 치료할 수 없는, 불치의, 돌이킬 수 없는(irreparable)
irremediably : ad, 
irremissible : ad, 용서하기 어려운, 면할수 없는
irremissibly : ad, 
irremovability : n, 
irremovable : a, 옮길(움직일)수 없는, 제거할(면직시킬)수 없는, 종신직의
irremovably : ad, 
irreparable : a, 수선(회복)할 수 없는, 돌이킬 수 없는
irreparably : ad, 
irrepealable : a, 법률이 폐지할수 없는, 취소(철회)할수 없는
irreplaceable : a, 바꿀수 없는, 대치할 사람(물건)이 없는
irrepressible : a, n, 억압할(억누를)수없는, 견딜수 없는, (충격)억제할수 없는 사람
irrepressibly : ad, 
irreproachability : n, 
irreproachable : a, 비난할 여지가 없는, 결점없는, 흠잡을 데 없는(blameless)
irreproachably : ad, 
irresistibility : n, 
irresistible : a, 저항할 수 없는, 억누를(억제할)수 없는, 사람을 녹이는(애교, 매력등)싫다, 좋다 할수없는
irresistibly : ad, 
irresoluble : a, 해설(설명)할수 없는
irresoluly : ad, 
irresolute : a, 결단력 없는, 우유 부단한, 우물쭈물하는
irresolution : n, 우유 부단한
irresolvable : a, 분해(분리, 분석)할 수 없는, 해결할수 없는
irrespective : a, (보통 다음성구로 전치사적으로 쓰여)...에 관계(상관)없는
irrespirable : a, (공기, 가스등)흡입할수 없는, 호흡하기에 맞지 않는
irresponsibility : n, 책임을 지지 않음, 무책임
irresponsible : a, n, 책임을 지지 않는, 책임이 없는, 책임감이 없는, 무책임한, 책임감이 없는사람
irresponsibly : ad, 
irresponsive : a, 반응이 없는, 응답하지 않는
irretention : n, 유지할수 없음
irretentive : a, 유지할수 없는
irretraceable : a, 되돌아갈수 없는, 돌이킬수 없는
irretrievable : a, 회복할수 없는, 만회할 가망이 없는
irretrievably : ad, 
irreverence : n, 불경, 불손, 불손한 언행
irreverent : a, 불경한, 불손한
irreverently : ad, 
irreversibility : n, 
irreversible : a, 거꾸로 할(뒤집을) 수없는, 역전(역행)할수 없는, 철회(취소)할수 없는, 변경할수 없는
irreversibly : ad, 
irrigable : a, 관개할 수 있는
irrigate : vt, vi, (토지에)물을 끌어 넣다(대다)관개하다(water), (외과)상처등을 관주하다, 관개하다, 관주하다
irrigation : n, 관개, 물을 끌어들임, (외과)관주법
irrigative : a, 관개(용)의
irrigator : n, 관개하는 사람, 관개차, 관주(세척)기
irritability : n, 화를 잘냄, 성급함, 자극( 반응), 흥분성
irritable : a, 화를 잘내는, 성마른(touchy), 안달하는(fretful), (자극에)반응하는, 민감한, 흥분성의(기관, 상처등)
irritable heart : x, (병리)과민심장
irritableness : n, 
irritably : ad, 
irritancy : n, 짜증, 안달, 화남
irritant : a, n, 자극하는, 자극성의, 자극제(물), 무효화하는
irritate : vt, 짜증나게(초조하게)하다, 화나게 하다, 안달하게하다, 자극하다, 염증을 일으키다, 무효로하다, 실효시키다
irritated : a, (..이)신경질이 난, 자극받은, 염증을 일으킨, 따끔따끔한
irritating : a, 흥분시키다, 자극하는, 아리게하는, 화나는, 비위에 거슬리는, 신경질나는, 짜증나는
irritatingly : ad, 
irritation : n, 짜증나게 함, 짜증, 격앙, 화, 짜증나는것, 자극하는것, (자극)상태, 염증, 아픔
irritative : a, 자극성의
irrupt : 돌입(침입, 난입)하다, (군중등이)분노를 폭발시키다, (개체수가)급격히 증가하다
irruption : n, 돌입, 침입, 침략, (동물의)대번식
irruptive : x, 돌입(난입, 침입)하는, (지질)INTRUSIVE
IRS, I.R.S. : x, Internal Revenue Service
IRSG : x, International Rubber Study Group(유엔)국제 고무 연구회
irtron : n, (천)적외선 천재
Irving : n, Washington (1783-1859) 미국의 작가
Irvingite : n, (경멸)어빙파의 신도, 카톨릭 사도 교회의 신자(cf.CATHOLIC APOSTOLIC CHURCH)
Irwin : n, 남자의 이름
is : vi, be의3인칭단수, 직설법 현재
is : x, (연결형)(등, 동, 동질 이성체의 뜻(모음 앞에서는 is, isochronism등시성
Is. : x, Isaiah, Island
is. : x, island(s), isle(s)
ISA : x, international standard atmosphere, International Sugar Agreement국제 설탕협정
Isa. : x, (성)Isaiah
Isaac : n, 남자이름, (성)이삭(Abraham의 아들, Jacob과 Esau의 아버지)
Isabel : n, 여자의 이름
Isabella : n, 여자이름(Elizabeth의 변형
isabella : n, a, (종종)회황색(의), 밀짚색(의)
Isabelle : n, 
isacoustic : a, 등음향
Isadora : n, 여자이름
isagoge : n, (학문에의)입문, 길잡이
isagogic : a, n, (특히 성서의 연혁을)안내하는, 서설적인, 성서서론, (문헌학적 연구의 길잡이)
Isaiah : n, 남자이름, (성)이사야(히브리의 대예언자, 기원전 720년경의 사람), (구약성서 중의)이사야서
isallobar : n, (기상)이살로바르, 기압등변화선
Isamael : n, (성)이스마엘(Abraham의 아들)세상에서 버림받은자, 사회의 적(outcast)
Isamaelite : n, 이스마엘의 자손, 사회의 적(Ishmael)
isatin : n, (화)이사틴(염료용)
ISBN : x, International Standare Book Number국제 표준 도서 번호
Iscariot : n, (성)이스가리옷(예수를 배반한Judas의 성), 배반자
ischemia : n, (병리)(혈관 수축에 의한)국소 빈혈
ischiadic : a, 
ischial : a, 
ischiatic : a, 좌골의 , 좌골신경의
ischium : n, (해)좌골
ISD : x, international subscriber dialing국제 다이얼 통화
ISDN : x, integrated services digital network(통신)통합 서비스 디지탈망
ise : suf, (영)IZE
isentropic : a, (물)등엔트로피의
Iseult : x, (아서왕전설)이졸데, (Cornwall왕의 아내, Tristram의 애인)
ish : suf, (형용사 명사에 자유로이 붙여서 쓰임)..의, ...에 속하는, ..성의
ISI. : x, Iron and Steel Institute
isinglass : n, 부레풀(물고기의 부레로 만듬), 운모(mica)
Isis : n, 이시스(고대 이집트의)풍요의 여신
Isl : x, island, isle
Islam : n, 이슬람교, 마호메트교, 회교, (집합적)전 회교도, 회교문화(문명), 전체 회교국
Islam : x, 이슬람 원리주의(cf. MOSLEM FUNDAMENTALISM)
Islambad : n, 이슬라마바드(파키스탄의 수도)
Islamic : a, 이슬람교의, 회교(도)
Islamic Republican Party : x, (이란의)이슬람 공화당
Islamism : n, 회교, 이슬람교(Mohammedansim)
Islamist : n, 
Islamite : n, 이슬람교도
Islamitic : a, ISLAMIC
Islamize : vt, 이슬람(교)화하다, 이슬람교를 신봉시키다
island : n, a, vt, 섬, 섬 비슷한 것, 고립된 언덕, (가로상의)안전지대, (미)대초원속의 삼림지, (해)(세포의), 섬, 세포군, (해), 항공모함 우현의)아일런드(브리지 포대, 굴뚝등을 포함하는 구조물), 섬의(insular), 섬으로 만들다, 고립시키다, (보통)수동형, (섬처럼)산재 시키다
islander : n, 섬사람, 섬의 주민, 섬나라 사람
island universe : x, (천)섬우주(GALAXY의 옛이름)
isle : n, vt, 섬, 작은섬, (산문에서는 고유명사와 함께만 씀), 섬에 살다
islet : n, 작은섬, (해)랑게르한스섬(췌장속에서 인슐린을 분비하는 세포군
isls., Isls. : x, islands, isles
ism : n, (구)이즘(doctrine), 주의, 학설
ism : suf, (행동상태작용), 체계주의, 신앙, 특성, 특징
Ismaili : n, 
Ismailian : n, 이스마일파의 신도(이슬람교shi'a파 중의 한파)
isn't : x, is not의단축
iso : n, (미속)독방
ISO : x, International Standardization Organization국제 표준화기구, International sugar Organization(유엔 국제 설탕기구)
iso- : x, (연결형)IS
isoagglutination : n, (의)(수혈에 의한)동종 응집(반응)
isobar : n, (기상)등압선, (물)동중체
isobaric : a, (기상)등압을 나타내는, (물)동중 원소의, 동중핵의
isobath : n, (해저, 지하의)등심선
isobutyl nitrate : (화)질산, 이소부틸(마약 상용자의 마약 대용품)
isocheim : n, 기상, 등한선
isochromatic : a, (광)등색의, (물)일정한 파장(주파수의)
isochronal : a, 등시(성)의
isochronism : n, 등시성, 등시운동
isochronous : a, 등시성의, 등시의
isocline : n, (지질)등사습곡
isoclinic : a, ISOCLINAL 2
isoclinic line : x, (물)등복각선
isodose : a, 등선량의 (등량의 방사선을 받는 점 지대의)
isodynamic, -ical : a, (물)등력의, 등자력의
isodynamic line : x, (물)등자력선
isoenzyme : n, ISOZYME
isogamete : n, (동형배우자)
isogamous : a, (생)동형 배우자에 의하여 생식하는
isogamy : n, (생)동형 배우자 생식, 동형배우
isogenic : a, (생)동원의 , 동생의
isogenous : a, (생)동원의, 동생의
isogloss : n, (어)등어선, (언어 특징이 다른 두 지방을 분리하는 선)
isoglucose : n, 이소글루코스(전분질 곡물에서 얻는 설탕 대용품)
isogonal : a, 
isogonic : a, n, 등각의, 등편각의, 등편각선
isohyet : n, (기상)등강수량선
isolable : a, 고립(격리)시킬수 있는
isolate : vt, 고립시키다, 격리(분리)시키다, 절연하다, (화)단리시키다, 유리시키다, (세균등을)분리하다
isolated : a, 고립된, 격리된, (화)단리된, (전)절연된
isolated camera : x, 비디오 재생용 텔레비젼 카메라
isolated point : x, (수)고립점
isolating language : x, 고립어(중국어)(cf, AGGKUTINATIVE Languge(교착어), INFLECTIONAL LANGUAGE(굴절어))
isolation : n, 고립, 격리, 분리, 교통차단, 고독(화)단리, (전)절연
isolation hospital : x, 격리 병원
isolationism : n, 고립 주의, (미정)고립주의(유럽의 정치간섭에 반대)
isolationist : n, a, 고립주의자(적인)
isolation ward : x, 격리병동
isolative : a, (언)(음변화가)고립적으로 생기는, 고립성의(cf.COMBINATIVE)
isolator : n, 격리하는 사람(물건)(전)절연체(insulator)
Isolde : n, ISEULT
Isolette : n, 미숙아 보육기(상표명)
isolinal : a, (물)등복각의, (지질)등사의 , 등경사의 등사습곡의
isolinally : ad, 
Isomer : n, (화)(동질)이성체
isomeric : a, 이성체의
isomerism : a, (화)이성, (물)핵종의, 핵이성
isomerous : a, 같은 수의 부분으로된, (직)꽃등 각부분이 등수의, (화)동질이성의
isometrical : a, 같은 크기(길이, 각, 용적)의
isometric exercise : x, 등척운동, 아이소메트릭스(isometrics)(벽, 책상등 고정된 것을 세게 밀거나 당겨서 하는 근육훈련)
isometrics : x, (단수, 복수취급)ISOMETRIC EXERCISE
isometry : n, (양, 액의)균등, (지)등고
isomorph : n, (화)(이종)동형체(물)
isomorphic : a, 같은 모양의, 동일 구조의, 등정형의
isomorphism : n, (화, 결정)유질, 동상, 동형, 이성
isomorphous : a, 
isoniazid : n, 이소니아지드, 이소니코틴산 하이드라지드(항결핵제)
isonicotinic acid hydrazide : x, (약)이소니코틴산 하이드라지드(결핵 치료제)
isonomy : n, (법적)동권, 권리평등
isooctane : n, (화)이소옥탄(휘발유의 내폭성 판별의 표준에 쓰는 일종의 탄화 수소
isophote : n, 등광도선
isopiestic : a, n, (기상)등압의(isobaric), 등압선(isobar)
isopleth : n, (수, 기상)등치선
isopod : n, a, 등각류의 동물, 등각류의
isopolity : n, (시민권등의)권리 평등, 상호권리
isoprene : n, (화)이소프렌(인조 고무의 원료)
isoprinosine : n, (약)이소프리노신(실험용 항바이러스제, 상표명)
isopropyl alcohol : x, 이소프로필 알코올(살균용)
isopycnic : a, 등밀도의 밀도차를 이용한 분리기술의
isoracy : n, 권력 평등주의
isoratic : a, 
isosceles : a, 이등변의(삼각형 따위)
isoseismal : n, 등진선의
isoseismic : a, 
isospin : n, (물)하전스핀, 아이소스핀
isostasy : n, (지질)(지각의)균형, 지각 균형설, 아이소스타시
isostatic : a, 지각 균형설의
isotherm : n, 등온선
isothermal : a, n, 등온선의, 등온층(선, 대), 등온선
isothermal region : x, STRATOSPHERE
isothermaly : ad, 
isotone : n, 동중성자핵
isotonic : n, (화, 생)등장의(용액), (생리)등(긴)장의 (근육), (음)등음의
isotope : n, 동위원소, 동위체, 핵종
isotopic : a, 동위 원소의
isotopic spin : x, ISOSPIN
isotron : n, 아이소토론(동위원소의 전자 분리기의 일종)
isotropic : a, 등방성의
isotropy : n, (물, 동)등방성
isotype : n, (생)동기준표본, 아이소타이프(그림 그래프의 단위가 되는 그림, 도형)그림 그래프
isotypic : a, 
isozyme : n, (생화)동질(동위)효소
Isp : n, (로켓의)추진력
Ispy : x, 숨바꼭질(hind and seek)
Isr. : x, israel, Israeli
israel : n, 이스라엘 (유대인의 공화국 수도, Jerusalem), (성)야곱의 별명, , (집합적, 복수취급)이스라엘 사람, 유대사람, 하느님의 선민, 그리스도 교도
Israeli : a, n, (현대)이스라엘 사람, (현대의)이스라엘의 (사람)
Israelite : n, a, 이스라엘(유대) 사람, 하느님의 선민, 이스라엘의 유대의
Israelitish : a, 
ISRD : x, International Society for Rehabilitation of the Disabled신체장애자 갱생 국제협회
ISSN : x, International Standard Serial Number
issuable : a, 발포(발행)할수 있는, (법)소송 쟁점이 될수 있는
issuance : n, 배급, 급여, 발행, 발포
issue : n, 발행물, (특히 출판물의)발행부수, (제..)판(쇄), 발행, 발포(어음등의)발행, 유출점, 출구, 하구, 유출, 쏟아져나옴, 유출물(과정의)결과, 결말, 논(쟁)점, 계쟁점, 문제점, 논쟁, 토론, (법)자식, 자녀, 자손, 
issue : 나오다, 나서다, 유출하다, 분출하다, (결과로)끝나다, 유래하다, 비롯되다, 생기다, (법)자손으로서)태어나다, 나오다, (명령, 면허증등을)내다, 내리다, 발행한, 발포하다, (피, 연기)등을 내다, (배급)지급하다, 넘겨주다, 간행(발행)하다, 출판하다, 유포시키다, (어음을)발행하다
issueless : a, 자식이 없는, 결과가 없는
issuer : n, 발행인
ist : suf, ..하는 사람, ..을 신봉하는 사람, ..주의자, ..가의 뜻
Istanbul : n, 이스탄불(터키의 옛수도, 구칭은Constantinople)
isth. : x, isthmus
isthmian : a, n, 지협의, 지협에 사는 사람
isthmian canal zone : n, 파나마운하 지대
isthmian games : x, 코린트지협 경기 대회(옛날 2년에 한번씩 거행)
isthmus : n, 지협, Panama 지협, 수에즈 지협, 협부
istle : x, 열대 아메리카산 용설란 무리의 섬유(밧줄등의 원료)
Istria : x, 이스트리아(아드리아해 북단의 반도)
ISV : x, International Scientific Vocabulary
it : n, (술래잡기의)술래, (구)극치, 지상, 이상, 중요인물, 제1인자, (속)성적매력(sex appeal), 이탈리아산 베르무트
IT&T : x, International Telephone and Telegraph Corporation(미)국제전화 전신회사
it'd : x, (구)it had(would)의 단축형
it'll : x, (구)it will의 단축형
it's : x, (구)it is, it has의단축형
It.Ital. : x, Italian, Italy
ITA : x, International Tin Agreement, Independent Television Authority , International Tin Agreement , Initial Teaching Alphabet
ital : x, italic(s)
Italian : n, ITALY
italian : a, n, 이탈리아(사람, 말)의, 이탈리아사람(말)
Italianate : a, 이탈리아 화한, 이탈리아식의
Italian cloth : x, 공단의 일종(안감용)
Italian dressing : x, 마늘, 오리건(origan)으로 맛들인 셀러드 드레싱
Italian greyhound : x, 이탈리아종 그레이하운드(애완용)
Italian hand(writing) : x, 이탈리아 서체(중세 이탈리아에서 발달한 필기체)
Italianism : n, 이탈리아식;이탈리아 기질, 이탈리아 말투
Italianist : n, 
Italianize : vt, vi, 이탈리아식으로 하다, 이탈리아화하다
Italian sandwich : x, 이탈리아 센드위치(submarine)
Italian sonnet : x, (시학)이탈리아식 소네트
Italian vermouth : x, 이탈리아 베르무트(단맛이 나는)
Italian warehouse : x, (영)이탈리아 특산물점
Italian warehouseman : x, (영)이탈리아의 특산물상인
italic : a, n, (인)이탤릭체(사체의), (특히 고대)이탈리아(사람, 말)의, 이탈리아어계, 이탈랙체, (어)이탈리아어계, 
Italicism : n, ITALIANISM
italicize : vt, vi, 이탤릭체로 인쇄하다, 이탤릭체를 사용하다, 이태릭체를 지시하는 밑줄을 긋다
italic type : x, (인)이텔릭체, 사체
Italo- : x, (연결형)(이탈리아의, 이탈리아와..간의)의 뜻
Italophile : a, n, 이탈리아를 좋아하는(편드는)(사람)
Italy : n, 이탈리아(유럽 남부의 공화국, 수도 Rome
ITC : x, International Tin Council(UN)국제 주석이사회(본부 LONDON), International Trade commission(미)국제 무역위원회, International Traders Club
itch : n, vi, 가려움, (병리)옴, 참을수 없는 , 욕망, 갈망, 가렵다, 근질근질하다, 못견디다, 
itchiness : n, 
itching : a, n, 가려움, 하고싶어 못견딤, 갈망, 가려운, ..하고 싶어 못견디는
itch mite : x, 옴벌레, 개선층
itchy : a, 옴에 걸린, 가려운, 근질근질한, 탐이나서 안달하는, 갈망하는
ite : suf, (명사, 형용사 어미)..의 사람(의), ..을 신봉하는 사람(의)의 뜻, 화석, 염류, 폭약, 상품등의 명칭, 형용사, 명사, 동사, 등의 어미
item : n, ad, vt, (마찬가지로의 뜻에서), 항목, 조목, 조항, 종목, 품목, 세목, (신문기사의)1항, 한절(항목), 하나..(항목을 차례로 열거할 때, 또 마찬가지로 , 또한, 항목별로 쓰다
itemant : a, 반복하는
itemization : n, 항목(조목)별 기재
itemize : vt, 항목(조목)별로 쓰다, ..의 명세를 적다
item veto : x, (미)의결 법안의 일부에 대한 주지사의)부분 거부권
iterate : vt, 되풀이하다(repet)
iteration : n, 되풀이, 반복(repetition)
iterative : a, 되풀이하는, 반복의
ITF : x, International Trade Fair국제 무역 견본시, International Trade Federation국제 운수 노조 연맹(본뷰(LONDON)
it girl : x, (thr)섹시한(매력적인)여자
Ithaca : n, 이타카(그리스 서쪽, 신화의(Odysseus의 출생지)
Ithun(n) : n, IDUN
Ithuriel's spear : x, 이수리엘의 창, 진위를 가리는 확실한, 기준(Milton의 paradise Lost에서 마왕의 정체를 폭로한 천사의 창)
ithyphallic : a, n, 주신 Bacchus축제의, 축제에 쓰는 남근상(phallus)의, (그림, 조각이)발기한 페니스를 가진, 음란한(Bacchus) 찬가용, 운율의 Bacchus 찬가 운율의시 , 음란시
ithyphallitic : suf, (염증의)의 뜻, (arthritic), ..의 뜻(Semitic
itineraition : suf, 동작상태를 나타냄
itineraitious : suf, 의 성질이 있는의 뜻(ambitious)
itineraititis : suf, 염증의 뜻(bronchitis)(익살)(광)의 뜻(golfitis)
itineraitive : suf, 라틴어계의 형용사및 명사 어미
itinerancy : n, 순방, 순회, 순력, 편력, 순회(순방)자의 단체, 순회 설교, 순회제도, 순회를 요하는 직무(임무)
itinerant : a, n, 순회(순방)하는, 편력중인, 지방순회의, 순방자, 편력자, 순회 전도사(판사), 도붓장수, 지방순회 공연배우(흥행사)등
itinerant electron : x, (물)편력전자
itinerary : n, a, 여행스케줄, 여정, 도정, 여행기, 여행일기, 여행안내서, 순방(순회)하는, 편력하는, 여정의 여로의
itinerate : vi, 순방(순회)하다, 순유하다, 순회, 설교하다
itineration : x, ITINERANCY
ITO, I.T.O : x, International Trade Organization
itous : suf, ITY(명사 어미)에 대응하는 형용사를 만듬
its : pron, (it의 소유격)그것의
itself : pron, 그것 자체, 바로 그것, (it의 재귀형)그 자체를(에), 평소의 그것, 정상적인 그것, 
itsybitsy : a, ITTYBITTY
ITTC : x, International Telephone and Telegraph Corporation
ITTF : x, International Table Tennis Federation
ittybitty : a, (익살)조그마한, 하찮은, (영구)(공들였으면서)짜임새 없는, (방, 디자인등)
ITU, I.T.U : x, International Telecommunication Union(유엔)국제 전기 통신동맹
itude : suf, 추상 명사를 만듦
itude : suf, 
ITV : x, industrial television(영)상업 텔레비전망, industrial television공업용 텔레비젼, instructional telesion교육 텔레비전
ity : suf, (추상명사 어미)(상태, 성질, 정도)등을 나타냄
IU : x, international unit (생)비타민량효과 측정용), 국제 단위
IU(C)D, I.U.(C.)D. : x, intrauterine (contraceptive)device자궁내 피임기구(링)
ium : suf, (라틴어계 명사 어미), medium, premium, 화학 원소명 어미radium
IUS : x, (로켓)inertial upper stage
IV, i.v : x, initial velocity, intravenous(ly)
Ivan : n, 남자이름
Ivanhoe : x, 아이반호(Walter Scott의 소설(1819)또 그주인공
Ivan ivanovich : x, (전형적인)러시아 사람(cf.JOHN BULL)
IVB : x, invalidity benefit
ive : x, (.. 한 경향, 성질을 가진)의 뜻native, captive, festive, sportive
ivied : n, 담쟁이로 덮인, 담쟁이가 무성한
Ivorian : a, n, 코트디부아르(공화국), (Ivory Coast)에 관한, 코트디부아르(공화국)의 국민(주민)
ivoried : a, 상아 비슷한, 상아, 같은
ivory : n, 남자 이름
ivory : n, a, 상아, (하마, 해마등의)기다란 앞니, 상아로 만든것(당구공, 피아노의 건반 주사위등)이, 치아, 상아색, 상아로된(만든)상아 같은
ivory black : x, 아이보리 블랙(상아를 태워 만든 흑색 그림 물감
ivory Coast : x, 코트디브와르(서아프리카의 공화국, 수도Abidjan)
ivory dome : x, (미속)지식인, 전문가
ivory nut : x, ivory palm의 열매
ivory palm : x, (식)상아야자나무
ivory paper : x, 아이보리 페이퍼(화가가 쓰는 고급종이
ivory tower : x, 상아탑(실사회와 동떨어진 사색, 몽상의 세계)
ivory towered : a, 속세를 떠난, 상아탑에 사는, 멀리 인적이 끊긴
ivory towerish : a, 
ivory towerism : n, 현실 도피주의
ivy : n, a, vt, (직)담쟁이 덩굴, IVY LEAGUGE의 대학, 학원의, 학구적인, 순학리적인, 담쟁이로 장식하다(덮다)
ivy league : a, 아이비 리그(미국북동부의 오랜 전통을 가진 명문 8대학, 아이비리그의(적인)
ivy vine : x, (식)야생 포도의 일종(미국 중부산)
IWA : x, International Whaling Agreement, 국제 포경 협정
IWC : x, International Whaling Commission, International Wheat Council(유엔)국제 소맥 이사회(본부(LONDON)
iwis : ad, (고)꼭 확실히(certainly)
ix : suf, (or(남성명사)에 대한 여성 명사어미)
ixia : n, (식)익시어(참붓꽃의 일종이며 남아프리카 원산)
Ixion : n, (그신)익시온(Hera를 범하려다 Zeus의 노염을 산 테살리아(Thessaly)의 왕), (물)익사이온(제어핵융합 연구의 실험용 자기경)
Ixion's wheel : x, (그 신)Zeus에 의해 Ixion이 묶인 영원히 회전하는 불의 수레바퀴
IYDP : x, International Year of Disabled Persons국제 장애자의 해(1981)
IYY : x, International Youth Year
ization : suf, (동사 어미에 대응하는 명사어미)
ize : suf, ...으로 만들다, , , 화 하다의 뜻
Izvestia : n, 이즈베스티야(소련정부 기관기)
izzard : n, (방)z자
izzat : n, (인도)명예, 명성, 체면, 자존심
