h.dic
haberdash : vt, (양복을0짓다, 유행형으로 디자인하다, (양복에)장식적인 디자인을 하다

hackwork : n, (돈벌이를 위한 예술 작품 등의)하청 작업, 9특히 삼류 작가의)매문쓰기

hade : n, vi, 언각(단층, 광맥 등의 경사를 수직면에서 잰 각도, 언각을 이루다, 기울다

Haggada0h) : n, 핫가다(탈무드중의 비율법적인 교훈적 이야기, 유월절 축하연에 사용되는 전례서)

hair implant : x, 인공 식모(술, 법)(인공적으로 모발을 두피에 심는

hairpiece[h'35~rp`i:s)(여성용)헤어피스, (남성용)가발

hair trigger : x, (총의)촉발 방아쇠, 민감한 기구(반응

Haitian Creole : x, 아이티프랑스말(프랑스말을 모체로 한 아이티말, 현재는 대부분의 아이티 사람이 사용함

Halaphone : n, 할라폰(전자 음향(효과) 장치(악기), 오케스트라 연주 중에 갖가지 음향 효과를 더해 주는

halfball storke : x, 하프볼 스트로크(공의 중앙을 쳐서 표적공의 가장자리에 맞히기

half binding : x, (책의 등과 모서리만 가죽인 반가죽 장정

halfboard : n, (호텔, 하숙 등에서의)부분적 식사 제공, 1박 2식9제공)(demipension), 하프보드(범주하는 조선법의 하나)

half hunter : x, 하프 헌터(유리 보호용 케이스가 있는 회중시계

HamitoSemitic : n, a, 햄셈어족(의)(Afro-Asiatic의 옛이름

hammerlock : n, (레슬링)해머록(상대편의 한쪽 팔을 등뒤로 틀어 올리기

hanging wall : x, 상반(경사진 광맥 등의 위쪽 암층

haptic lens : x, 공막 렌즈(백안부)까지 덮는 콘택트 렌즈)

hard bubble : x, 하드버블(컴퓨터 회로에서 기억의 분열을 일으키는 자기 버블

hard copy : x, 하드 카피(컴퓨터의 처리결과를 눈으로 읽을 수 있는 형태로 인쇄한 것

hardedge : n, a, 하드에지(의)(기하학적 도형과 선명한 윤곽의 추상 회화

hard rock : x, 하드 록(앰프를 사용하여 규칙적인 비트로 연주하는 록

hard science : x, 자연 과학(물리학, 화학, 생물학, 지질학, 천문학 등

Hare krishna : n, 하헤크리슈나(힌두교의 Krishna 신에게 바친 성가의 제목, (하레)크리슈나교(도)

harem pants : x, 하렘 바지(발목 부분을 끈으로 묶게 된 통이 넓은 영성용 바지

Hawaii time : x, =Hawaiian Standard Time하와이 표준시(GME보다 10시간 늦고 시간대는 Alaska Time와 같음

headboard : n, (침대 등의)머리쪽 판자, 울의 머리쪽 판자9소 등을 고삐로 매는)

headtohead : n, a, 접근전, 접9근)전의

heath hen : x, 검은 멧닭의 암컷, 히스헨(지금은 멸종한 북미산 멧닭의 일종

heat island : x, 열섬(주변보다 온도가 높은 도시(공업 지대)

heaveho : int, n, vi, vt, 영차(닻줄을 감을 때의 소리, 퇴자놓기, 퇴자놓다

hebetic : a, (Gk 젊은의 뜻에서, 사춘기의, 사춘기에 일어나는

heh : int, 쳇!, 허허!, 엣!(경멸, 가소로움, 놀람, 반문 등의 소리

helihome : n, 헬리홈(헬리콥터와 모터홈을 결합시킨 것

herb tea : x, (약초를0달인 약, 탕약, =herb water

hisandhers : a, (상품이)남녀(부부(용 한 벌씩의)

histiochemistry : n, 조직 화학(조직내의 여러 물질의 성질, 분포를 연구하는

hobbit : n, 호빗(영국의 작가 John R Tolkien의 작품에 나오는 가공의 난쟁이

hole puncher : x, 펀처(종이에 구멍 뚫는 사무용구

Holy Innocent's Day : x, 무죄한 어린이들의 순교 축일(Herod왕명으로 Bethlehem의 갓난 아이가 살해된 기념일(12월 28일)

homeostasis : n, 항상성(신체 내부의 체온.화학적 성분등이 평형을 유지 조절되는 일

homeroom : n, 홈룸(학급 전원이 모이는 생활 지도 교실(시간)

Homo habilis : n, 호모하빌리스(최초로 도구를 만든 것으로 보이는 약 200만년전의 사람

homonymy : n, 동음9형)이의, 동명 이물

hooked schwa : x, 훅트시와(발음 기호)의 명칭, 이 사전의(5~r, 에 해당

hoove : n, 고창증(가축의 위가 가스로 부풀어 오르는 병

Hooverville : n, (미)1930년대 불경기 때의)실업자 수용 주택(지구)

hoppicker : n, 홉 따는 사람(기계

Horeb : n, 호렙산(모세가 율법을 받은 산;보통 Sinai와 동일시됨

horizontal divestiture : x, 수평박탈(한 회사가 유시 제품을 생산하는 다른 사업이나 회사의 지주를 처분하는 일

horizontal pricefixing : x, 수평적 가격 유지(가격 경쟁을 피하기 위한 가격 협정

Horn of Africa : n, 아프리카의 뿔(아프리카 대륙 북동부, 소말리아 공화국과 그 인근 지역

hors d'oeuvre : n, 오르되브르, 전채(수프 전에 나오는 가벼운 요리

Hosea : n, 호세아서(의 저서) (기원전 8세기의 히브리의 선지자

hour angle : x, 시각(자오선과 천제가 이루는 각도

housefather : n, 9기숙사 등의)사감

hovertrain : n, 호버트레인(자력에 의한 공기 쿠션을 이용한 고속 열차

hubblebubble : n, 물 담뱃대, 수연통, 부글부글9소리), 와글와글

human growth hormone : x, 인간성장 호르몬(인체의 성장을 지배하는 뇌하수체 종합 호르몬

hurly : n, (hurlyburly의 단축형, 소동, 혼란, hurley

hush kit : x, (제트 엔진용)소음 장치(흡음형 내통과 개량형 노즐의 조합

Hussein : n, 후세인(1935-)(요르단왕(1952-)

hybridoma : n, 하이브리도마(암세포와 정상세포를 융합하여 만든 잡종 세포, 단 클론 항체를 산출함

hydraulic system : x, 유압 장치(계통)(유압으로 조종계통이나 착륙장치를 작동시키는

hylozoism : n, 물활론(생명과 물질이 서로 불가분의 관계에 있음을 주장함

hypercharge : n, vt, 하이퍼차지(소립자의 하전 상태를 나타내는 연산자, ~에 지나치게 집어넣다(부과하다)

i.dic
Iago : n, 남자 이름, 이아고(Shakespeare 작 othello에 나오는 음험하고 간악한 인물

ibex : n, 아이벡스(알프스.아펜니노.피레네 산맥 등에 사는 야생 염소

Ibsen'ism : n, 입센주의(문제극의 형식으로 사회의 인습적 편견을 적발함

Icarus : n, 이카로스(밀로 붙인 날개로 날았는데 너무 태양에 접근했으므로 밀이 녹아 바다에 떨어졌다는 인물

Iceland : n, 아이슬란드(북대서양의 공화국, 수도, -er 아이스란드 사람

icelolly : n) 막대기가 있는 아이스 캔디

iceout : n, 해빙(호수면 등의 얼음이 녹기

ice shelf : x, 빙붕(ice sheet의 해상에 나온 말단

iceup : n, (눈물의)빙결, 동결, 착빙(고체 표면에 대기중의 수분이 얼어 붙기

ician : suf) 에 능한 사람, 을 배운사람

id : x, IDE의 변형, sstr(Isesse

idioglossia : x, 구어부전(이해 불가능한 발음을 함

Idiom Neutral : x, 이디엄 뉴트럴(1902년에 발표된 인공적 국제 보조어

idiot light : x, 이상 표시등(배터리 오일 휘발유 등의 부족 이상을 자동으로 표시

idle wheel : x, 유동바퀴(2개의 톱니바퀴 사이에 쓰는 톱니바퀴

IDP : x, inosine diphosphate 2인산 이노신, integrated data processing(집중 데이타 처리, international driving permit(국제 운전면허)

IKE : x, 아이크(Dwight D. Eisenhower의 애칭

Il Duce : x, 일 두체(파시스트 당수mussolini의 칭호

illusion : n, 환영, 환상, 착각, 오해, 미망, 투명한 명주망사(여성용 베일등에 쓰이는

im : pref, (b, m, p앞에 올때의 변형

imagineering : n, 이미지니어링(새로운 경영 관리 기술, 기술자의 창조력을 높이는 기술 또는 공학

imago : n, (나비, 나방등의 )성충, (정신분석)(양친등의)면모, 영상(어렸을때의 사랑의 대상이 이상화된 것

imbecile : n, a, 저능(한), 우둔(한), 매우 어리석은(stupid), 허약한(feeble), 저능한 사람 바보(심)치우(지능도가 IDIOT 보다 높고 MORON 보다 낮아 3-7세 정도인 저능자

imbricate : vt, vi, a, (잎, 비늘등 겹쳐진, 미늘을 단(over), 비늘 모양으로 겹쳐진, 비늘모양으로 겹쳐진, 비늘, 모양으로 겹치다, 미늘을 달다

imbroglio : n, ((연극의)복잡한 줄거리, (사물)의 뒤얽힘, 분규, 혼란

immediate constituent : x, (문법)직접 구성요소(문장을 차례로 2개의 하위 구분으로 나누어 갈때의 그 한쪽 보기

immersion : n, 액체속에 담금, (기독교)침례, 열중, 골몰, 몰두, (형용사적)(외국어의)집중 훈련의, (천)잠입, (한천체가 다른 천체의 뒤 또는 그늘에 숨는일

immovability : n, 부동(성, 

immunity bath : x, 면책, 특권, 기소(소추)면제, (증언을 얻기 위해 증인에 대한 기소를 면제함

impact crater : x, 충돌 화구(운석이나 화산 분출물의 낙하로 생긴 크레이터

impaction[imp'4k95n)꽉 들어차게함, 밀착시킴, 눌러댐, (의)(신체의 일부의)매복(증)

impala : n, 임팔라(아프리카산 영양

impartial : a, 치우치지 않은, 편견이 없는, 공평한, 공명정대한(fair, 

impartible : a, (부동산등을)분할할 수 없는, 불가분의(indivisible, 

impeach : vt, (미)(공무원 등을)탄핵하다, 비난하다, 탓하다(charge)...의 허물로)..의 과실을 나무라다, ..에게 죄를 취우다, 고소(고발)하다, (명예, 인격등을)의심하다, 문제삼다

imperial : 제국의, 대영제국의, 대영제국 제정의, 황제의, 황후의, 황실의, 제권의, 제위의, 최고 권위의, 최고 권력을 가진, 장엄한, 당당한(majestic), 거만한, 건방진(상품이)특대(고급)의, 우수한, (도량형이)영본국의 법정표준을 따른, 황제수염(나풀레옹 3세의 수염식으로아랫입술밑에 끝이 뾰족하게 기른, 승합마차의 지붕(에 싣는 여행용 트렁크), 특대품, 질이 좋은 물건, 제정 러시아의 금화

imperial presidency : x, (미)제왕적 대통령제(초헌법적으로 강대해진 미국 대통령의직(지위)

impersonal verb : x, 비인칭 동사(항상 제3인칭 단수

impi : n, 남아프리카 Zulu 또는 Kafir족 전투원의)대부대

impiety : n, 불경, 불손, , 신앙심이 없음, 경건하지 않음, 신앙심 없는(불경한, 사악한 행위(말)

implantable pump : n, (의)매몰식 펌프(체내에 삽입하여 약제를 주입하는 장치

implosive : n, ((폐쇄음이)내파의(cf, implode), 내파음

impolicy : n, 졸책(bad policy

impossible art : x, 개념예술(conceptual art

impound : vt, (밖에 잘못나간 가축 등을) 우리속에 넣다, (물건을) 둘러싸다, (사람을)가두어 넣다, (물을 관개용으로) 모으다, 받다, (법)사람을 구치 감금하다, (물건을)몰수(압수하다(confiscate)

impoverish : vt, (사람, 국가 등을)가난하게 하다, (토지 등을)메마르게 하다, 불모로 만들다, 약하게 하다, 허약하게하다, 흥미(변화, 매력(등)을 잃게하다, 지루하게(따분하게)하다

impropriator : n, (영국교)교회 재산을 보관하는 속인)

improver : n, 개량, 개선하는 사람(물건), 식품 첨가물(특히 방부제)수습공(임금 없이 또는 저임금으로 기술을 배우는

impulse charge : x, 충격 장악(로케, 미사일)등을 발사기에서 이탈시키는 데 쓴 폭약)

impurity : n, 불결, 불순, 음란, 외설(obscentiy)불순물, 혼합물, 불순한(부도덕한 행위, 

inaugurate : vt, 취임식을 거행하다, 취임시키다(미)에서는 특히 대통령에게씀, (보통 수동형으로, 낙성식(개업식, 발족식)을 거행하고 공공 시설을 쓰기 시작하다, (새 시대를 개시하다..의 막을 열다

incarnadine : a, vt, n, (시)분홍색의, 담홍색의, 살색, 분홍색, 붉게 물들이다, redden)

incarnate : , vt, 육체를 갖춘, 육체를 입은, 성육한, 사람의 모습을 한, (관념, 추상물등이)구체화한, 육체를 부여하다, (보통 수동형으로 써서 (..의 육체(모습)을 가지다)의뜻이 됨, ..의 화신이 되다, 구체화하다, 구현(실현)시키다

incarnation : n, 육체를 부여함, 인간화, 구체화, 실현, 권화, 화신, (의)육아발생, (하느님이)육신을 입으심, 성육신(인간을 구원하기 위해서 그리스도가 하느님의 아들로서 육신과 인간성을 가지고 지상에 태어난 일))

incensory : n, 달아매는 향료(censer, 

incertitude : n, 불확실, 부정, 불안정(unvertainty, 의혹

incidence : n, (사건, 영향의)범위, 발생, 발생률, 발병률, 떨어짐, 추락, 낙하, 부담, 귀착, (물)투사, 입사, (물)투사각, 입사각, (공)영각(동체기준선에 대하여 주익이 이루는각

incomprehensible : a, n, 이해할수 없는, (특히)신의 속성이)인식할수 없이 무한한, 무한(불가해)한것

incorporation : n, 혼인, 혼합, 결합, 합동, 합병, 편입, 결사, 법인, 단체, 회사(corporation), (법)법인격 부여, 법인, (미)회사)설립, 문서병합, (언)포합

incrassate : (약)증발등으로)액체를 농축하다(직, 동)비후한:vt, a, 

increase : 늘다, 불어나다, 증가(증대, 증진)하다, 커지다, 강해지다, (유의어increase 수량정도등이 증가(증대)하다, enlarge 크기 양 등이 증가하다, multiply 수량이 배증하듯 늘어나다, 번식하다, 증식하다, (달이)차다, 늘리다, 불리다, (opp.diminish)(영토등을)확장하다, 증강하다, (국제 긴장등을)격화시키다, 증가, 증대, 증진, 증식, 확대, 상승, 번식, 자손(의 번식)증가액, 증대량, 이익, 이자

increscent : a, 증대하는(특히)달이 점점차는, 상현의opp.decrescent)

inculcate : vt, 사실, 사상, 지식, 습관을)되풀이하여 가르치다, 열심히 설득하다, (의 마음에 가르치다)(사상, 감정등을)..에게 주입하다, 심어주다

indent : 톱니모양을 자국을 내다, 톱니모양으로 만들다, 만입시키다, 쑥들어가게 하다, (두 통으로 작성한 계약서등을)톱니모양으로 찢다, (계약서 등을)두통작성하다, (인)새로 시작되는 줄의 첫머리를안으로 약간 넣어 짜다, 9영)두장 잇달린 주문서로 주문하다, (한장은자기가 보관), (영)두장 잇달린 주문서를 발행하다, 톱니 모양, 오목함, 옴폭함, 옴폭한 땅, 두장잇달린 계약서, (영)신청청구, (상)주문서, 구매위탁, 수탁구매품, (해외로부터의)주문, (인)새로 시작되는 줄의 첫머리를)들여짜기

indexation['indeks'ei95n)(경)전면적 물가 슬라이드제, 지수화방식에 의한 가치 수정

index crime : x, (FBI의 연차 보고에 공표되는 중대 범죄

indexlink : vt, (경)(연금, 세금등을 물가에 슬라이드 시키다

Indian paper : x, 인디언지(얇고 불투명한 인쇄용지, 사전등에 씀

Indian Territory : x, (미사)인디언 특별 보호구(인디언 보호를 위해 특설한 준주, 지금의 Oklahoma동부지방, 1907년에 폐지

Indian wrestling : x, 인디언씨름(팔씨름, 밀고 당기는 씨름등

indicatory : a, 지시(표시의)indicative)

Indra : n, (힌두교)인타라(우뢰나 비를 주관하는 veda교의 주신, 불교의 제석천에 해당

ineffable : a, 말로 표현할 수 없는, 말해서는 안될 만큼)신성한

inertia selling : x, 타성 판매 강매 (멋대로 상품을 보내놓고 반품하지 않으면 대금을 청구하는 방식

inextinguishable : a, (소멸(말살)할수 없는, (불등)끌(지울)수 없는, (감정등)억제할수 없는, 억제할 수 없는

infamous : a, 수치스런, 불명예스러운, 파렴치한, 악명높은, 악랄한, 악독한(나쁘기로)이름난, 지긋지긋한, 지독한, 아주나쁜, (법)파렴치죄로)공민권을 박탈당한

infantile paralysis : x, 소아마비(지금은poliomyelitis라고함

inflationary : a, 인플레이의 통화팽창의), 인플레이션을 일으키는

inflectional[굴곡의, 굴절, (활용어미)변화의 (이 있는, 억양의

informapauperis : ad, (법)소송 비용을 면제받는)극빈자로서

information pollution : x, (정보 공해(방송 출판등으로 인한 정보 과다)

informed consent : x, (의)고지에 입각한 동의(승낙)수술의학 실험에 대한 환자의)

ingenious : a, (재간(재치)있는, 영리한, 교묘한, 정교한, 독창적인, 창의력이 있는

ingenue : n, 천진난만한(순진)한 소녀, 그역을하는  여배우)

ingoing : a, n, 들어오는, 들어옴, 새로 집터를 빌린 사람이 치르는)정착물건비

Inner Light : x, 내적인 빛(퀘이커 교도가 마음 속에 느끼는 그리스도의 빛

Innsbruck : n, 인스브루크(오스트리아의 관광도시, 

inositol : n, 이노시톨, 근육당, (비타민 B복합체의 하나

inplace : x, (미정)반대당에 잠입한)정치 스파이

inquiry station : x, (전산)문의 스테이션(중앙 계산 시스템에 원격 문의를 보낼수 있는

instant : a, n, 즉시, 찰나, 순간, 순식간, 인스턴트식품, (특히)인스턴트커피, 즉각(즉시)의, 긴급한, 절박한(urgent), 이달의, 인스탄트의 즉석요리용의)

institutional investor : x, 기관투자가 생명보험회사등)

instrumentalism : x, (철)기구(도구)주의(사상이나 관념은 환경지배의 도구로서의 유용성에 따라 가치가 정해진다고 하는John Dewey의 학설

insufficiency : n, 불총분, 부족(lack), 불충분한, 결점, (의)심장등의)기능부전

integrase : n, (생화)인테그레이스(숙주 세균의 DNA에 프로파지(PROPHAGE)의 주입을 촉매하는 효소

integrated injection logic : x, 아이스퀘어엘(반도체 논리집적 회로의 한형식

intellectual junkfood : x, 핫도그 정보(손쉽게 입수할수 있는, 별로 가치없는정보

intercommunion : n, (친교, 상호교제(연락)(기독교)다른 종파 교도간의 성찬식

interface verification : x, (로켓)인터페이스 검사(로켓 발사시 관련기기의 상호 작동을 점검하는 검사

interfere : vi, 방해하다, 훼방하다, (이해등이)충돌하다, 대립하다, 손상하다, 해치다, 간섭하다, 참견하다, 중재(조정)하다, (물)광선음파등이)간섭하다, (불법으로)방해하다

interlaced : a, (도형이 섞어짜여진, 

interlocution : n, 대화, 문답(dialoguge

interlocutory : a, 대화의, 문답체의, 대화중에 삽입하는, (법)중간의, 최종적이 아닌)

internal angle : x, 내각(cf.EXTERNAL ANGLE

international candle : x, (광)국제 표준촉광(1940년 까지 사용된 광도 단위, 현재의 단위는(candela)

interrorem : ad, a, (법)경고로서(유언에 대한 이의 신청자는 유산을 못받는다는

interrupt : vi, vt, 가로막다, 저지하다, (말등을)도중에서 방해하다, 중단시키다, (전산)끼어들다, 방해하다, 중단하다)

interstadial : n, 야간 빙기(빙상의 생장과 축소사이의 휴지기

intimidation : vt, a), 협박하다, 위협하여 시키다, 어떤일을 하게되는

intinction : n, (천주교)성찬의 빵을 포도주에 적시기)

introduce : 들여오다, 도입하다, 처음으로 수입하다, 채용하다, 전하다, 끼워넣다, 삽입하다, 소개하다, 선도하다, 안내하다, 처음으로 경험하게 하다, 초보를 가르치다, (문법)(접속사가 절을)이끌다, (의안등을)제출하다, (논문)등에)서론을 달다, (이야기 등을)..으로 시작하다

introduction : 도입, 채용, 창시, 첫수입, 소개, 피로, 서론, 서설, (서두의)해설, introduction 책의 일부를 형성하고 그 내용에 관한 정신적인 예비적 해설.preface 본론과는 독립하여 책의 목적, 구성등에 대해 해설한것.foreword preface와 비슷한 것이지만 종종 저자 이외의 인사가 기술한것), 입문(서), 개론, 서설, (악)서주, 전주곡(prelude), 끼워넣음, 삽입

intrude : vt, vi) 억지로 밀어넣다, 강요하다, 강제하다, (지질)관입시키다, 억지로 밀고 들어가다, 침입하다, (남의일에)참견하다, 방해하다

intrusion : n, (의견등의)강요, (장소에의)침입, (사생활에의)침해, 방해, (법)무권리자의)토지침입점유, (교회 소유지의)점유 횡령, (지질)(암맥의)관입, (스코교회)교도의 동의 없는 목사 임명

inverted arch : x, (건)역, 아치(기초등에 쓰는

investiture : n (영)(관직, 성직등의)수여, 임관, 수여식, 임관(인중)식, (자격의)부여, (문어)익힘, 착용), 

invisible balance : x, (경)무역외 수지)

Io : n, (그신)이오(Zeus의 사랑을 받았으나 hera의 미움을 받아 흰 암소로 변함, (천)목성의 제1위성

ionosonde : n, 이오노전데(전리층 높이를 관측 조사하는

iota : n, 이오타(그리스말 알파벳의 아홉째 글자

iotacism : n, 이오타화(현대 그리스어에서 모음이나 이중 모음을 이오타음(영어의(i)음으로 발음하는경향

Iphigenia : n, )이피게니아(Agamemmon과 Clytemnestra의 딸)

Iran : n, 이란(아시아 남서부의 공화국, 수도 Teheran, 구칭

irenic : a, 평화의 평화적인, 협조적인peaceful)

irghizite : x, (지질)이르기스석(소련방Kazakh 공화국에서 발견된 실리카가 풍부한 텍타이트(tektite)

iridosmine : n, (화)이리도스민연 오스뮴과 이리듐의 합금)

Irish Free State : x, 아일랜드 자유국)

Irish Sea : x, 아이리시해(아일랜드섬과 잉글랜드 사이

iron crutain : x, 철의 장막(소련측과 서방측을 갈라 놓는 정치적 사상적 벽(cf.BAMBOO CURTAIN

is : x, (연결형)(등, 동, 동질 이성체의 뜻(모음 앞에서는 is, isochronism등시성

Isabella : n, 여자이름(Elizabeth의 변형

island : n, a, vt, 섬, 섬 비슷한 것, 고립된 언덕, (가로상의)안전지대, (미)대초원속의 삼림지, (해)(세포의), 섬, 세포군, (해), 항공모함 우현의)아일런드(브리지 포대, 굴뚝등을 포함하는 구조물), 섬의(insular), 섬으로 만들다, 고립시키다, (보통)수동형, (섬처럼)산재 시키다

islet : n, 작은섬, (해)랑게르한스섬(췌장속에서 인슐린을 분비하는 세포군

isobutyl nitrate['aiso~ubj'u:t~il-)(화)질산, 이소부틸(마약 상용자의 마약 대용품)

isooctane : n, (화)이소옥탄(휘발유의 내폭성 판별의 표준에 쓰는 일종의 탄화 수소

issue : 나오다, 나서다, 유출하다, 분출하다, (결과로)끝나다, 유래하다, 비롯되다, 생기다, (법)자손으로서)태어나다, 나오다, (명령, 면허증등을)내다, 내리다, 발행한, 발포하다, (피, 연기)등을 내다, (배급)지급하다, 넘겨주다, 간행(발행)하다, 출판하다, 유포시키다, (어음을)발행하다

Italy : n, 이탈리아(유럽 남부의 공화국, 수도 Rome

item : n, ad, vt, (마찬가지로의 뜻에서), 항목, 조목, 조항, 종목, 품목, 세목, (신문기사의)1항, 한절(항목), 하나..(항목을 차례로 열거할 때, 또 마찬가지로 , 또한, 항목별로 쓰다

item veto : x, (미)의결 법안의 일부에 대한 주지사의)부분 거부권

ITF : x, International Trade Fair국제 무역 견본시, International Trade Federation국제 운수 노조 연맹(본뷰(LONDON)

Ithaca : n, 이타카(그리스 서쪽, 신화의(Odysseus의 출생지)

ithyphallitic : suf, (염증의)의 뜻, (arthritic), ..의 뜻(Semitic

IU : x, international unit (생)비타민량효과 측정용), 국제 단위

Ivanhoe : x, 아이반호(Walter Scott의 소설(1819)또 그주인공

ivory black : x, 아이보리 블랙(상아를 태워 만든 흑색 그림 물감

ivory paper : x, 아이보리 페이퍼(화가가 쓰는 고급종이

ivy league : a, 아이비 리그(미국북동부의 오랜 전통을 가진 명문 8대학, 아이비리그의(적인)

IWC : x, International Whaling Commission, International Wheat Council(유엔)국제 소맥 이사회(본부(LONDON)

k.dic
Kafir : n, 카피르 족(파키스탄 북서부에 살고, Alexander 대왕의 후예라고 하는 주민, =KAFIR 3

Kafka : n, Franz91883-1924)독일의 초현실파 소설가

Kampala : n, 캄플라(Ugandda의 수도

Kampuchea : n, 캄푸치아(Cambodia의 한 때의 정식 명칭(1975-88)

Kauai : n, 카우아이(하와이 북서부의 화산(섬)

keypad : n, 키패드(컴퓨터나 텔레비젼의 부속 장치, 정보의 입력 또는 채널의 선택 등을 할 수 있는 버튼이 달린 작은 상자

Khomeini : n, 호메이니(이란의 이슬람교 시아파 지도자, 이란의 최고 지도자(1979-89)

kissinger : n, 키신저(미국의 정치학자, 국무장관(1973-77)

kludge : n, 클루지(부조화한 구성 요소로 이루어진 컴퓨터) 장치), 소프트웨어상의 귀찮은 문제에 대한 효율적인 해결

Ku Klux : x, 삼K단 (남북 전쟁후 남부 백인의 흑인 박해 비밀결사

j.dic
jackknife : n, vt, vi) 잭나이프(튼튼한 휴대용 접칼), 해군 나이프, 잭나이프, 새우형 다이빙, 잭나이프로 베다(자르다), (jackknife 처럼)접다(접히다), (연결된 열차 등이)잭나이프처럼 구부러지다

Jamestown : n, 제임스타운(미국 Virginia주 동부의 마을, 북미 최초의 영국 식민지(1607)

Jonestown : n, 존스타운(남미(Guyana의 한 지명, 1978년 (인민사원)(Peoples Temple)신자의 집단자살이 있었음)

jow : n, vi, vt, 종소리, 방울소리, (종, 방울을(이)울리다, (특히 머리를)때리다, 치다

Judas : n, (은전 30냥으로 예수를 판)(가리욧 유다, 배반자, (문, 벽의)엿보는 구멍

n.dic
nacre : n, 진주층(mother of pearl

nagana : n, 나가나병(tsetse파리에 의한 치명적인 가축병

nail : 손톱, 발톱, 못, (새, 닭의)며느리발톱, (소, 말등의)뒷발톱, (유의어nail 사람 동물의 손톱, 발톱을 통틀어 하는 말이다, fingernail 손톱, toenail 발톱, claw 고양이 등의 발톱, talon 맹금의 발톱), 못, 징, 네일(옛날 길이의 단위 2 1/4인치, 5.715센티, (속)궐련, 술, 못(징)을박다, 못을 쳐서 고정하다, (구)체포하다, 붙잡다, (야구)터치아웃시키다, (학속)나쁜짓을 들추어내다, 잡다, (구)명중시키다, 잡다, (사람을)후려갈기다, 구타하다, (사람의 눈주의를)끌다, (사람의 말을)놓치지 않다

naildixic acid : x, (화)날리딕신산(비뇨, 생식기 감염증 치료용 항생물질

nainsook : n, 네인숙(엷은 무명, 인도원산

naira : x, 나이라(나이지리아의 화폐단위 100KOBO 기호 N

Nairobi : n, 나이로비(Kenya 공화국의 수도

naked ape : x, 발가벗은 원숭이, 인간(a human being)(영국의 인류학자 Desmond Morris의 저서 the naked ape(1967)에서

Nakhodka : n, 나훗카(시베리아 Vladivostok남동쪽에 있는 항구

name part : x, (극)주제역(Hamlet 극의 Hamlet

Nancy : n, 여자이름(Ann(e)의 애칭, (속)(여성역의) 호모(nance)

Nanking : n, 남경(중국 장쑤성의

nanometer : n, 나노미터(10억분의 1미터, 기호nm

Nantes : n, 낭트(프랑스 북서부의 항구도시

Napiers rods(bones) : x, 네피어의 계산봉(J.Napier가 고안한 곱셈, 나눗셈 용구

Naples : n, 나폴리(이탈리아 남부의 항구도시

Napoleon : n, 나폴레옹(1769-1821)(프랑스 황제, 본명(Napoleon Bonaparte)(보불 전쟁에서 패배하여 영국에서 객사함)

napu : n, (동)궁노루(자비, 수마트라산

narrow gauge : x, (철도)협궤, 협궤철도(용의 객차(화차)

NASA : x, Aeronautics and Space Administration)미국 항공우주국, 나사

Nathaniel : n, (남자이름(애칭 Nat), natheless()ad, 

nation : n, (한정부 아래 공통의 문화, 언어 등을 가진)국민(전체)(유의어people), 세계의 여러국민, 전인류, (성)유대인쪽에서 본)이교도, 이방인, 국가(country), 민족, 종족, (북아메리카 원주민의)부족, (그들이 정치적으로 결성한)부족 연합

national bank : x, 국립은행, (미)국법 은행(연방정부의 인가를 받은 상업은행

National league : x, 내셔널 리그(미국프로야구 양대 리그의 하나(cf.AMERICAN LEAGUE)

natural : n, 자연적인 것, (고)선천적인)백치, (음)제자리표, 제자리음, (피아노, 풍금의)백건, (카드)그냥 이기게 되는 두장의 패, 타고난 명인, 성공이 , 확실한것(사람), naturalness()n, 

naturalism : n, 자연주의(현실 또는 자연의 객관적 진실 묘사를 목적으로 하는), 자연주의(본능에 따라 행동하는), (철)자연주의(자연을 중시하고, 모든 현상을 과학적 법칙으로 설명하는), (신학)자연론(종교적 진리는 자연에 대한 연구에서 얻어진다는

natural langugage : x, 인공언어, 기계언어에 대하여)자연언어

nature study : x, 자연공부(꽃 새 광석 날씨등의 관찰, 국민학교의 학과

Nauru : n, (지명)나우루 공화국(오스트레일리아 동북방의 섬나라, 수도(Nauru)

Navy list : x, (영)해군요람(사관 및 함선의 공식 명부

nawab : n, (NABOB 1 나와브(인도, 파키스탄의 이슬람 귀족, 명사에 대한 존칭

Nazareth : n, 나사렛(Palestine북부의 작은 도시, 그리스도의 성장지

Neanderthal man : x, (네안데르탈 사람(1856년에 독일의 네안데르탈에서 발굴된 구석기 시대의 유럽원인)

Nebraska : n, (북미 인디언 말(평평한강)의 뜻에서 , 네브래스카주(미국중서부의 주)

needlebar : n, 바늘대(재봉편물)기계의)

negative income tax : x, 역 소득세(저소득자에게 정부가 지급하는 보조금

negative list : x, 네거티브, 리스트(GATT에 보고하는 수입제한 품목

negative transfer : x, 소극적 전이(학습 과정에서 선행 학습이 후의 학습을 방해 억제

negligence : n, 태만, 부주의, 무관심, 등한, 단정치 못함, 태반한 행위, (법)부주의로 인하)과실, 법칙의 무시, 자유분방

Negrito : n, 네그리토(동남아, 오세아니아 등에 사는 키 작은 흑인

Negro state : x, (남북 전쟁 이전의 남부의 노예주

nek : n, (아프리카 남부(산의)안부, 산협

nematocyst : n, (가시 세포(말미잘, 히드라 등과 같은 강장 동물의 기관)

Nemean games : x, 네메아제(2년 마다 nemea에 열렸던 그리스 4대 제전의 하나, 나머지Olympian games, Pythian game, Isthmian games

Neodarwinism : n, 신다윈설(자연도태를 중시하는(Weismann의 설), Neodarwinist()n, 

Nepal : n, 네팔(인도와 티베트사이의 왕국

nephanalysis : n, 네프아날리시스(구름의 모양, 양과 강수량의 관계를 중시하는 일기도 분석

nephrite : n, 연옥(신장병에 좋다고 생각되었음

ness : suf, (분사(복합)형용사 등에 붙여서, (성질, 상태)등을 나타내는 추상명사를 만듦

nestle : vi, vt, 깃들이다, 편안하게 드러눕다, 기분좋게 자리잡다, 바싹다가서다, (집등이)(쾌적하게 깊숙이)자리잡고 있다, 주위의 풍경속에 파묻히다시피서 있다, (머리, 얼굴, 어깨등을..에 비벼대다, 아늑하게 자리잡도록하다, nestler()n, 

Nestor : n, (그신)네스토르(homer작 Iliad)중의 슬기로운 노장군), 현명한 노인oy전쟁때의 현명한노인

net ton : x, (미)톤(2000파운드, 순톤

network : n, vt, (운하, 철도등의)망상조직, 연락망, 망세공, 망제품, 라디오tv)방송망, 네트워크, (전산)회로망, ..에 방송망을 설치하다, 방송망으로 방송하다

network analysis : x, (수)회로(망) 해석, 네트워크분석, (회로망 해석 수법을 이용하여 프로젝트의 계획 관리를함

neve : n, 만년설(빙하의 상층부를 형성하는 입상 빙설

nevermore : ad, 두번다시~~하지않다(never again

neverneverland : x, J.M Barrie작 Peter Pan에서)동화(꿈)의 나라

New Delhi : x, 뉴델리(인도 공화국의 수도

New England : x, 이지방이 영국해안과 비슷하다해서 Captain John Smith각 명명)뉴잉글랜드미국북동부의 여섯주Connecticut, Massachusetts, Rhode Island, Vermont, New Hampshire, Maine)

new English : x, 신영어(1500년경 이후의 영어

New English Bible : x, 신 영역성서(신약 1961년, 신구약합본 1970년에 간행

Newfoundland : n, 뉴펀들랜드, (캐나다 동해안의 섬, 영국령, 뉴들렌드 종개(온순하고 헤엄을 잘쳐 인명 구종에 사용)

Newgate : n, 뉴게이트 (City of London의 서문에 1902년 까지있었던 유명한 교고서

Newhigte : n, 뉴헤어본, 미국(connecticul주의 도시

New Jersey : x, (누저지)이땅을 받은 영국제독의 출신지, Jersey섬의 이름을 따서), 미국 동부의 주

New Journalism : x, 신 저널리즘(객관성)간결성 위주의 종래 저널리즘에 대하여 기자의 주관적 참가 심리적 추측등이 특징)

Newman : x, 뉴먼(1801-90)영국의 추기경, 신학자, 저술가)

news dealer : x, (미)신문(잡지)판매인(영)newsagent)

newsstand : n, (미)거리, 역, 구내등의)신문, 잡지 매점

New Year's Day : x, 정월초하루, 설날(미, 캐나다)에서는 종종Day를 생략)

New York School : x, 뉴욕파(1940-50)년대에 New York에 나타난 추상 표현주의 화파)

next friend : x, 소송 대리인(소송에서 법적 무능력자의 대리인

niblick : n, (골프)니블릭, 9번 아이언(number nine iron

Nightingale : n, 나이팅게일, 1820-1910영국의 간호사, 근대 간호학 확립의 공로자)

nincomerery : a, pron, 9, 9자, 9개 한벌, 9인조, 야구팀, 9번째의 사람(물건, (골프)9개의 구멍, (문예미술을 맡은 )뮤즈의 아홉여식

nineninenine : n, (구분)구급전화 변호(겨경찰, 구급지.소방소를 부를 번호

nineteen : n, a, 19(의), 19개 사람의, 19세기의, 19달러(파운드, 센트, 펜스(등)

ninety : a, 90의, 90개(사람, 세)의, 90개 사람, 90, 90의 기호, 90세, 90달러(파운드, 센트, 펜스(등), (세기의)90년대, (특히 문학에서 19세기말 10년을  말함, 대문자로 시작), (연령등의)90대, (온도계 등의), 90도대, (성적의)90점대

Nissenhut : x, 영국의 광산기사의 이름에서)퀀셋 병사, 조립식 주택(Quonsethut)

nob : n, vt, 머리, 머리에 가하는 일격, 흑, (카드)뗀패와 같은 짝의 잭(이패를 가진 자는 한점을 얻음, 머리를 치다

noncollegiate : a, n, (학문이)대학 정도가 아닌, (영)(학생이)대학(학부)에 속하지 않는, (태학이 학부제도가 아닌, 대학 교육을 받지 않은 사람, college에 속하지 않는 대학생

noncooperation : n, 비협력, 대정부 비협력(운동)(특히 인도의 간디파의)대영 비협력 운동), noncooperatist()n, noncooperative()a, 

nonunion shop : x, 반 노조기업(노조와 관계없이 고용주가 고용조건을 정하는

normal school : x, 사범학교(현재는 teachers college로 개칭

North Channel : n, 노스 해협코틀랜드와 북아일랜드 사이)

Norway : n, 노르웨이(스칸디나비아 반도 서부의 왕국, 수도Oslo

nose cone : x, (로켓등의)원추형 두부)

nose glasses : x, 코안경pincenez)

nouvelle cuisine : n, (F.)누벨퀴진(새로운 저칼로리의 프랑스 요리

Nova Scotia : n, 노바스코샤(캐나다 동부의 반도 및 그 주)주도Halifax, 옛이름Acadia)

NOx : n, 질소 산화물, 광화학 스모그의 발생원인)

nuclear winter : x, 핵의 겨울(핵전쟁으로 인한 전지구적인 한랭현상

nullah : n, (인도)(자주 물이 마르는 수로 협곡

numbered account : x, 번호 계산을 대신 번호로 등록되는 은행 당좌 구좌)

Number Ten[No. 10)(Downing street)영국 수상관저(런던Downing가 10번지에 있는)

nursery slopes : x, (스키)초보자용 활강코스)

nutmeg apple : x, 육두구의 열매)

nymph : n, (그, 로신)님프(산, 강, 연못.숲등에 사는 예쁜 소녀 모습의 정령, 요정, 아름다운 소녀, , 애벌레(nympha)(낚시 애벌레 같은 제물낚시

nympha : n, 어린벌레, 애벌레(번데기의 다음 발육 단계, 소음순, nymphal()a, 

y.dic
x.dic
xenofgaft : n, 이종 이식편(이종 동물에서 이식된 장기(조직), 이종 이식

xenophon : n, 크세노폰, (그리스의 역사가.철학자

o.dic
Oedipus complex : x, 친모복합(아들이 아버지에 반발하고 어머니를 사모하는 경향

oversteer : vi, n, (자동차 등이)오버스티어하다(운전자의 의도 이상으로 많이 꺾이는 경향, 오버스티어

m.dic
M2 : x, M2(M1에 각종 금융기관의 정기성 예금을 합친 일국의 통화 공급량

MAC : Military Armistice Commission, Mac, pref (...의 아들)의 뜻(스코틀랜드 사람, 아일랜드 사람의 성에 붙음

Mach : n , 마하(고속도의 단위) ~ one 은 20도씨에서의 음속 770마일/시에 상당)

Maidstone : n, 메이드스톤(잉글랜드 동남부 Kent 주의 주도

major league : ㅌ, (미)메이저(대리그(2대 직업 야구 연맹의 하나 American League 또는 National League)

malapportionment[m`4l5p'25~r95nm5nt -p'2:-)의원 정수의 불균형

marketing manager : x, 마케팅 매니저(시장 분석, 제품 계획, 판매 촉진 등의 활동을 통제하는 업무의 담당자

Marshall Plan : x, 마샬 안 (미국 국무장관 G.C.Marshall의 제안에 의한 제2차 대전 후의 유럽 부흥 계획

Maseru : n, 마세루(Lesotho의 수도

massage : n, vt, (이기다, 반죽하다의 뜻에서) 마사지, 안마, 안마 치료, ...에게 마사지하다, ...의 긴장, 편견 등을) 풀어주다, 완화하다, ...의 비위를 맞추다

masthead : n, vt, 돛대끝, 돛대 꼭대기, 돛대꼭대기의감시원, (신문, 잡지 등의)발행인난, (선원을 벌로 돛대 꼭대기에 오르게 하다, (돛, 기등을)돛대(꼭대기)에 올리다(달다)

matrix management : x, 매트릭스 매니지먼트(전문 스태프를 현지의 일상 업무 조언자겸 중앙 스태프가 되게 하는 조직 형태

matronize : vt, vi,  matron답게 만들다; matron으로서 감독(관리)하다, (젊은 여성을 따라 다니며 돌보다, matron이 되다(노릇을 하다)

mattamore : n, 지하 주거(창고_

matter : n, 물질(opp, spirit, mind), 성질, 본질, (철)질료, (논)명제의 본질, 내용, 자료, 재료, (미술)재질, 마티에르, 중요함, ..., 물 (postal ~ 우편물, printed ~ 인쇄

maturity stage : x, 제품 성숙 단계 (매상 속도가 떨어지고 이윤이 안정되는 것이 특징

maximin : n, 맥시민(어떤 한 조의 극소치 중의 최대치), 맥시민 치(게임 이론에서 최소의 득점을 최대로 하는 수법

mechanical advantage : x, 기계적 확대율(지레, 도드래, 수압기 등의 기기에 의한 힘의 확대율

media mix : x, 미디어믹스(필름, 테이프, 슬라이드 등을 동시에 이용하는 행사(기획)

Megillah, -la : n, 메길라(에스더기 the Book of Esther)가 수록된 유대의 두루마리책; Purim제에 유대 교회에서 읽음)

melodion : n, 멜로디언(1806년 Dietz가 발명한 소형 건반악기

Memnon : n , 멤논(트로이 전쟁에서 Achilles에게 살해된 에티오피아왕), 멤논(이집트왕 Amenhotep 3세의 거대한 상

Mercia : n, 머시아(영국 중부의 옛 왕국(7-8세기)

merengue : n, vi, 메렝게(아이티, 도미니카의 춤(리듬), 메렝게를 추다

Merseyside : n , 머지사이드주(1974년에 신설된 잉글랜드 북서부의 주

Mersey sound : x , 머지 사운드(1960년대에 Liverpool을 중심으로 결성된 the Beatles등 팝 그룹의 음악

Mesopotamia : n, a, 메소포타마아(아시아 남서부 Tigris, Euphrates 두 강의 하류에 있었던 고대 왕국; 현재의 이라크와 거의 같은 지역, 아라크의 옛 이름, 메소포타미아의 (사람)

metameric : a, 구조(동족)이성의, 조건 등색의(을 나타내는, 체절의

microprogram : n, vt, 마이크로 프로그램(마이크로 프로그래밍에서 쓰는 루틴(routine), (컴퓨터에)마이크로프로그램름을 짜넣다

mills bomb9grenade) : x, 난형 고성능 수류탄

minar : n, 등대의 뜻에서)(인도 건축 등의) 작은 탑

miz(z0entop : n, 뒷 돛대의 장루

Moabite : n, a, 모압 사람(유대 사람과 싸웠던 고대 셈족, 모압 사람의

model : n, 모형, 원형, 본, 설계도, 모델, 마네킨, 모범, 모범적인, 모형의, 모양을 마들다(점토 따위를 어떤 형으로)뜨다, 설계하다, ...을 본뜨다, model school 시법 학교)

modeling clay : n, 소상용, 점토)

monkey : n, 원숭이, 장난꾸러기, 흉내를 내는 아이, 젊은 것(monkey up 성내다(성내게 하다, monkey business 장난, 기만), 낭난치다, 놀려대다, 흉내내다, 놀려대다

Monroe Doctrine : , 유럽 각국은 미대륙 각국에 대하여 간섭해서는 안된다고 한)먼로주의

Montana : n, 미국 북서부의 주)

monument : n, 기념비, 기념상, 기념문, 기념관, 기념물, 문서, 기록(the Monument 1666년 런던 대화재 기념 원탑

mood1 : n, 마음(의상태), 기분(be in no mood ...할 마음이 없다, in the mood...할 마음이 나서, a man of moods 변덕쟁이n

mop1 : n, vt, 자루걸레(a mop of hair 더벅머리, 자루걸레로 닦다, 훔쳐 내다, 이익을 빨아 먹다

mortagage : n, 저당(권), 저당잡히기(on mortgage 저당잡아, 저당잡히다

motto : n, 명, 금언, 표어, 모토, 논문 등의 첫머리에 인용한)제구, 반복 악구

mount : vi, vt, n, 오르다, 타다, 앉히다, 박다, 붙이다, 무대에 올리다, 물가가 오르다(mount guard over ...을 지키다, 승용 말, 대지, 보석의 대좌, 포가

mouse : n, vt, 새앙쥐, 얻어맞은 눈두덩의 멍(poor as a church mouse 매우 가난한, 찰가난의, like a drowned mouse 비참한 몰골로, mouse and man 모든 생물, 고양이가 쥐를 잡다

mud : n, 진흙, 진창(throw mud at ...을 헐뜯다, stick in the mud 궁지에 빠지다, 보수적이다, 발전이 없다

murder : n, vt, 살인, 모살, 고살(like blue murder 나쁜짓은 드러나게 마련이다, 살해다하, 곡을 서투르게 불러서(연주하여)망치다

z.dic
l.dic
lamented : a, 애도를 받는, 애석히 여겨지는(고인에 대한 습관적 표현, 애석한, 한탄스러운

Lammas : n, 라마스, 수확제, (옛날 8월 1일에 행하여졌음, 베드로의 쇠사슬의 기념일(8월 1일)

Lansing : n, 랜싱(미국(Michigan 주의 주도)

Lao : n, 라오족, 라오말(태국 북부에서 라오스에 걸쳐 쓰이는 말, 타이어에 가까움

Lesseps : n, 레셉스 Ferdinand M. de ~(180594)(프랑스의 기사, (Suez운아의 건설자)

liability : n, 책임(있음, 부담, 의무, 경향, limited ~ 유한 책임

lierne : n, 둥근 천장을 잇는)서까래

limousine : n, 리무진(운전석과 객서의 사이에 유리 간막이가 있는 대형 자동차), 호화로운 대형 승용차, (공항의)여객 수송용 소형 , 버스)

linguistic stock : x, 어계와 그것에서 파생된 모든 방언, 언어), 어떤 어계를 말하는 민족

lipase : n, 리파제(췌액), 아주까리씨 등에 포함된 지방 분해 효소)

loaf : n, (pl, loaves(vz)(일정한 모양으로 구워낸 빵의)덩어리, 빵 한덩어리, 요리의 일종, 원뿔꼴의 한덩이, loaves and fishes 제 잇속

logy : a, 동작, 지능이)느린, 둔한(dull), 탄력이 없는

lovebug : n, 날벌레의 일종(미국 멕시코만 연안 주의 흑색 곤충, 교미기(봄)에는 떼지어 다니며 자동차 교통의 장애가 됨

a.dic
abandon : 1)버리다, 버려두다, 단념하다, 2)내맡기다, (집, 동네를)떠나다, 3)유기하다(술)에 젖다, (절망)에 빠지다

abate : vt, 1)할인하다, 내리다, 할인하다, 덜다, 누그러뜨리다2)줄다 약해지다, 누그러지다

ABM : n, 탄도탄요격 미사일(Atomic Bomb Mission 원폭 조사 위원회

abolition : n, 폐지, 노예 폐지(~ism)(노예)폐지론, ~ist(노예)페지론자)

abort : vi, n, 1)유산하다, 조산하다, 실패하다, 발육이 안된 채 끝나다, 로켓비행이 중단 되다, 프로그램 실행의 중지

abridge : vt, 1)단축하다, 적요하다, 간추리다, 줄이다2) ...으로부터 ...을 빼앗다(deprive)

absorb : vt, 흡수하다, 병합하다, 동화하다, (흥미로)이끌다(be~ed by ...에 흡수(병합)되다

access : n, 접근, 발작, 부가, 증가(be easy of~ 접근(가까이)하기 쉽다, gain~to ...에 접근하다, 가까이하기 쉬운 사람

adhocracy : n, 특별위원회(중심의 정치(기구)

aerial torpedo : x, 공중 어뢰)

afar : ad, 멀리, 아득히(`off 멀리 떨어져서, 원방에, from~멀리서, 원방에서

agoing : ad, 움직여, 진행하여(set~ ...을 움직이다(작용하다), ...을 시작(착수)하다

alkyl : n, a, 알킬, 알킬의(지방족의 포화탄화수소기)-알킬의을 포함한)

allmains['2:n'ait)9수신기가)어떤 전압에도 쓸 수 있는

aloof : ad, pred, a, 떨어져서, (keep(stand, hold)~(...에서)떨어져 있다, (...에) 초연해 있다(from)-초연한, 무관심의

ambi : pref, 양쪽, 둘레)따위의 뜻

amuck : ad, 미친 듯이 날뛰어(run~ 함부로 날뛰다(설치다)

and : conj, 그리고, 및, 또한, 그러자, 그러면, (and/or=and or(newspapers and/or magazines 신문 및 또는 잡지)

anvil : n, (대장간용의)모루, (on the~ 심의(준비)중에

anything : pron, 무엇이든, 무엇인가, 아무것도(~but ...외에는 무엇이든, ...는 커녕, 어림도 없는(far from)

apart : ad, 떨어져, 떼어서(~from ...은 별문제로 하고, come ~흐트러지다, joking~ 농담은 집어치우고, take~ 분해하다다

ape : n, vt, 원숭이, 고릴라, 오랑우탄, 긴팔원숭이따위(go~ 발광하다, 열광하다, play the~ 서툴게 흉내내다, 흉내내다

appreciative : a, 감상안이 있는, 눈이높은(~audience 눈 톺은 관객(청중), 감상적인, 감사의(~remarks 감사의 말)

Ares : n, 아레스(군신), 로마 신화의 Mars에 해당)

Armageddon : n, 아마겟돈(세계의 종말에 있을 선과 악의 결전장

Armenian : a, n, 아르메니아(사람(말)의, 아르메니아 사람, 아르메니아 말

arrear : n, (일, 지불의)밀림, 미불, 잔금, 잔무(in~(s)밀리어, 미불되다, in~lf ...에 뒤지어

askance : ad, 모으로, 비스듬듬히, 곁눈질로(look askance at ...을 곁눈질로 흘기다, 으심쩍게 보다

Athene : n, 여자 이름, 아테네(아테네의 수호신, 지혜, 예술, 전술의 여신

atmospherium : n, 기상변화 투영 장치(를 설비한 방(건물)

Avignon : n, 아비뇽(남프랑스의 도시, 교황청 소재지(1309-77)

awe : n, 외경(stand in~of ...을 외경(두려워)하다

awry : pred, a, ad, 뒤틀린, 뒤틀리어, 일러진, 잘못되어(go(run)~ 시패하다, look~ 스처(곁눈질로)보다

ax : n, 도끼, 삭감, 면직(have an~ to grind 속 배포가 있다, 생각하는 바가 있다, put the~in the helve 수수께끼를 풀다

axstone : n, 도끼돌남미에서 돌도끼를 만드는 재료)

v.dic
valine : n, 발린(아미노산의 일종으로 동물의 정상적 성장에 필요함

vessel : n, 용기, 그릇, (대형의)배, 비행선, 도관, 맥관, ~s of wrath (mercy) 노여움(자비)의 그릇 (하느님의)노여움을(자비를) 받은 사람들)

virazole : n, 비라졸, (항 바이러스제 ribavirin의 상표명

volley : n, 일제 사격, 빗발치듯하는 탄환(화살, 돌), (질문, 욕설의)연발, (테니스)발리(공이 땅에 댈 전에 치거나 차보내기

w.dic
Washeteria : n, 워시테리아(세탁기;상표명)(영, 미 셀프서비스의 세탁소;(영)셀프서비스의 세차장

Waterbury : n, 워터베리(미국Connecticut주 서부의 도시;시계의 산지), 워터베리(같은 도시의 Waterbury Clock Co.에서 제조되는 값싼 시계 이름

weeper : n, 우는 사람, 슬퍼하는 사람;곡하는 사람(장례식에 고용되는), 상장(남자 모자에 다는);검은 베일(과부가 쓰는

wheatmeal : n, (영)(기울을 뽑지 않은 밀가루

whig : n, 휘그당원, 휘그당(17-18세기에 일어난 민권당으로 TORY당과 대립하여 19세기에 지금의 Liberals(자유당)가된정당, 독립당원;공화당원(1834년경 결성되어 민주당과 대립)

Whight : n, 와이트 섬(영불 해협에 있는 섬으로 잉글랜드의 한 주

widefield : a, 시야가 넓은(망원경 등

windblown : a, 바람에 날린, (나무가)바람에 날려 구부러진, 여성의 머리를)짧게 깍아 이마 쪽으로 눕힌

windchill : n, 풍속 냉각(기온과 어떤 풍속의 바람의 복합 효과에 의한 신체의 냉가

b.dic
Babel : n, 바벨 탑(옛날 Babylon 에서 하늘까지 닿도록 쌓으려던 탑, 천벌로 인부들이 서로 말이 통하지 않게 되어 완성에 실패

baby : n, 갓난애, 작은동물(물건), 젊은 여자, 소녀, 애인(gold the~ 성가신 것을 떠맏다), pass the~ 책임 회피하다)

Bahaism : n, 바하이교, (세계 평화를 창도하는 페르샤에서 일어난 종교

ballade : n, 발라드(8행의 구 3절과 4행의 envoy로 된 프랑스 시형, 각 절과 envoy는 모두 같은 후렴으로 끝남, 서사가(곡), 담시곡

baptism : n, 세례, 침례, 명명(식)(~of bloo 괴의 세례, 순교, ~of fire 포화의 세례, 첫 출전, 화형에 의한 순교, 괴로운 시련

barathea : n, 배라시아(양모 또는 견(면)을 섞어짠 고급 옷감

Bayard : n, (중세 기사 이야기에 나오는)마력을 가진 말, (보통의)말, 구렁말, 남자 이름, 무용이 뛰어난 믿음직한 신사, 바야르(중세 기사의 귀감으로 일컬어진 프랑스인

beach : n, vi, vt, 바닷가, 물가, 해변, 냇가, 호반, (해변의)모래, 조약돌(on the~ 영락하여-바닷가에 얹히다(얹히게 하다), 바닷가에 끌어올리다

beacon : n, vt, vi, 횃불, 봉화, 등대, 수로(항로)표지-봉화를 올리다, 봉화로 신호하다, (비추어(인도하다, 경고하다

Beckett : n, 베케트 Samuel ~(1906- )(프랑스에 사는 아일랜드의 소설가, 극작가, Nobel 문학상(1969)

beggarticks : n, pl, 서양도깨비바늘(미국 원산, 국화과, =BEGGARLICE

behindthescenes : a, 공개안된, 비밀리의, 흑막의(~conference 비밀 회담

beke : n, 백인 이민 생활자(보통 상류 계급, 프랑스계)코레올(Creole말))

bereft : v, bereave의과거(be utterly~어찌할 바를 모르고  있다

betel : n, 구장, (후추과의 나무, 인도 사람은 그 잎에 ~nut를 싸서 씹음))

Bhorizon : n, B층(토양 층위의 하나, A층 바로 아래

bibivalent : a, 쌍이가의(2가의 양, 음 이온에 해리하는 전해질에 대하여 말함

Bircher : n, 버치 당원(미국 극우 정치 조직 Johb Birch Society 회원(동조자)

blanco : n, vt, 백색 도료(벨트, 군화 등의 가죽 제품용, (가죽 제품에)백색 도표를 칠하다

blaster : n, 발파공, 블래스터(벙커용의 타면이 넓은 클럽, (SF소설에서)우주 총, 건, 건맨

blaze : n, vt, 길잡이로 나무껍질을벗긴)안표

blindfold : vt, a, ad, 눈을 가리다, 어찌할 바를 모르게 하다, 속이다-눈이 가려진9가려져), 무모한

Bloomfield : n, 블룸필드(1887-1949)(미국의 언어 학자

bluebird : n, (날개가)푸른 울새(북미산 유리울새속, 순경

blue ribbon : x, 카터 훈장의)푸른리본, 일등상, 최고의 명예, 금주의 회원장

boatel : n, 보텔, (자가용배로 여행하는 사람을 위한 물가의 호텔

Bobbie : n, 남자 이름, 여자 이름(Barbara, Roberta의 애칭

bow sow : n, vi, 멍멍(짖다

brandish : vt, (칼 따위를 휘두르다

bread mold : x, 빵에서 생기는) 검은 곰팡이

bricolage : n, 브리콜라즈(도구를 닥치는 대로 써서 만든 것(만들기)

Britannica : a, n, 영국의(The Encydlopaedia Britannica(대영 백과 사전)과 같이 책명 등에 쓰임)), 영국에 관한 문헌

Brittany : n, 브르타뉴프랑스 북서부의 반도 bretagne의 영어명)

broke : v, a, 무일푼의, 파산한(go for~ 기를 쓰고 해 보다

brood : n, vi, vt, 한배의병아리, 한배 새끼, 아이들, 종류, 종족-알을 품다(안다), 곰곰히 생각하다(on, over), (구름 걱정이(내리 덮이다(over, on)-숙고하다

Buchanan : n, 뷰캐넌 James ~(1791-1868)(미국 15대 대통령(1857-61)

buildup : n, 형성, 발전, 선전, 매명, (장면을)최고조로 돋구어올리기, 날조 조작)

bun : n, 롤빵(건포도를 넣은 단 빵), (롤빵 모양으로)묶은머리(take the~ 일등이 되다, 이기다

bundle : n, vi, vt, 다발, 꾸러미, 다발지어 묶다, 서둘러 떠나다(~lf nerves 굉장히 신경질적인 사람, ~oneself up 많이 껴입다

bushel : n, vt, vi, 부쉘단위, 미국에서는 1, 95말, 영국에서는 2, 01말)부셀 되

buzkashi : n, 부즈카시(죽은 염소(송아지)를 말을 타고 빼앗는 아프카니스탄의 국기

bygone : a, n, 과거의, 과거(the past)(Let~s be~s 과거를 묻지 말라

u.dic
ululate : vi, 짖다)늑대처럼), 부엉부엉 울다(올빼미처럼), 슬피울다

underpinning : n, 지주(벽 등의)받침대, 토대, 버티는 물건, 보강물, 지지(support), 응원, 속옷, 다리(legs, 

Union shop : x, 유니온 샵(비조합원도 채용후 조합에 가입하기로 고용주와 조합간에 협정이 된 사업체

unlaid : a, 놓여 있지 않은, 늘어(벌여)놓지 않은, 부설되지 않은, (식탁이)준비 되어 있지 않은, 안정(진정)되지 않은, 갈피를 못 잡는, 당황한, (비치는 무늬가 없는(종이), 꼬이지 않은(새끼)

upheaval : a, 밀어 올림, 융기, 솟아르다, 밀어, 융기, 대변동(사상, 사회), 융기, 대변동(사상, 환성 등의 격번

t.dic
ta-da(h) : int, 나오신다, 기대하시라사람, 물건을 처음 소개할 때 세우는 소리)

tabla : n, 타블라(인도 음악의 한 쌍의 작은 북

tachistoscope : n, 순간 노출기(그림, 문자등 시각적 자극을 주는 장치

tafia : n, 태피아 술(럼주의 일종, 서인도산

takin : n, 타킨(티벳산 영양의 일종

tangier : n, 탠지어(아프리카 북서부 끝에 있는 모르코의 옛 국제 관리 지대

tap : n, 꼭지, 통주둥이(faucet), 마개(plug), 탭, 콘센트, 술의 종류(품질), 술집, on ~(언제나 마실 수 있게)꼭지가 달려, 언제든지 쓸 수 있게)꼭지가 달려, 언제든지 쓸수 있게 준비되어

targeting : n, 약물 표적화(환부에 약물을 유효하게 도달시켜 약효의 지속화, 증강을 꾀하는 일

Tartuffe : n, 타르튀프(프랑스의 극작가 Moliele 작의 희극 제명 위선자, 	

Tayside : 테이사이드(1975년에 신설된 스코트랜드 중동부주의 주, 

technicism : n, 갸술(지상 주의, 

telecommute : n, 텔레컴퓨니케이셔(전기 통신과 전자 계산기가 융합한 새로운 정보 처리의 공학, 기술, 산업(분야)

tenesmus : n, 이급후중(배설 후에 남는 불쾌한 동통

tetrastyle : n, 4주식의(건물

thermocline : n, (호소)의 수온이 급격히 변하는)변온층, (수온)약층

threadneedle : n, 어린이 놀이의 일종(한 줄로 손 잡고 서서 끝의 아이가 다른 끝의 두 사람 사이를 차례로 빠져나감

threevalued : a, 삼치적인진.위의 2치 이외에 제3의 진리치를 인정하는)

thrummy : a, 부스러기 실의(로 만든);(표면에)보풀이 선)

thuggee : n, THUG에 의한 살인 강도, (인도의)폭력 행위(조직

tiki : n, (폴리네시ㅏ 티키(인류를 창조한 신)티키의 상(나무.돌로 만들어 몸에 지님)

tireless : a, (사람이)지칠 줄 모르는, 정력적인;근면한, (행동 등이)피로의 기색을 보이지 않는, 꾸준한, (자동차가)타이어가 없는)

toby : n, 남자 이름, 땅딸보 모양의 맥주 조끼(모자 부분으로 마심, 가느다란 값싼 엽궐련

toein : n, 토인(자동차의 바퀴를 약간 안쪽으로 향하게 하기

togoland : n, 아프리카 서부의 (구)영, 불 위임통치령(현재 동부는 독립하여 Togo공화국, 서부는 Ghan공화국의 일부로 편입

tokamak : n, 토카막(제어열 핵융합 반응 실험 장치

Toledo : n, 톨레도 검(스페인의 Toledo에서 생산되는 질이 좋은 칼

toucher : n, ad, 만지는 사람(물건, 거의, 아슬아슬하게

triathlete : n, 트라이애슬리트(트라이애슬론(triathlon)의선수

trickledown theory : x, 트리클다운 이론(대기업에의 재정적 우대는 중소기업이나 소비자에게 파급효과를 준다는 설

trilingual : a, 3개국어의)를 말하는

trimetrogon : n, 3각점 부감 촬영법(다른 각도에서 3대의 카메라로 동시 활영하는 항공 사진 방식

trumpeter : n, 트럼펫 부는 사람, 나팔수, (이야기를 치켜세우는 사람, 나팔새, 트럼펫(울음소리를 목족으로 개량된 비둘기)

trumpetlike : a, (모양, 소리가 트럼펫 비슷한

twodecker : a, 2중 갑판의(배), 2층 있는(전차(버스)(doubledecker)

c.dic
C : n, C(미국 Bell연구소 개발의 시스템 기술 언어

cabin : n, vi, vt, 오두막집(hut)(영국 철도)신호소, 선실, 캐빈(상선의 1.2등 객실, 군함의 함장실.사관실), (비행기.우주선의)캐빈(승무원실.객실 등), (이동 주택차(trailer)거주 부분, 오두막집(좁은 곳)에서 살다, (좁은 곳에)가두다

Calamity Jane : x, 칼래미티 제인(1852?-1903)(미국 개척 시대의 여자 사격의 명수 Martha Jane Burke의 별명

calendar : n, vt, 달력(almanac), 책력, 역법, 연중 행사표, 연차 목록(공문서의), 일람표(list), 공판 예정표, (대학의(요람, 의사 일정(의회의), (행사 등을)달력(일정표)에 기입하다, (날짜와 내용에 따라 문서를)일람표(목록)로 만들다

calla : n, 칼라, 화란 물토란(꽃(=callalily)

calque : n, (번역차용(어구) (loan translation)

Calvary : n, 그리스도가 십자가에 못 박힌 곳(Golgotha의 라틴어명, 그리스도의 수난상, 고난, 시련

Cambridgeshire : n, 케임브리지셔(잉글랜드 동부의 주, 주도 Cambridge 

campus : n, a, 교정, 구내, 켐퍼스(대학등의), 학원, (대학의)분교, 학원(교정에서의, 대학의

Candlemas : n, 성촉절(2월2일, 성모마리아의 순결을 기념하는 축제일, 촛불행렬을 함

cannelloni : n, 카넬로니(원통형 대형 파스타(pasta) 또는 그요리

Cannes : n, 칸(프랑스 남동부의 피한지, 해마다 국제 영화제가 열림

Canute : n, 카뉴트(994?-1035)(잉글랜드왕(1016-35), 덴마크왕(1018-35), 노르웨이왕(1028-35)겸함

carbecue : n, 카베큐(폐차를 불 위에서 압축하는 장치

car bed : x, 카베드(차 좌석에 놓는 아기 침대

car pool : x, (자가용차의)합승이용(그룹) (통근 등에서 교대로 자기 차에 태워주기 

Castle Catholic : x, 영국의 북아릴랜드 지배를 지지하는 카톨릭교도)

catch line : x, 주의를 끄는) 선전 문구, 표제

catty : a, ad, n, 심술 사납게 남의 말 하는, cattily, cattiness, 캐티(중국.동남아시아의 중량 단위, 1, 3파운드 상당

caul[k2:l)대망막(태아가 종종 머리에 뒤집어 쓰고 나오는 엷은 막)

caviar)e) : n, 캐비아(철갑상어(sturgeon)의 알젖), 진미

Cayley : n, 케일리암(달 표면 고지의 파인 곳에 채워진 각력암질

cedilla : n, 음을 나타내는 부호)

cell-mediated immunity : 세포(매개)성 면역(세포막에 부착하는 항체의 중산에 의한

cell therapy : x, 세포요법(양의 갓난새끼의 세포를 주입하는 회춘법

Celotex : n, 셀로텍스(건물의 절연 및 방음용 합성판, 상표명

Celt : 켈트사람, 켈트족(Aryan인종의 일파, 지금은 Ireland, Wales및Scotland  고지등에 삶

centimo : n, 센티모(스페인.베네수엘라의 화폐단위

cervic- : x, cervici(-v5si)cervico-(-v5ko~u)(연결형)목, 경부의 뜻(모음에서는 cervic-()x

Cezanne : n, 세잔(프랑스의 후기 인상파 화가

challenge : 도전(장), 결투(시합등)의 신청, 수하, 의욕(노력, 감흥등)이 솟게 함, 해볼 만함, 설명(증거)의 요구, 항의, 힐난, 힐책, (투표자의 유효성.자격등에 대한)이의 신청, (임명 전의 배심원에 대한)기피, 도전하다, (논전.시합 등을)걸다, (결투를)신청하다, (...에게)대답을 요구하다, 수하하다, (진실.정당성.권리 등을)의심하다, 이의를 제기하다, (배심원.증거 등들)거부하다, (설명.칭찬 등을)당연히 요구하다, (사물이 사람의 주의력.상상력 등을)촉구하다, 환기하다, 자극하다, (투표(장)의 유효성(자격)에 이의를 제기하다, 도전하다, (사냥개가)냄새를 맡고 짖다, 이의 신청을 하다

chamber : 방, 침실, (궁정.왕궁의)공무집행실, 알현실, (공관 등의)응접실, 판사실, 재판관 집무실, 변호사 사무실, 독신자용 셋방, 전세 아파트, (입법.사법기관의)회의장, 의원, 의회, 회의소, 회관(hall), (총포의)약실, (기계 속의) 실, (생물체 내의)소실, 방, 공동, 침실용 변기, 실내용으로 만들어진, 실내 음악의, 방에 가두다, ...에 방을 만들다, (총포가 ...형의 탄환을 장전할 수 있다

chambermaid : n, (호텔 등의)객실 담당 여종업원), 가정부, 시녀

Chandler's) wobble : x, 챈들러 요동, 자유 요동(자전축의 평균극 주위의 운동)

channel : 강바닥, 하상, 유상, 수로, 가항수로, 운하, 해협, (보도, 무역 등의)경로, 루트, 계통, (정식)전달 루트, (왕복 등의)경로, (라디오.텔레비전 등의)채널, (할당된)주파수대, (사상.행동 등의)방향, 방침, (활동의)분야, (도로의)도랑, 측구, 암거, 소관, 도관, (문지방 등의 장식홈, (일반적으로) 가늘고 긴 홈, 총검의 홈, (마약주사 놓는)정맥, 채널, , 통신로, ~(l)er, ...에 수로를 열다(내다), ...에 홈을 파다, (물 등을)수로(도관)로 나르다, (정보.관심.노력 등을)(어떤 방향으로 )도리다, 전하다, 보내다, (강물 등의)흐름을 다른데로 돌리다, (자금 등의 일부를)타 용도로 돌리다

chapbook : n, 싸구려 책(옛날 행상인)이 팔고 다닌 소설.속요등의 소책자), 소책자

chapel[t9'4p5l)예배당, 채플(학교.병원.군.교도소.선박등의), 부속 예배당, 교회당, 예배(학교의 채플에서 하는), 성가대, 악대, 인쇄소, 인쇄공 조합

charge d'affaires : n, 대리대사(공사), 공사대리(대사(공사)없는 국가에 둠))

Charo(l)lais : n, 샤롤레(프랑스 원산의 큰 흰소, 주로 식육.교배용

chase : 뒤쫓다, (여자를)귀찮게 따라다니다, ...을 추구하다, (사람.동물을)쫓아내다, 달아나다, 떠나다, ...의 뒤를 쫓다, 추적하다, 추격하다, 달리다, 뛰어다니다, 서두르다, 추적, 추격, 추구, 쫓기는사람(짐승.배), 사냥감, 추구의 대상, 사냥, 개인 소유의 사냥터, 추적 장면, 홈, 체이스, 쪽포신, (금속에 돋을 새김하다, (무늬를)양각으로 넣다, ...에 홈을 내다

chasseur : n, (프랑스 육군의)추격병)경장비의 보병.기병), 사냥꾼, 제복을 입은 종자

chauvinism : n, 쇼비니즘, 광신(맹목)적 애국 주의, (자기가)속하는 단체.성별 등을 위한)극단적 배타(우월)주의

Cheshire cheese : x, 체셔 치즈(크고 둥글 넓적함

chinoiserie : n, 17-18세기 유럽에서 유행한 복장.가구.건축 등에서)중국 취미(의 것)

Chisanbop : n, 지산법(산술 초보를 가르치는 손가락 계산법, 한국인 Pai Sung Jin씨가 발명, 상표명

Choctaw : n, 촉토족(아메리카 인디언의 한 종족, 촉토족의 한 사람, 촉토 말, 못 알아들을 말, 촉토(피겨 스케이티아 스텝의 한 가지

choriamb : n, 강약약강격, 장단단장)격

chosen : a, 선발된, 선택한, 좋아하는, (특히 구원받기 위해서)신에게 선택된)

church triumphant : x, 승리(개선)의 교회(현세에서 악과 싸워서 승천한 천상의 영혼, 

ciborium : n, 제단의 닫집, 성합(성체를 담는 그릇

cinema verite : n, 시네마 베리테(핸드 카메라나 가두 녹음 등으로 현실을 있는 그대로 그려내는 수법(영화)

city : (town보다 큰)도시, 도회, 시, cathedral 또는 칙허장이 있는 도시, 시장 또는 시의회의 행정하에 있는 자치제, 인구에 따른 최고의 지방 자치제, 전시민, (London의)시티(시장 및 시의회가 지배하는 약 1평방 마일의 구 시내로 영국의 금융.상업의 중심지, 재계, 금융계, 장소, (어떤 것이 많이 있는)상태

classical : a, (고대 그리스.라틴의)고전 문학의, 고전의, 인문적인, 일반 교양적인, 고전주의의, 의고적인, 고전 취미적인, (음악이 클래식의, (학문이)고전파의, 전형적인, 모범적인, ~ism=CLASSICISM, ~ist=CLASSICIST

clear : (세관을)통과하다, 관세를 지불하다, 출항 절차를 마치다, (빚 등을)청산하다, (어음을)교환 청산하다, (수표를)현금으로 바꾸다, (선박.사람 등에)출국(입국)허가를 주다, (비행기에 이착륙등의)허가를 주다, (계획.제안 등을 위원회 등에서)승인(인정)받다, (...을)허가(인가)하다, (기억 등을)지우다, 소거하다, (날씨가)개다, (구름.안개가)걷히다, (얼굴.리지 않고, 뚜렷하게, 명료하게, 또렷하게, 충분히, 완전히, 쭉, 계속하여, 떨어져서, 빈터, 빈 틈, 안 치수, 클리어 쇼트(크게 호를 그리며 상대방 뒤, 엔드라인 안으로 떨어지는 플라이트)

Cleveland : n, 클리블랜드(미국 Ohio주 북동부의 Erie호반에 있는 도시, 1974년에 신설된 잉들랜드 북부의 주

clink : n, vi, 교도소, 유치장, 땡그랑 소리(얇은 금속조각.유리 등의), 돈, 땡땡(땡그랑)울리다(소리나게 하다

clipping bureau (service) : x, 클리핑 통신사(신문.잡지의 발췌기사를 주문에 따라 제공하는

clotted cream : x, 지방분이 많은)고체 크림

Coalite : n, 반해탄(저온 건류 코크스, 상표명

coaster brake : x, (자전거용)역전브레이크(페달을 거꾸로 밟아 멈추게 하는 제동기

coating : n, 칠, 입힘, 입힌 것, (요리.과자 등의)겉에 입히는 것, 도료), 코트(웃옷감), 코팅

codger : n, (특히)노인이)괴팍한 사람, 괴짜, 영감태기

coherer : n, 코히러(무선 전신용 검파기

cold type system : x, 콜드 타이프 시스템(납활자나 열을 사용하지 않고 필름을 주체로한 사식화에 의한 인쇄 공정

Colombia : n, 콜롬비아(남미 북서부에 있는 공화국, 수도 Bogota

colon : n, 콜론, 결장, 콜론(코스타리카 및 엘살바도르의 화폐 단위, 식민지의 농부, 농장주

commission : 위임, 위임장, 임명, (장교의)임관 사령, 장교의 지위(계급), (직권.임무의)위임, 위탁, (위임된)임무, 직권, 명령, 지령, 주문, 의뢰 사항, 위원회, (집합적)위원회의 위원들), (상거래의)위탁, 업무 대리, 대리(권), 거간, 수수료, 구전, 커미션, (죄를)범함, 수행, 범행, 위임하다, 권한을 주다, ...에게 위임장을 주다, (장교로)임관하다, (일 등을)의뢰하다, 주문하다

Comoros : 코모로(인도양 서부의 Comoro제도로 이루어진 공화국, 수도 

complete game : x, 완투 시합(한 투수가 1회부터 9회까지 혼자 투구하기

composite school : x, )캐나다의 보통과.상업과.공업과를 포함하는)종합중등학교

con : 죄수, 전과자, 범죄자, 차장, 폐병, =COM, 반대 투표, 반대론(자), 신용 사기, 횡령, 신용 사기의, 반대하여, ...을 가지고, ...으로써, 숙독(정독)하다, 암기하다,  (조타(침로)를 지휘하다, 속이다, 속여서 ...하게 하다, 속여서 빼앗다

Conakry, Konakri : n, 코나크리(Guinea의 수도

concrete jungle : x, 콘크리트 정글(인간이 소외된 도시

content subject : 내용과목(실용과목과 대조하여 철학.역사등 그 자체를 목적으로하는교과, cf.TOOL 

continental breakfast : x, (빵과 커피(홍차)정도의 가벼운 아침식사

conversion ratio : x, 전환 비율(핵분열시 하나의 원자에서 생기는 원자의 수

convertible note9paper currency) : x, 태환 지폐

coo : int, (의성어)거참, 허(놀람.의문을 나타냄

cooee, -ey : n, int, vi, (의성어)어이!(오스트레일리아 원주민의 고함 소리, 어이하고 고함치다

Cook : n, 쿡 James~91728-79)(영국의 항해가)

cookie, cook(e)y : n, (과자(cake)의 뜻에서)(보통 가정에서 만든)쿠기, 작고 납작한 케이크 biscuit, small sweet cake), 과자빵(bun), 사람, 놈(person), 매력적인 여자, 귀여운 소녀, COOKY

Coolidge : n, 쿨리지(John) Calvin~(1872-1933)(미국 제30대 대통령(1923-29)

cooncan : n, 쿤캔(40매의 카드로 두 사람이 하는 러미(rummy)

cork : n, vt, vi, 코르크나무(cork oak), 코르크(코르크나무의 껍질), 코르크 제품(특히 코르크 마개(bottle stopper), (코르크로 만든)낚시찌(float), (병에)코르크마개를 하다, (얼굴.눈썹에)코르크 먹을 칠하다, 코르크화 되다

corrective trainig : x, 교정 교육 처분(죄인에게)직업 교육과 일반 교육을 받게함)

cortin : n, 코르틴(부신피질의 유효성분과 부신전체의 엑스

crabbed : a, ad, n, (사람.언동이)심술궂은, 괴팍한, (문제 등이)이해하기 어려운, (필적이 이상야릇한, 알아보기 힘든, ~ly, ~ness

croquet : n, vt, vi, 크로케(잔디 위에서 하는 공놀이), (크로케에서)상대편 공을 자기 공으로 제치는 타구법), (상대편 공을 다른 방향으로)제치다

curvet : n, vi , vt, 커벳, 등약(발이 땅에 닿기 전에 뒷발이 뛰는 보기 좋은 도약, (말이)등약하다, (아이 등이)뛰어다니다, (기수가)말을 등약(도약)시키다

cybernate : vt, a, (공정을 컴퓨터로 자동 조절하다, 인공 두뇌화하다, -na ted()

p.dic
pa'anga : 파앙가(통가의 화폐 단위, 

PakaPotti : n, 휴대용 변기의일종(미국에서는  국립 공원 등엣 캠핑할  때 휴대용 변기 사용이 의무화되어 있음, 상표명

palindrome : n, 회문(뒤 어느쪽에서 읽어도 말이 되는 어구

paper wedding : x, 지혼식(결혼 1주년 기념식(일)

parsons table[종종 퍼슨스 테이블(다리가 면판의 네 귀에 붙은 것

passant : a, 오른쪽 다리를 들고 걷는 자세의)

payback : a, 환불(의), 대충(의), 원금 회수9의)

pelter : n, 내던지는 사람9것), 총, 권총, 억수같은 비

performance art : x, 퍼포먼스 아트(육체의 행위를 음악, 영상, 사진 등을 통하여 표현하려는 1970년대에 시작된 예술 양식

personal : a, n, 개인의, 본인의, 신체의, 용모의, 개인에	관한, 개인적인, 인식 공격의, 인치의, 개인이 속하는, 동산(become personal 인식공격을 하다, 인사란

pillory : n, vt, 망신칼(죄인의 목과 양손을 기운 채 뭇사람에서 망신을 당하게 하던 옛날의 형틀, 망신칼을 씌워 내뵈다, 웃음거리로 만들다

pilot : n, a, 도선사, 수로 안내인, 키잡이, 조종사, 지도자, 조절기(drop the pilot 훌륭한 지도자를 물리치다-도선할, 지도하다, 비행기를 조종하다, 시험적인, 예비거인

plank : 두꺼운 판자, 정강의 조항(walk the pland 뱃전 밖으로 내민 판자 위를 눈을 가린 채 걸림 당하다(해적의  사형)-판자를 깔다, 밑에 놓다, 즉시 지불하다, 판자위에서 구운 채 내놓다

pleasure : 즐거움, 쾌락, 의지, 오락, 욕구, 기호(at   pleasure   마음대로,   take  a 

pleasure in : x,  ...을 즐기다, 좋아하다)

post : n, vt, vi, ad, 우편, 우체국, 우편물, 우체통, (by post 우편으로, by return of post 편지 받는 대로 곧(회답바람), 우송(투함)하다, 정통하게    하다, 역마로    여행하다, 급히   여행하다, 빠른말로

pot : 단지, 항아리, 화분, 병, 속깊은 남비, pot하나  가득한 물건, 술, 물고기나  새우를 잡는 바구니, 한번에 건돈, 마리화나에 건 돈, 단지(항아리)에 넣다)화분에 심다, 쏘다

potato : 감자, 고구마(dirp  a thing  likea fot  potato 당황하여	버리다, Irish 

practice : n, vt, vi, 실시, 실행, 습관, 연습, (의사, 변호사 등의)업무, 소송 절차-늘 행하다, 실행하다, 연습하다, (의사, 변호사 등을(업으로 하다, 습관적으로 하다, 연습하다, (의사, 변호사등이)개업하다

prefabricate : (가옥 따위의)조립	부분품을 제조하다(prefabricated house  조립 가옥(주택)

prelude : n, vt, vi, 전주곡, 서막, 준비 행위, 전주곡이  되다, 서두가 되다, 전주곡을 연주하다, 서막이 되다)to)

prey : n, vi, 먹이, 밥, 희생, 포식, 약탈품(beast of prey 맹수(맹조), 먹이로 하다, 괴롭히다, 해하다, 약탈하다. preyer n.

pride : n, vt, 자만, 자부, 거만, 자존심, 자랑, 득의, 만족, 경멸, 득의의  모습, 한창(the  pride of mangood  남자의 한창  때, take  a  pride in	...에  긍지를 갖다, 뽐내다, 자랑하다(oneself on)

prime : 최초의, 원시적인, 근본적인, 수위의, 주된, 최상의, 우수한, 소수의, 최초, 초기, 봄, 전성, 전성, 청춘, 최량의  상태(부분), 소수, 분, 프라임  부호(부, 피트, 수학의  대시  따위를 나타냄), (폭발물 등에)) 뇌관을 달다, 실컷마시게 하다, 뇌관을 장치하여 발화준비를 하다. primeness n.

probationer : n, 수습(집행 유예)중인 사람), 집행유예중의 죄인

probationship : n, 수습(집행 유예)중인 사람), 집행유예중의 죄인

process : n, a, vt, 진행, 경과, 순서, 돌기, 영장, 사진 제판법(in  process 진행하여, ...중, (화학적으로)가공한-처리(가공)하다, 기소하다, (정보, 데이터를) 처리하다, (자료 등을) 조사 분석하다

profit : (장사의)이윤, 이익(make one's profit  of ...을 이용하다, ...에 이익이 되다, 이익을 얻다, 남다

progress : n, vi, vt, 전진, 진보, 발달(in progress  진행중, make progress 진행하다, 전진하다, 전진(진행, 진보)하다, 전진(진척)시키다

prompt : a, ad, 민속한, 곧(기꺼이)...하는, 즉시의, 생각나게  하다, 사상, 감정을)환기하다, (배우자에게)숨어서 대사를 일러주다, (퀴즈 따위에서 사회자가)힌트를 주다, 자극하다, 격려하다, 촉구하다, 상기시키다, 생각나게하다, 자극하는 것, 인도일, 일람불, 즉시불, (시간이)정확히

proximity talks : x, 근거리 외교(근접한 장소에 있는 당사자 사이를 중개자가 오가며 추진하는 외교 교섭

pudding : 푸딩(과자), 푸딩처럼 말랑말랑한  것, 소시지의 일종, 실리, 실익(more praise tan pudding (실속 없는)헛 칭찬

puddle : n, vt, vi, 웅덩이, 이긴 진흙(진흙과 모래를 모로 이긴 것), 흙탕물로 적시다, 흙탕물이 되게 하다, 이긴 지흙이 되게하다, (물의  유출을 막기 위해)이긴 진흙을 바르다), 흙탕을 휘젓다

puka : n, 푸카(하와이 해안에 많은 흰 조가비, 끈을 꿰어 목걸이, 팔찌를 만듦

pure : a, n, 순수한, 더러움	없는, 순혈의, 깨끗한, 오점 없는, 순전한, 단순한, 순이론적인(pure and simple 순전한(바보), 순수한 것

purpose : n, vt, 목적, 의도, 의지, 효과, 의의, 의미(on purpose  일부러, to good purpose 매우 효과적으로, 잘, to little purpose 거의 헛되이, 계획하다, ...하려고 생각하다

g.dic
Gaelic football : n, 게일식 축구(주로 아릴랜드에서 행해지는 1인, 2팀간의 축구

galantine : n, 갤런틴(닭고기, 송아지 고기 등의 뼈를 바르고 향미료를 넣어 삶은 음식, 식혀서 먹음

galatea : n, 고급무명(보통 흰 바탕에 푸른 줄이 있음

Galatia : n, 갈라디아(소아시아 중부의 옛왕국

galbanum : n, 갈바눔, 풍자향(고무질 수지, 의약, 향료용

Galen : n, 갈레노스(그리스의 의사), (익살)의사)

gallopade : n, 갈로파드(2/4)박자의 빠르고 약동적인 헝가리 춤), 그무곡

gam- : 에서는 gam-) (연결형)(암수가 합친, 자웅 합체의)의뜻(모음)

game park : x, (아프리카 등의)동물 보호 구역)

ganges : n, 갠지스강(벵골 만으로 흐르는 인도의 큰강

gangplank : n, 배다리, 트랩(배와 부두 또는 선창을 연결하는 널판

gapped scale : x, 갭트 스케일(실제 쓰지 않은 음을 뺀 음계

garget : n, (소, 돼지, 가금 등의)인후 종양, (소, 양의)유방염)

garrot(t)e : n, vt, (스페인의)교형구, 교수형, 교살 강탈(사람 뒤에서 줄 등으로 목을 졸라 금품을 빼앗는, 교수형에 처하다, 목을 졸라 금품을 빼앗다

Gaza Strip : x, 가자 지구(이스라엘 남서부에 인접하는 항만 지역

gee ho, geeup : x, 이러, 어디여(소나 말을 빨리 가게 하는 소리

gelatinous : a, 젤라틴(아교0모양의, 아교질의, 젤라틴에 관한, 젤라틴으로 된

gelidity : n, (얼음처럼_차가움, 극한, 냉담함

gene bank : x, 유전자 은행(유전 물질을 생존시킨 상태로 보존하는 시설

general education : x, (전문(기술)교육에 대하여)일반 교육, 보통 교육)

general post : x, (오전)첫번째 배달 우편), 실내 유회의 일종

geographical mile : 지리 마일(적도에서의 경도 1분, 

geomagnetic storm : x, 자기 폭풍(태양 흑점에 의한다고 생각되는 지구 자기의 이변

Georgia Mafia : x, 조지아 마피아(조지아주 출신의 Carter대통령 측근들

German band : x, 관악기를 연주하며 거리를 누비고 다니는 소인수의)가두 음악대

gesticulator : n, 몸짓(손짓)으로 나타내는(말하는)사람)

ghost dance : x, 교령춤(아메리칸 인디언들이 죽은 사람의 혼과 통하기 위하여 추는 춤

gilly : x, n, 곡마단의 운반(자동)차, 작은 곡마단, 사육제의 꽃 자동차)

girlcott : vt, (여성이 여성에게 편견을 가진 사람을 보이콧하다_

giza : n, 기자)이집트 Cairo부근의 도시, 피라미드와 스핑크스로 유명)

glot : x, (연결형)(몇 개)언어에 통달한)의 뜻

glow lamp : x, 백열 전구, 백열(전)등)

glucinum : n, 글루시늄, =BERYLLIUM)

glyptics : n, (보석)조각술)

gnathous : x, (연결형)-턱을 가진)의 뜻

gogo fund : x, 주식의 단기 투자 자금)

golden number : n, 황금수(서력 연수에 1을 더하여 19로 나눈 나머지수, 부활절의 날짜를 산출하는 데 씀

gold record : x, 황금의 레코드(싱글판으로 100만판매, LP앨범으로 50만 세트 팔린 레코드의가수, 그룹에게 주는 상

good : n, 좋은, 잘된, 훌륭한, 행복한, 아름다운, 선량한, 예의바른, 현명한, 친절한, 관대한, 능숙한, 유능한, 참된, 유효한(as~as (죽은 것)과 같은

Gordon(setter) : x, 고든세터(스코틀랜드 원산의 털이 검은 중형의 사냥개

Gothic architecture : x, 고딕 양식의 건축(12-16세기에 서구에 널리 유행한 끝이 뾰족한 아치형의 양식

Gothic novel : x, 괴기, 공포 소설(18세기 후반 부터 19세기 초에 걸쳐 영국에서 유행

goulash commnuism : x, 굴라시 공산주의(소비 물자의 증산, 생활 수준 향상책을 강조

gourami : n, 구라미(등목어과의 동남아시아산 식용, 관상용 담수어

governess cart : x, (영)마주 앉는 좌석의)2륜 경마차

Graeae : n, 그라이아이(the Gorgons를 지키는 3자매;세 사람이 눈 하나와 이 하나 밖에 없음

Graf : n, 독일, 오스트리아, 스웨덴의)백작

graffiti art : x, (보도, 벽, 공중 변소 등에 하는 낙서 예술

Grams method : x, 그램 염색법(염색하여 세균을 양성과 음성으로 분류 식별하는 법

Grand Banks : x, 그랜드뱅크(Newfoundland남동부 근해의 얕은 바다로 세계 4대 어장의 하나

Grant : n, Ulysses Simpsom(1822~1885)미국의 군인, 정치가(남북전쟁의 북군 총사령관, 제 18대 대통령(1869~1877)

Greenwich (Mean(Civil)time : n, 그리니치 표준시

Gregorian calendar : x, 그레고리오력, 신력(로마 교황 Gregory XIII 제정(1582)

Grenada : n, 그러네이다(서인도제도 동부의 독립국;수도

grouper : n, (따뜻한)해안의)능성어과의 물고기

growth center : x, (sensitivity training등을하는)능력 개발 센터)

guaco : n, 열대 아메리카산 국화과 식물(만능약, 특히 배독, 간헐열에 씀

guerrilla theater : x, (반전, 반체제적인)게릴라 연극, 가두 연극)

guide word : x, 책의 페이지 윗부분에 인쇄된)찾아보기 말, 색인어

guild socialism : x, 길드 사회주의(제1차 대전 전의 영국 사회주의 사상

gummite : n, 구마이트, 고무석(황갈색 또는 적갈색의 고무 모양의 역청 우라늄광

Gunpowder Plot : n, 화약 음모 사건(1605년 11월 5일 영국 국회의 폭파를 음모한 Guy Fawkes를 주범으로 하는 천주교도의 음모

gyrase : n, 자이레이스(DNA의  이중 나선을 수퍼코일화하는 효소

f.dic
fenitrothion : n, 페니트로티온(사과 등 과수용 살충제

finger plate : x, 지판(손가락 자국이 나지 않게 문의 손잡이 주위에 댄 금속판

fleshings : n, (무대용의)살색타이츠, (가죽에서 벗겨낸살, 수구레

floor mat : x, 마루 매트(의자와 융단사이에 까는 플라스틱판

fool : n, 풀(삶은 과일을 으깨어 우유 또는 크림에 섞은 것

fouette : n, 푸에테(들어올린 다리를 채찍질하듯 급히 움직이기

fourth wall : x, 제4의 벽(무대와 관객 사이를 떼어 놓는 보이지 않는 수직면(공간)

q.dic
Qfever : n, Q열(rickettsia에 의한 열병

s.dic
SABMIS : n, (sea-based antiballistic missile intercept system 해저(잠수함)해저 요격 미사일 망(체제) (통칭 Sea-based ABM system)

sacroiliac : n, )

salep : n, 샐렙 가루(난초과)식물의구근에서 만듦, 식용, 약용)

Salome : n, 살로메(춤을 잘 추어 그 상으로 헤롯에게 청하여 세례 요한으로 머리를 얻은 소녀, (마태복음14:6-11)

Samnite : na, 고대 이탈리아의)삼늄(Samnium)사람(의)

SanchoPanza : n, 산초 판자(Cervantes작 Don Quixote에 나오는 인물, 돈키호테의 하인, 상식이 풍부한 속물의 표본

Sanctus : n, 상투스(성찬식 때 감사송 다음에 부르는 노래, Sanctus)거룩하시다)로 시작됨), 성가곡

sandhi : b, 하기)

Sankhya : n, 상키아 학파(철학), 수론 학파(인도 6파 철학의 하나

Santa Monica : n, 샌타 모니카(미국California주LosAngeles의 해변 휴양지

sapiens : a, 화석인과 구별하여)현 인류의

Sasquatch : n, 새스콰치(미국 북서부 산속에 있다고 전해지는 원인

scarlet letter : x, 주홍 글씨(옛날 간통자의 가슴에 꿰매 달게 한 붉은 헝겊의 A자 (adultery)

schizy : a, (미 정신 분열증의, 다중 인격의

schwa : n, 쉬와, 애매한 모음의 기호명, 히브리어의 shewa에서 옴)

scoliosis : 척추 측곡(척추가 왼쪽 또는 어른쪽으로 굽는 병, 

scorpioid : a, 전갈 같은, 전갈목(류)의, 전갈 꼬리처럼 말린, 고사리같이 말린((circinate)

Scrabble : 스크래블(anagram 비슷한 단어 만들기 놀이, 상표명:n, 

scribbler : n, 난필인 사람, 악필가, (경멸, 익살) 엉터리 문인, 잡문가, (양털을)얼레빗질하는 기계(를 움직이는 사람

seasonless : a, 4철(의 구별)이 없는)

Seder : n, 유대인의)유월절 밤 축제

selfaggrandizement : n, (적극적인)자기 권력(재산)확대(강화

selfsustaining : a, 자립((자활)하는, 자급 자족의

senatorial : a, 상원((원로원)(의원)의, 상원(원로원)의원다운, (대학)평의원회의, (미)상원 의원 선출권이 있는(선거구)

septate : a, 중격(격벽, 격막을 가진

shaver : 깎는(면도하는0사람, 이발사, 대패질하는 사람, 면도기구, 사기꾼, 꼬마, 풋내기, 

shemozzle : n, (영)싸움, 소동)

shoulderpiece : n, 어깨받이, (갑옷의)어깨에 대는 장구)

shout : vt, vi, n, 외치다 vi, 외치다, 소리치다, 부르짓다, 큰소리로 말하다(at), 고함치다, 떠들어 대다, 승부는 났다(남은 것은 갈채뿐), 외쳐(큰소리로)말하다), 외침, 소리침, 큰소리, 한턱낼 차례

shut : vt, vi, n, 닫히다, 잠그다, 잠기다, ~ down 닫다, (일시적으로)휴업(폐쇄)하다, ~ in 가두다, (가로)막다, ~ into , ...에 가두다, (도어 따위에 손가락이 끼이다, ~ off (가스, 물 따위)잠가 막다, (소리 따위를)가로막다, 제의하다

sicknessbenefit : n, (영)건강 보험의)질병 수당

sidehead : n, (인쇄물의 난외의(작은)표제

silhouette : n, 실루엣, 그림자, (그림), (옆얼굴의)흑색 반면 영상, 실루엣으로 하다, 파란 하늘을 배경으로 까맬A 보이는 나무)

sixth column : 제 6렬(fifth column을 도와 패배주의적 선전을 하는 그룹, 

snag : n, 꺽인 가지, 뻐드렁니, 물에 쓰러진 나무(배의 진행을 방해, 뜻하지 않은 장애, 방해하다, 잠긴 나무에 걸리게 하다

snaggy : a, 꺽인 가지, 뻐드렁니, 물에 쓰러진 나무(배의 진행을 방해, 뜻하지 않은 장애, 방해하다, 잠긴 나무에 걸리게 하다

solander : n, 고안자인 스웨덴의 식물학자 이름에서)(책, 서류, 식물 표본 등을 넣는)책 모양의 상자

Sorbonne : n, 소르보스(비타민(C 합성용 단당)

sozin : n, 소진(동물체 안에 존재하는 항병성 단백질

spelling pronunciation : x, 으로 읽는 따위)

spill : vt, vi, n, (액체, 가루를)엎지르다, (피를)흘리다, ...을 흩뿌리다, 내동댕이 치다, 지껄이다, (차, 말에서 내동댕이 치다, (돛의)바람을 새게 하다, 지껄이다, 누설하다, 엎질러지다, 엎질러짐, 전락

Stalin : n, Joseph1879-1953)소련 정치가

stenotype : n, 속기용 타이프라이터(그것에 쓰는0속기 문자

stenotypist : n, 스테노타이프(속기(술)(보통의 알파벳 용)

sterilizer : n, 불모로(불임케)하는 것, 빈약하게 하는 것, 멸균(소독)자, 살균 장치(제, 소독기

steward : n, 집사, (클럽, 병원 따위의)식사 담당원, 기선, 여객기 따위의)급사, 여객계원, (연회, 쇼 따위의)간사

sticker : 찌르는 사람, 찌르는 연장, 붙이는 사람(것), 광고 붙이는 사람, 풀 붇은 라벨, 스티커, 주저하는(꺼리는)사람, 고집(집착)하는 사람, 끈기 있는 사람, 밑질긴 손님, 오래 끄는(신중한)타자, (도살장의)백장, 좀체 팔리지 않는 상품, (풍금 등의)스티커(왕복하는 두개의지렛대를 연결하는 목간, 밤송이 가시, 당황케하는 사람(물건), 난문제(제출자), 수수께끼(puzzle)

storyboard : b, 스토리보드(텔레비전)영화의 주요 장면을 간단히 그린 일련의 그림을 붙인 패널)

stringer : n, 선수)

stub : vt, , ...을 그루터기로 하다, 그루터기를 뽑아내다, (발부리를 그루터기, 돌부리 등에부딪치다

submicron : a, (특히)직경이)1미크론 이하의, 초미세한, 미크론 이하의 입자로 된

suburbanity : n, 교외(도시 근교의 특징(성격, 분위기)

sugarcoated : n, (햄, 베이컨이)설탕, 소금, 질산염 등의 피클로 처리된)

Sunni : n, a, 수니파(이슬람 교의 2대 종파의 하나, 수니파의

sunny : a, 볕 잘 드는, 양지바른, 태양같은, 밝은, 명랑한, on the ~ side of (fifty( (50세)는 아직 안된

sunroof : n, (자동차의)선루프(지붕의 개폐식 채광장(sunshine roof), 일광욕용 옥상(지붕)

superhigh frequcncy : x, 초고주파(주파수 3천-3만 메가헤르츠, 생략 SHF

superpotr : a, 초대형 항구(거대 탱커 등을 위해 해상에 건설된

symposium : n, 토론(좌담)회, (고대 그리스의)향연, (같은 테마에 관한 여러 사람의 논(문)집

d.dic
dancing : n, 춤, 무도, 댄스 홀, 무도장, 댄스 교사)

dark brown star : x, (천)암갈색의 별(가시광을 거의 발하지 않는 은하 속의 적외선원

day coach : x, 침대차와 구별하여)보통 개차

deadonarribal : n, 병원에 도착하였을 때 이미 사망한 환자, (전자)처음 사용 때 작동하지 않는 전기 회로)

debate : n, vt, vi, 토른, 논쟁, 숙고, 토론회, 토론하다, 숙고하다)

debit card : x, (은행 예금에서 직접 인출할 수 있는 크레디트 카드(은행이 고객에게 발행

decarbonize : vt, (엔진의 실린더 벽 등의 탄소를 제거하다

declare : vt, vi, 선언하다, 언명하다, 신고하다, 공언하다, 성명하다, 언명해 놓고 그만두다, 해약하다)

decline : vi, n, 기울다, 아래로 향하게 하다, 사퇴하다, 쇠하다, 겨변화하다, 경사, 기욺, 물가의 하락, 쇠비, 쇠약병, 늘그막, 기울어, 쇠하여)

decruit : vt, (고령자 등을0다른 회사(낮은 부서)로 배치 전환하다, decruitment, n

de haut en bas : a, ad, 깔보는9태도로), 무례한(태도로)

delay machine : x, (악기)딜레이 머신(음성 신호를 임의로 지연시켜 재생하는 장치

demy : n, 디마이판, (영)옥스포드 Magdalen College의)장학생(졸업생)

denial : n, 부정, 부인, 거부, 극기, 싫다는 말을 못하게 하다)

desalinate[d`i:s'4l5n`eit)=DESALT

dextroamphetamine : n, 덱스트로암페타민(각성제 및 식욕 억제약으로 씀

dieseling : n, (가솔린엔진의)디젤링(스위치를 꺼도 엔진내의 과열점에 의해 자기 점화하여 회전을 계속하는 일

dignity : n, 위엄, 존엄, 관록, 품위, 체면에 관계되다, 위신을 손상 시키다)

dirt : n, 쓰레기, 먼지, 오물, 진흙, 흙, 토지, 비열한 언사, 욕, 굴욕을 참다, 욕을 하다)

discretion : n, 사려, 분별, 신중, 행동의 자유, 자유 재량, 분별 연령, 마음대로, 신중히)

disrate : vt, (해)(사람, 배 등의)등금을 낮추다)

district : n, 구역, 지구, 지방, county를 나눈 구, 미국 콜럼비아 특별 행정구 미국 수도의 소재지)

divert : vt, 돌리다, 전환하다, 기분을전환하다, 즐겁게하다, 전용하다, ...으로 기분을 푸다)

dividivi : n, (식)열대 아메리카 산 콩과 식물(의) 꼬투리)(무두질에 씀)

Dobro : n, 도브로(금속의 반향판이 달린 음향 기타, 상표명

documentation : n, 문서조사, 증거 자료, 문서 자료의 분류 정리, (선박의)선적 서류 비치)

dodec- : x, (연결형)12의 뜻(모음 앞에서는 dodec-

donation party : x, (미)손님이 선물을 주는 파티)

dong : n, 동(베트남의 화폐단위

dors- : x, _ (연결형)(등과, 등의, 의 뜻

dot : n, 점, 점재, 점을찍다, 점재시키다, 세세한데 까지 소홀히 않고 분명하게 하다)

dozens : n, )미)상대방 가족에 대한 농담을 하는 게임(흑인의 게임)

drabbet : n, ((영)갈색 즈크천

dragon's blood : x, 기린혈(용혈수)의 열매에서 채취한 수지, 와니스 등의 착색제)

drawstring : n, (자루, 옷자락 등을 졸라매는 끈

drooly : a, 침을 흘리는, (미)굉장히 매력적인, (미)옷, 차 등이)군침이 날 정도의, (미)인기 있는 남자(10대들의 용어)

drug design : x, (약)약제 설계(유효성을 높이기 위한 종합적 개발 검토

dry kiln : x, (목재의)건조로)

Dubai : n, 두바이(아랍 에미레이트 연방의 주요 구성국의 하나

dwt, : x, denarius weight, =penntweight)

dynamic pressure : x, (물)동압(로켓이 대기 속을 날때 받는 압력

e.dic
early : 이른, 초기의, 일되는, 맏물의, 어릴때의, 가까운 장래의(at an early date 금명ㄹ간에, 머지 않아, keep early hours 일찍자고 일찍 일어나다, 일찍, 이른 때에, 초기에

earthquake lights : x, 지진시의 발광 현상(지진 때 하늘이 밝게 빛나는 현상

East Bloc : x, 동구 공산권(바르샤바 조약기구)에 가맹한 소련과 동구 여러 나라)

East Central : n, (런던시의)중앙 동부 우편구)

Eastern Orthodox Church : x, 동방 정교회)

ebullism : n, (의)(급속한 기압강하로 인한 체액 비등

ECA : x, Economic Commission for Africa(국제연합)아프리카 경제 위원회, Economic Cooperation Administration(미)경제 협력국(MSA의 구칭

echolocation : n, 반향정위)박쥐등이 초음파를 내어 그 반사로 물체의 위치를 아는 것)

Eisenhower : n, Dwight(1890, 1969)미국 제 34대 대통령(1952, 61)에칭 Ike)

electronic countermeasure : x, (군)(적미사일의)유도 방향 전환 전자 장치)

embalm : vt, 시체에)향유를 발라서 보존하다:(이름을)길이 기억에 남기다, 향기를 풍기다, 향료를 치다

emu : n, 에뮤(타조 비슷한 큰 새, 날지 못함

enjoy : vt, 즐기다, 누리다, 향유하다, 건강, 재산 따위를 가지고 있다(enjoy oneself 즐기다, 즐겁게 지내다(시간을 보내다)

ENSA : n, Entertainment National Service Association)(영)위문 봉사회(군대를 위문하는)

ensign : n, 군기, 국기, 기수, 해군소위(national ensign 국기, red ensign 영국 상인, whete ensign 영국 군함기

entrain : vt, vi, 기차에 태우다(타다

entrance : n, vt, 들어감, 입장, 등장, 입학, 입구, 취업(entrance exmination 입학 시험, entrance fee 입장료, 입학금, n

eohippus : n, 에오히푸스(미국 서부에서 발굴된 시신세 전기의 화석마

eous : suf, ...와 같은, ...비슷한)의 뜻

Episcopalian : a, n, 감독과의 사람)

estate : 재산, 유산, 소유권, 재산권, 토지, 소유지, 살림살이, 처지, 사회적  지위, 사회적 신분, (정치, 사회적)계급(personal  estate 동산, the 

ethical : a, 도덕상의, 윤리적인(ethical drug 처방약(의사의 처방전 없이는 시판을 허용치 않는 약제)

Etonian : a, n, Eton의 Eton 교 학생)

euchre : n, vt, 유커(카드놀이의일종, 유커에서 지게 하다, 책략으로 이기다, 앞지르다

exception : 예외, 제외, 이의take exception to ...에 반대하다, with the exception of ...을 제외하고는), 

exceptional child : x, (교육)특수 아동(비범하거나 심신 장애로 특수 교육이 필요한

r.dic
rack : (모자 등의)...걸이, 선반, 그물 선반(기차의), ...시렁, ...대, 상자 시렁(서류 분류용), 식기 시렁(plate-rack), 꼴 시렁, (옛날의)팔다리를 잡아당기는 식의)고문대, 고문, (육체.정신의)큰 고통, (톱니바퀴의)톱니막대, 침대, 방, (보통 건물의)파괴, (바람에)날리는 구름, 조각구름, (말의)가볍게 뛰는 걸음, (말의)경구보, (말이)경구보로 뛰어가다, (포도주를)재강에서 짜내다, 고문하다, 괴롭히다, 끊어지도록 잡아당기다(틀다), 잡아 찢다, (머리등을)무리하게 쓰다, (생각을)짜내다, (소작인 등을)착취하다, (토지를)함부로 써서 토박하게 하다, 대(선반, 시렁에)얹다, (말을)꼴 시렁에 매어두다

radiomicrometer : n, (복사)에너지 검출용)열전 방사계

Rafferty('s) rules[r'4f5~rti(z)-)(권투 등에서의)무규칙

ram effect : x, 램 효과(기속)의 증가에 따라 흡입구에 유입되는 공기의 압력이 증가하는 효과)

ran : (혀가)잘 돌아가다, 유창하다, (..라고 씌어 있다), 평균(대체로)...이다, (편물등이)술술 풀리다, (스타킹이)줄이 가다, 올이 풀리다, (ladder), (성격.특징이)(...속에)흐르다, 전해지다, 내재하다, ...의 경향이 있다, 으로 흐르다, (수량등이)...에 달하다, (사람.말등을)달리게 하다, 몰다, (기선.차등을)다니게 하다, 운행시키다, (사람.말등을)달려서 어떤 상태가 되게 하다, (장소에서)도망가다, 도망치다, (사냥감을(쫓다, (사람을)차에 태워 가다, (말을)경마에 출전시키다, (사람을 선거에)입후보시키다, (사람을)(의원등에)입후보시키다, (바늘.칼등을)...에 찌르다, (실.손가락등을)궤다, 찔러넣다, ...에 부딪다, 부딪치다, 

reach : 도착(도달)하다(arrive in), ..에 닿다, 명중하다(hit), ...에 이르다, 퍼지다, (길이가)...에 이르다, (결과.결론에)도달하다, (목적등을)이루다, (손 등을)내밀다, 뻗다, (사람의 마음 등을)움직이다, 영향을 주다, (전화 등으로)연락하다, 손을 뻗다, 발돋움하다, (손.발이)빛깔 등의), 범위, 구역, 퍼짐(expanse), (한눈에 바라보이는)강의 두 굽이 사이의 유역, 운하의 구간(두 수문 사이의), 갑, 곶(promontory), (돛의 동일한 방향(tack)에서의)한 침로의 함정

red hunt : x, 빨갱이 사냥(공산주의자 및 그동조자의 체포(탄압)

redline : vi, vt, n, 운용 한계내에서 비행하다(에 맞추다), (급여 지급 대장 등의)리스트에서(항목을)삭제하다, (지역에)REDLINING을 적용하다, 운용한계(안전하게 비행할 수 있는 한계점(속도)

redoubt : n, 사각형보루, (임시의)작은)보루, 요새

regrater, -grator : n, 매점자, (곡물 등을 농가마다 돌며 사들이는)중매인, 사재기 상인)

reichsmark : n, 라이히스마르크(독일에서 사용하던 마르크화

relation : n, 관계, 관련, 연관, 친족(친척)관계, 연고, 친척, (구체적인)관계, 이해관계, 교섭, 교제, (이성과의)관계, 성교, 설화, 진술, 언급, 이야기, 고발, 신고, (법의 효력의 소급

replacement demand : x, (설비.내구재 등의)대체 수요, 대체 구매 수요)

repose : 휴식, 수면, 휴양, 정양, 안일, 안온, (활동의)휴지, 정지, (성인의)영면, (마음의)평온, (태도 등의)침착, (색채 등의)조화, 안정감, (신용.희망 등을)두다, 걸다, 위임(위탁)하다, 눕히다, 쉬게 하다, 휴양시키다, 쉬다, 휴식하다, 자다, 편히 눕다, 영면하다, 안치되다, 가로놓이다, 놓여 있다, 기초를 두다, 의지하다, 신뢰하다, (증거.논의등이)...에 의거하다, 입각하다, (마음이 언제까지나 머무르다

restrictive practice : x, (공익에 반하는)기업 협정, (노조 등에 의한)의도적 생산 제한)

retronym : n, 일반화된 상품명(Band-Aid(반창고), Kleenex(화장지)등과 같이 보통 명사화해서 쓰는 말), 광고 표기가 일반화 된것(Kentucky Fried Chicken의 finger-lickin' good(손가락을 빨 정도로 맛있는 등)

riel : n, 릴(캄푸치아의 화폐 단위

ringer : n, 둘러싼 사람(것), 고리(편자(등) 던지기 하는 사람(놀이), 그 쇠고리(편자)(의 한번 던지기), 몰리어 삥삥 도망쳐 다니는 여우, 둘러싼 사람(것), 종을 치는 사람, 종을 울리는 장치, 꼭 닮은 사람(것), 경기의 부정 참가자, 속이고 대리 출전한 사람(말)

ring lock : x, 고리 자물쇠(몇개의 홈을 낸 고리를 맞추어서 여는 자물쇠

riot gear : x, (경찰의 폭동 진압용 장비

Roundhead : n, 의회당원, 원두 당원)1642-49년의 내란시 왕당에 적대하여 머리를 짧게 깎았던 청교도의 별명)

round robin : x, (서명의 순서를 감추기 위해)원형으로 사인한 단체 항의서(탄원서(등), 사발통문, 기명회람장, (테니스.체스등의)리그전

rowel : n, vt, (박차 끝의(톱니바퀴, (~ed, ~ing, ~led, ~ling)박차를 가하다

rugger : n, 럭비(Rugby football)(cf.SOCCERP

runty : a, )runtier, -iest)발육부전의, 왜소한, 꼬마의

rupiah : n, 루피아(인도네시아의 화폐단위, 기호 Rp, =100 sen, 루피아 지폐

Russell : n, 남자 이름, 러셀 Bertrand ~ 91872-1970)(영국의 수학자.철학자.저술가)

Russia : n, 러시아 제국(Russian Empire)(수도 St.Petefsburg(지금의 Leningrad), 소련(수도 모스크바), =RUSSIA LEATHER

