A : a 하나의, 어느 하나의, 어떤(a certain), 같은
A-frame : a, n, A(자)형의, A형 틀(무거운 물건, 호이스트, 샤프트, 파이프 등을 받치는 데 씀)
A-sub : n, 원자력 잠수함
A.B.S. : x, American Bible Society, absent absolute(ly) abstract
A.C.I.S. : x, Associate of the Chartered Institute of Secretaries
A.C.L.S. : x, american council of learned societies
A.C.U. : x, =Autocycle Union
A.E.R.E. : n, Automatic Energy Research Establishment, 원자력 연구소
A.N. Other : n, 익명씨, 선수 미정
A.V.C. : n, American Veterans' Committee미국 재향 군인회
aardvark : n, 땅돼지, 남아프리카산 땅돼지
Aaron : n, 아론(모세의 형, 유태교 최초의 제사장)
Aaron's beard : x, 물레나물, 범의귀 따위의 속명
Aaron's rod : x, 식물 미역취 따위의 속명
aba : n, 염소털로짠옷감, (아라비아인의)소매 없는 긴 겉옷
abac : n, 계산도표, 조견도표
abaca : n, 마닐라삼
aback : ad, 뒤로, 후방으로, 돛이 거꾸로, be taken~ 뜻밖에, (느닷없이)당하다, 깜짝 놀라다
abacus : n, 수판, 주판, (둥근 기둥의)대접받침
abaddon : n, 지옥, 나락, (=apollyon)
abaft : ad, prep, 뒤로, 뒤에, 고물(선미)에(aft)
abalone : n, 전복
abampere : n, 절대 암페어, 10암페어(전류위 cgs 전자단위)
abandon : 1)버리다, 버려두다, 단념하다, 2)내맡기다, (집, 동네를)떠나다, 3)유기하다(술)에 젖다, (절망)에 빠지다
abandonee : n, (유기 자산의)피위부자
abase : vt, 낮추다, (지위나 품위를)떨어뜨리다(degrade), 창피를 주다
abash : vt, 부끄럽게 하다, 당황케 하다(=embarrass)
abasia : n, (뇌중추 장애 등에 의한)보행불능증
abate : vt, 1)할인하다, 내리다, 할인하다, 덜다, 누그러뜨리다2)줄다 약해지다, 누그러지다
abatis : n, 가시울타리, 철조망
abattoir : n, 도살장, 공설도축장
Abba : n, 아버지(기도에서의 하나님, 마가 XIV 36)
abbacy : n, 대수도원장의 관할구역, 대수도원장의 직(임기)
abbatial : a, 대수도원(장)의, 대수녀원장의
abbe : n, (프랑스의)대수도원장, 신부
abbess : n, 여자수녀원장(CF, ABBOT)
abbey : n, 수도원
abbot : n, 수도원장
abbreviate : vt, 줄이다, 단축하다
abbreviate : vt, 줄이다, 단축하다
abbreviation : n, 생략, 약어, 약자
ABC : n, =alphabet;초보, 입문서
ABCC Atomic Bomb Casualties Commission : x, 원폭 상해 조사 위원회
abdicate : vt, (권리, 지위를)버리다, 퇴위하다, 퇴관하다
abdication : n, 사직, 퇴위, 퇴관
abdicator : n, 포기자, 퇴위자, 양위자
abdomen : n, 배, 복부
abdominal : a, 복부의
abduct : vt, 유괴하다, 외전시키다
abductor : n, 유괴자, 외전근
Abe : n, 아브라함의 통칭
abeam : ad, (배위 용골에)가로로(선채와T자를이루어)
abecedarian : n, 초학(심)자, 초보의, 기본의, 아무것도 모르는
abed : ad, 잠자리에
Abel : n, 아벨(아담의 둘째아들, 형 가인에게 살해됨)
Aberdeen : n, 스콜틀랜드의 동북부도시, 스모치테리어개
aberdevin : n, 검은방울새(유럽산)
aberrance : n, 탈선, 과오
Aberdonian : a, 에버딘의사람
aberrancy : n, 탈선, 과오
aberrant : a, 정도를(바른 길을) 벗어난, 탈선적인
aberration : n, 바른 길을 벗어남, 정신 이상, (렌즈의)수차
abet : vt, 부추기다
abeyance : n, 중절, 정지
abhor : vt, 몹시 싫어하다, 혐오하다(detest)
abhorrence : n, 혐오, 아주 싫은 것, 싫은(to me), 몹시 싫은(OF IT), 서로 용납치(맞지)않는(TO, FROM)
abidance : n, 지속, 거주, 체재, (...의)준수
abide : vi, 머무르다, 살다, 지탱(지속)하다
abide by : x, (약속, 결의 따위를)굳게 지키다, 따르다, 규칙을 엄수하다
abiding : a, 영속적인
abigail : n, 시녀, 몸종
ability : n, 능력, 수완(to do), 재능
abiochemistry : n, 무기화학
abiogenesis : n, 자연발생론
abiotic : a, 생명(생물)에 관계없는, 비생물적인
abirritant : n, a, 진정제, 자극완화제(의)
abject : a, 비참한, 비열한
abjection : n, 영락, 비열함
abjectly : ad, 비열함
abjure : vt, 맹세코 그만두다, (주의, 의견 등을)버리다
ablation : n, 제거, 삭마, (로켓)융제(우주선의 대기권 재돌입시 피복 물질의 녹음)
ablative : n, a, 탈격(의), ~absolute 탈격 독립구
ablator : n, 융제물질
ablaut : n, 모음전환(gradation)(보기 sing-sang-sung)
ablaze : ad, 불타올라, 격하여, set~ 불태우다
able : a, 재능 있는, 유능한, 능란한, 자격이 있는, ...할 수 있는, be~to(do)~할 수 있다 , -ible()suf, 기능을 나타내는 형용사를 만듦, admirable, comfort-able, accessible, sensible
ablebodied : a, 강건(강장)한, 튼튼한(an...seaman)적임(일등)선원
abloom : ad, a, 꽃이 피어
ablush : ad, a, 얼굴을 붉혀
ablution : n, (몸을)깨끗이 씻음, 목욕 재계, 깨끗이 씻는 물
ably : ad, 훌륭히, 교묘히
ably : ad, 훌륭히, 교묘히, 유능히
ABM : n, 탄도탄요격 미사일(Atomic Bomb Mission 원폭 조사 위원회
abnegate : n, (권리 등을)버리다, 자제하다, (쾌락 등을)끊다
abnormal : a, 비정상인, 이상의, 변태의, 변칙의(~psychology 이상 심리학)
abnormality : n, 이상, 변칙, 병신, 불구
ABO : n, 혈액조직ABO분류법
Abo-o, ab-o : n, =ABORIGINAL
aboard : ad, prep, 배 안에(로), 차내에(로)
abode : v, n, abide의 과거(분사), 거주, 주거, 체류
abolish : vt, a, n, 폐지하다, 철폐하다(~.a.ble, ~ment)
abolition : n, 폐지, 노예 폐지(~ism)(노예)폐지론, ~ist(노예)페지론자)
abomasum : n, 동물의 추위(반추 동물의 제 4위)
Abomb : n, 원자, 고속용으로 개조한 중고차(hot rod)
abominable : a, ad, 싫은, 지겨운, 지독한, the~snowman(히말라야의)설인, -bly 미울 정도로, 지겹게
abominate : vt, 혐오하다, 몹시 싫어하다
abomination : n, 혐오, 증오, 싫은 일
aboriginal : a, n, 처음부터의, 원주의, 토착민의, 원주민, 토인, 토착의 동식물
aborigines : n, 원주민, 토착민
aborning : ad, 태어나려하고 있는, 수행되기 전에
abort : vi, n, 1)유산하다, 조산하다, 실패하다, 발육이 안된 채 끝나다, 로켓비행이 중단 되다, 프로그램 실행의 중지
abortifacient : n, a, 낙태약, 유산을 촉진하는 
abortion : n, 유산, 조산, 유산아, 낙태, 실패, 기형물, 불구 발육부전, (artificial~인공 유산, ~ist 낙태의)
abortive : a, 유산의, 조산의, 실패의, 발육부전의
aboulia : n, =abulia
abound : vi, a, ad, ...이 많다(Trout~in this lake=This lake~s with trout 이 호수에는 송어가 많다)(~ing, ~ingly)
about : prep, ad, a, vt, ~에 대하여, ~의 주위에, ~의 여기저기에, 대략, 약, ~경에, ...의 둘레에, 도처에, 병이 돌아서 , 소문등이 퍼저서
aboutface : vi, n, 뒤로 돌다(돌기), (사상 따위)전향하다, 전향
above : prep, ad, a, n, ~보다 위에, ~을 넘어, ~보다 윗자리에
aboveaverage : a, 평균을 넘는, 보통 아닌, 괜찮은
aboveboard : ad, pred, 있는그대로의, 공명히
abovedeck : ad, a, 갑판 위에서, 공명정대하게, 있는 그대로
aboveground : ad, 지상에, 매장되지 않은, 생존하다
abovementioned : a, 상술한, 위에 말한
abovestairs : ad, a, 위층에
abovo : ad, (L.=from the egg) 처음부터
Abp : x, archbishop
abracadabra : , 이마를 삼각형으로 그듭쓴(병 예방의)부적, 주문, 뜻 모를 말(gibberish)
abrachia : n, 결여(증), 상지(의학용어)
abractness : n, 추상성
abrade : vt, vi, 닳리다, 문대어 벗기다, 신경질나게하다
abrader : n, 연삭기
Abraham : n, 남자 이름, 아브라함(유태인의 조상)
Abrahamman : n, 가짜로 미치광이 짓을 하며 다니는 거지(영국에서)
Abram : n, 남자이름, 아브람
abranchiate : n, 아가미없는(동물)
abraser : n, =ABRADER
abrasion : n, 벗겨짐, 문질러 닦음, 찰과상, 마멸(된곳)
abrasive : a, 연마의, 꺼칠꺼칠한, 마찰 있는(인간관계), 피부를 긁히는
abreact : vt, 정화하다(억압된 감정을), ...을 해제하다
abreaction : n, (억압 감정)해방, 소산
abreast : ad, 나란히, 어깨를 나란히 하여, keep~of(with)(the times)(시세)에 뒤지지 않고 따라가다
abridge : vt, 1)단축하다, 적요하다, 간추리다, 줄이다2) ...으로부터 ...을 빼앗다(deprive)
abridgement : n, 요약본, 초본, 적요, 축소, 단축, 요약
abroach : ad, pred, a, (통의)마개를 따고, 퍼져서
abroad : ad, 
abrogate : vt, (법률, 습관 등을)폐기하다
abrogation : n, 폐지
abrogative : a, 폐지(폐기)의
abrogator : n, 폐기자, 철회자
abrupt : a, 느닷없는, 험준한, 퉁명스러운, (글의 앞뒤가)동일하지 않는
abruption : n, (급격한)분열, 분리
abruptly : ad, 갑자기(=suddenly), 뜻밖에, 퉁명스럽게, 무뚝뚝하게
Absalom : n, 압살롬(다윗의 셋째 아들, 부왕을 배반했음)
abscess : n, 종기, 농양
abscessed : a, 종기가 생긴
abscind : vt, 절단하다, 잘라내다
abscise : vt, vi, ...절단하다, 절제하다
abscissa : n, 횡선, 가로 좌표
abscission : n, (수술에 의한)절단, 절제, 갑작스런 중단
abscond : vi, n, 도망하다(~with the money 돈가지고 도망치다) ~enc 도망, 실종
abscondence : n, 도망, 실종
abseil : n, vi, (자일을 쓰는)현수하강, 현수하강을 하다
absence : n, 부재, 결석, 결핍, 없음(of), 방심(~of mind 방심, in the~of ...이 없기 때문에, 이 없을 경우에)
absent : a, ad, 부재의, 결석의, 없는, 멍청한, 결석시키다(~oneself from ...을 비우다, 결석하다), ~ad 멍하여, 멍하게
absentee : n, a, 부재자, 부재지주, 부재투표자의(를위한)(~ism부재지수제도)사보타즈전술
absentee ballot : x, 부재 투표 용지
absenteeism : n, 부재지주 제도, 장기 결석, 계획적 결근
absentee voter : x, 부재 투표자
absentee voting : x, 부재자 투표
absently : ad, 얼빠져, 넋을 잃고
absentminded : a, ad, 방심 상태의, 멍(청)한(~ly)
absinthe : n, 압생트(독한술)
absinthism : n, 압생트중독(술)
absitomen : int, (제발)이것이 흉조가 아니길! 맙소사 맙소사
absolute : a, 절대의, 순수한, 무조건의, 전제의, 절대온도(고도)의, (컴퓨터)기계어로 쓰인
absolute alcohol : x, 무수 알코올
absolute altitude : x, 절대 고도
absolute ceiling : x, 절대 상승 하도(안전 비행이 가능한)
absolute construction : x, 독립 구문
absolute humidity : x, 절대 습도
absolute infinitive : x, (participle)독립 부정사(분사)
absolutely : ad, 아주 맞았어, 그래
absolute magnitude : x, 절대 등급
absolute majority : x, 절대 다수
absolute monarchy : x, 전제 군주 정체
absolute music : x, 절대 음악(표제 음악에 대해서)
absoluteness : n, 
absolute pitch : x, 절대 음고(음감)
absolute temperature : x, 절대 온도
absolute value : x, 절대값
absolute zero : x, 절대 영도(-273도)
absolution : n, (회개한 자의)면죄, 책임 해제
absolutism : n, 전제주의, 독재 정치
absolutist : n, 절대론자, 전제정치론자, 전체주의자
absolutize : vt, 절대화하다
absolve : vt, 방면하다, 사면하다, 무죄를 언도하다
absonant : a, 조화되지 않는
absorb : vt, 흡수하다, 병합하다, 동화하다, (흥미로)이끌다(be~ed by ...에 흡수(병합)되다
absorbability : n, 흡수됨, 피흡수성
absorbable : a, 흡수되는, 흡수되기 쉬운
absorbed : a, 마음을 빼앗긴, 열중한, 여념 없는
absorbefacient : a, n, 흡수성의, 흡수제
absorbency : n, 흡수성
absorbent : a, n, 흡수성의, 흡수제
absorbent cotton : x, 탈지면
absorbent cotton : x, 탈지면
absorbing : a, 흡수하는, 흥미진진한
absorptance : n, 흡수율(비)
absorption : n, 흡수, 몰두
absorption band : x, 흡수대
absorption spectrum : x, 흡수 스펙트럼
absorptive : a, 흡수하는, 흡수력 있는, 흡수성의
absquatulate : vi, 뺑소니 치다, 종적을 감추다
abstain : vi, n, 끊다, 자제하다, 삼가다(from), 금주하다(~ern)절제가, 금주가
abstemious : a, 절제하는, (an~diet)절식
abstention : n, 절제, 자제(from), 기권
abstentious : a, (술을)끊은, 절제하는
absterge : vt, 씻어내다(없애다), 깨끗이 하다
abstergent : a, n, 세척력이 있는, 깨끗이 하는, 세제
abstersion : n, 세정, 청정화
abstersive : a, 께끗이 하는, =ABSTERGENT
abstinence : n, 금욕, 절제, 금주
abstinent : a, 절제하는, 금욕적인, 금주하는
abstracism : n, 추상주의
abstract : a, 추상적인, 공상적인, 심원한, 방심한, 추상파의
abstracted : a, 추상된, 추출된
abstracter : n, 추출하는 사람(물건)
abstraction : n, 추상, 추출, 추상파의 작품, 방심, 절취
abstractionmonger : n, 공상가, 얼빠진 사람
abstractive : a, 추상적인, 추출력 있는, 초록의
abstractly : ad, 추상적으로
abstract noun : x, 추상명사
abstruse : a, 난해(심원)
abstrusity : n, 난해(함), 난해한 것(점)
absurd : a, 불합리한, 모순된, 어리석은
absurdism : n, (문학, 연극 등의)부조리 주의
absurdity : a, 부조리한, 엉터리없는 일(것 이야기)
ABU : n, 아시안방송연합
abubble : a, 거품이 일어나는, 뒤끓는, 동요(흥분)하는
abuilding : a, 건축(건설, 건조)중인
abulia : n, (마음)의지상실
abundance : n, 풍부, 윤택, 다수, 부유, 충분한 물자 공급
abundant : a, ad, 풍족한, 남아돌 정도의(-dantly)
abusage : n, 말의 오용
abuse : vt, n, 남용하다, 악용하다, 학대하다, 욕하다, 악용, 남용, 학대, 욕(설), 악습, 폐해 
abusive : a, 입 사나운
abut : vt, vi, 인접하다(on, upon), 기대다(against)
abutilon : n, 어저귀속의 식물
abutment : n, 인접, 접합부, 홍예받침대
abuttal : n, 인접, 경계
abutter : n, 인접 지주, 인접된것
abutting : a, 인접한, 접경한, 건축에서 홍예받침대 구실을 하는
abuzz : a, 와글와글, 활기 넘쳐
abvolt : n, 전자단위 기호
abwatt : n, 절대 와트
abysm : n, 심연, 심원, 끝없이 깊은 지옥, 나락
abysmal : a, 한없이 깊은, 심연의, 나락의, 지독히 나쁜
abyss : n, (밑이 없는의 뜻에서)심연, 나락, 지옥, 혼돈
abyssal : a, (해면에서 300길이 넘는)깊은 바다의, 바닥을 알 수 없는
Abyssinia : n, 아비시니아
Abyssinian : a, n, 아비시니아의, 아비시니아 사람, 아비시니아 말
AC/DC : x, ac/dc alternating current/direct current 교류, 직류의, 교직양용의, 양성에의
acacia : n, 아카시아
academe : n, 학구적 생활, 학자 생활, 학구, 학자연하는 사람
academese : n, (딱딱한)학자풍의 문체(용어)
academia : n, 학자의 세계
academic : a, 학문의, 대학의, 학구적인, 비현실적인, 인문과의, 일반 교양적인, 형식존중의, 진부한, (Academic)플라톤 학파의
academical : n, 대학의 예복과 예식용 모자, 대학생의 정장
academic  costume : x, 대학 예복
academic freedom : x, 학문의 자유
academician : n, 아카데미(학회, 학술원, 미술원)회원
academic interests : x, 학교 경영 단체
academicism : n, 예술원풍, 형식주의
academic year : x, 학년(도)
academism : n, 예술원풍, 형식주의
academy : n, 학원, 사립의 고등 학교, 전문 학교, 학회, 아카데미아(플라톤이 철학을 강의한 아테네 근교의 올리브 숲)
Academy award : n, 아카데미상(영화)
academy board : x, (유화의)판지캔버스
Acadia : n, 캐나다 남동부
Acadia : n, 캐나다 남동부의 지방
acaleph : n, 해파리의 일종
acanthoid : a, 가시 모양의, 가시가 있는
acanthus : n, 아칸서스, 아칸서스 잎 장식(그리스 건축의 주두)
acappella : a, 무반주 음악
acariasis : n, 진드기(기생)증
acarid : n, 진드기
acarpous : a, 열매 맺지 않는
acatalectic : a, 행 끝의 시각이 완전한, 완전운각의
acatalepsy : n, 불가지론(철학)
accede : vi, 취임하다(앉다)(to) , (요구에) 동의하다, 따르다, (조약 따위에) 참가하다
accedence : n, 
accelerando : ad, a, 점점 빠르게, 빠른
accelerant : n, 촉진제, 촉진
accelerate : vt, vi, 빨리하다, 빨라지다, 속도를 늘리다
accelerated : a, 속력이 붙은, 가속된
acceleration : n, 가속, 촉진, 가속도
accelerative : a, 가속의
accelerator : n, 가속장치, 촉진제
accelerometer : n, 가속도계
accent : n, vt, 악센트(부호), 강조, 어조, 말투, 사트리, 음성, 말, 시구, ...에 악센트를 두다;(음색체 따위를)강하게 하다
accentuate : vt, ...에 악센트를 두다, 악센트 부호를 붙이다, 두드러지게 하다, ...을 역설하다
accentuation : n, 음의 억양법, 악센트를 붙이는 법, 강조, 역설, 두드러지게 하기
accept : vt, 받아들이다, 떠맡다, 용인하다
acceptability : n, 수락할 수 있음, 응낙, 만족, 용인성
acceptable : a, 받을 수 있는, 좋은
acceptance : n, 수령, 어음의 인수
acceptant : a, n, (...을) 기꺼이 받아들이는, 받아들이는 사람, 수락자
acceptation : n, 받아들임, 신앙
accepted : a, 일반적으로 인정된, 용인된
accepter : n, 받아들이는 사람, 수락자, 수납자
accepting : n, (런던의)어음 인수 상사
acceptive : a, 받아들일 수 있는, 받아들이는
acceptor : n, 어음 인수인
access : n, 접근, 발작, 부가, 증가(be easy of~ 접근(가까이)하기 쉽다, gain~to ...에 접근하다, 가까이하기 쉬운 사람
accessary : a, n, =ACCESSORY 부속의
accessibility : n, 
accessible : a, 접근(가까이)하기 쉬운, 얻기 쉬운
accession : n, 접근, 도달, 취임, 계승, 상속, 증가(물), (도서관의)수납도서, (종업원의)신규 채용
accession number : x, 도서수납번호
accessorial : a, 보조의, 종범의
accessorily : ad, 보조적(종속적)으로
accessorize : vt, vi, (부속품, 액세서리를)공급하다, 비치다, (의복에) 액세서리를 달다
accessory : a, n, 부속의, 보조의, 종범의, 부속물, (여성의)악세사리, 종범자
access road : x, (어느 시설에의)진입로
access time : x, 호출시간(기억 장치에 정보를 기록, 해독케 하기 위한 시간), 컴퓨터용어
accident : n, 우연히 일어난 일, 사고, 재난
accidental colors : x, 보색잔상으로 일어나는 색
accidental error : x, 우연오차
accidental insurance : x, 상해보험
accidentally : ad, 우연히, 뜻하지 않게
accidentprone : a, 사고를 일으키기 쉬운
accidie : n, 게으름, 무위
accipiter : n, 매의 총칭, 매, 맹금
accipitral : a, 새매(매)같은, 맹금성의
acclaim : n, vt, vi, 갈채, 환호, 갈채를 보내다, 갈채하다
acclamation : n, 환호, 갈채, 환호투표
acclamatory : a, 순화하는
acclimatable : a, 풍토에 순응시킬 수 있는
acclimate : vt, vi, 풍토에 순화시키다
acclimation : n, 새 환경 순응, 새 풍토 순화
acclimatization : n, =ACCLIMATION
acclimatize : vt, =ACCLIMATE
acclivity : n, 치받이
acclivous : a, 치받이의, 비탈진
accolade : n, 칭찬, 명예, 나이트작 수여식
accommodate : vt, 적응시키다, 조절하다, 화해시키다, 공급하다, 빌려주다, 숙박시키다, 수용하다
accommodating : a, 친절한, 잘 돌봐주는, 붙임성 있는, 싹싹한, 융통성 있는, 고분고분한
accommodation : n, 적응, 순응, 화해, 조정, 융통, 대부금, 편의, (호텔, 병원, 선박 등의)숙박 설비
accommodation bill : x, 융통어음
accommodation ladder : x, (배, 여객기의)트랩, 승강계단
accommodation load : x, 특설도로
accommodation train : x, 완행열차
accommodation unit : x, 주택, (관청용어)
accommodative : a, 필요에 대응하는, 적응적인
accommodator : n, 적응자, 조정자, 융통해 주는 사람, 임시고용(파트타임)의 가정부, 파출부
accompaniment : n, 수반하는 물건, 반주
accompany : vt, 따르다(be accompanied by a person with a thing), 반주하다
accompanying : a, 따르는(징조 등), 동봉(첨부)한 (편지 등)
accomplice : n, 공범자, 동류
accomplish : vt, 완수하다, 성취하다, 달성하다, (학문과 기예를) 가르치다
accomplish : a, 완성한, 숙달한, 소양(교양)이 있는
accomplishable : a, 이룰 수 있는, 완성(성취)할 수 있는, 습득할 수 있는
accomplished : a, 성취(완료, 완성)된, 뛰어난, 능란한, 조예가 깊은, 교양이 있는, 세련된
accomplishment : n, 성취, 완성, 수행, 실행, 성과.(경멸)서투른 제주
accompt : n, v, =ACCOUNT
accord : n, vi, 일치하다, 맞다, 조화하다
accordance : n, 일치, 조화
according : ad, 따라서, ~as(...함)에 따라서, ~to ...에 의하면, ...에 따라.그에 따라서, 그러므로
accordingly : ad, 따라서, 그러므로, 그에 따라서, 그에 알맞게
accordion : n, 아코디언
accordion door : x, 접었다 폈다하는 문
accordion pleats : x, 잔주름(스커트)
accost : vt, n, 말을 걸다, 말붙임, 인사
accouchement : n, 분만, 출산
accoucheur : n, 조산원, 산부인과 의사(남자)
accoucheuse : n, 산파, 조산원(여자)
account : n, 계산(서), 셈, 설명, 변명, 기사, 평가, 이유, 근거, 가치, 이익
account : vt, vi, ...라고 생각하다, 설명하다, 셈하다
account : n, 계산서, 셈, 설명, 변명, 기사, 이유, 평가, 가치, 이익
accountability : n, 책임
accountable : a, 설명할 수 있는, 책임 있는
accountancy : n, 회계사의 직(사무)
accountant : n, 회계원, 회계사, 계리사
accountant general : x, 회계(경리)과장, 경리국장(부장)
account book : x, 회계장부
account current : x, 교호계산
account day : x, 결산일
account executive : x, (광고, 서비스회사의)섭외부장
accounting : n, 회계(학)
account rendered : x, 대차정산서, 지불청구서
account sales : x, (위탁 판매의)매상계산서, 외상판매
accouplement : n, 연결, 결합, 연결재, 두 원주를 접근(밀착)시키는 공법
accouter : vt, 차려 입다(sith, in), ~ment 복장, (pl)(군복, 무기 이외의)장구
accouterments : a, 복장, 몸차림, 장구(무기, 군복 이외의)
Accra : n, 가나의 수도
accredit : vt, vi, 믿다, 신뢰(신임)하다, 신임장을 주어 파견하다, (어떤 행위를 남에게)돌리다, (아무의)짓으로 돌리다(~hiwith)
accreditation : n, (학교, 병원 등의)인정, 인가, 신임장
accredited : a, (사람, 학교 등이) 기준 합격의, 인정된, 공인된, (신앙이) 정통의, (학설 등이) 일반적으로 인정된, 용인
accrete : vi, vt, 부착하다, ~에 부착시키다
accretion : n, a, 부가물, (부가에 의한) 증대(-tive 부착에 의한)
accretive : a, 증가(첨가)하는, 증가성의, 확대하는, 퇴적하는
accrual : n, 발생, 수익을 얻음, 이자가 붙음
accrue : vi, 생기다, 발생하다
acculturate : vt, vi, 문화 이입에 의하여 변용 시키다(하다), 문화를 이입하다
acculturation : n, 
accumulate : vt, vi, 모으다, 쌓이다, 모이다(~dfund 적립금)
accumulation : n, 집적, 축적
accumulative : a, 쌓인, 모인, 축적하는
accumulator : n, 모으는 물건(사람), 축재가, 축전지, (컴퓨터)누산기
accuracy : n, 정확, 정밀
accurate : a, 정확한, 정밀한
accurately : ad, 정확히(exactly), 정밀하게
accursed : a, 저주받은, 지겨운
accurst : a, 지겨운, 진저리나는
accusable : a, 고소(고발)해야 할, 비난할 만한
accusation : n, 비난, 힐책, 고소, 고발, 죄, 죄명
accusatival : a, 대격의, 직접 목적격의
accusative : n, a, 대격의
accusatorial : a, 고발자의, 비난자의, 고발주의의
accusatory : a, 비난의, 고소의, 고발의
accuse : vt, 고발하다, 고소하다, 비난하다, 책하다
accused : n, 피고인(들), 피의자
accuser : n, 고소인 원고
accuser : n, 고발인, 비난자
accusing : a, 고발하는, 비난하는, 책망하는 듯한
accustom : vt, a, 익히다, 예의, 늘하는식의
accustomed : a, (...에)익숙한, 길든, 여느 때와 다름없는, 평소의
ACE : x, American Council on Education
ace : n, 우수 선수, 카드 따위의 1, 게임에서1점, 능수, 명인, 제1인자, 우수 선수, 하늘의 용사
acedia : n, 게으름
acehigh : a, 우수한, 크게 인기 있는
Aceldama : n, (가롯)유다가 자살한곳, 유혈의 땅
acellular : a, 세포를 가지지 않은, 세포로 갈라지지 않은, 무세포의
acentric : a, 중심이 없는(을 벗어난)
acephalous : a 무두의, 지도자가 없는
acerate : a, 침상의, 침엽을 가진
acerb : a, 신, 쓴, 떱떨한(말, 태도, 기질이), 엄격한, 격한, 통렬한
acerbate : vt, ...을 성나게 하다, 괴롭히다
acerbity : n, 신맛, 쓴맛, 통렬함, 신랄함
acerose : a, 겉겨 모양의, 겉겨가 섞인
acervate : a, 군생하는
acescent : a, 시게 되는, 미산성의, 신 듯한, 시무룩한, 언짢아하는, 약간 까다로운
acetabular : a, 비구의, 빨판의
acetabulum : n, 빨판, 비구, 관골구
acetal : n, 아세탈, 수면제
acetaldehyde : n, 아세트알데히드
acetamide : n, 아세트아미드(결정성 초산 아미드, 유기 합성, 용제용)
acetaminophen : n, 아세트아미노펜(해열 진통제)
acetanilide : n, 아세트아닐리드, 진통해열제
acetate : n, 초산염
acetated : a, 초산으로 처리한
acetate rayon : x, 아세테이트(인조견사 일종)
acetic : a, 초의, 초산의
acetic acid : x, 초산
acetic anhydride : x, 물이 없는 초산
acetification : n, 초화
acetifier : n, 초화기, 초산 제조기
acetify : vt, vi, 초화하다, 시게하다(되다)
acetimeter : n, =ACETOMETER
acetometer : n, 초산 비중계, 초산 농도 측정기
acetone : n, 아세톤(휘발성, 가연성의 액체, 용제, 무연 화약, 니스 등에 쓰임)
acetous : a, 초같은, 초의, (맛이) 신
acetyl : n, 아세틸
acetylcholine : n, 아세틸콜린
acetylene : n, 아세틸렌
acetylsalicylic acid : n, =ASPIRIN
Achaea : n, 그리스의 한지방
Achaia : n, a, 아케아(고대 그리스 남부의 땅), -an, -ch'aian 아케아의(사람), 그리스의, 그리스 사람
Achates : n, Aeneas의 충실한 벗(Virgil 작 Aenceid중의 인물), 신의가 두터운벗
ache : vi, n, 아프다, 쑤시다, 갈망하다, 아픔
achene : n, 수과
Achernar : n, 아케르나르
Acheron : n, 아케론 강, 그리스 로마 신화의 아케론강, 저승
Acheulean : a, (구석기 시대의 한 시기) 아슐기
achievable : a, 성취(달성)할 수 있는
achieve : vt, n, 성취하다, 이루다, (목적을) 달성하다, (명성을) 얻다, achievement 성취, 업적, 위업
achievement : n, 성취, 연령
achievement age : n, 학업성취연령
achievement quotient : x, 성취(성적)지수(생략 A.Q)
achievement test : x, 학력검사
achilary : a, 무순판의
Achillean : a, 아킬레스의(같은)
Achilles : n, 아킬레스(Homer작 Ilad에서 발빠른 용사) hell of... 유일한 약점
Achilles tendon : n, 아킬레스건
achluophobia : n, 암흑공포증
achromatic : a, 색이 없는, 색을 없앤
achromatin : n, (세포핵 안의)비염색질
achromatism : n, 색지움, 소색성, 무색
achromatize : vt, ...색을 없애다, (렌즈의)색수차를 없애다
achromatopsia : n, (전)색맹
achromic : a, 무색의, 염색 물질이 결여된, 색소 결여(증)의
A chromosome : x A염색체(과잉 염색체 이외의 보통 염색체)
Achromycin : n, 아크로마이신
acicimeter : n, 산정량기, 산적정기
acicula : n, 바늘 모양 부분(돌기), 바늘, 가시, 강모, 침상 결정(체)
acicular : a, 바늘 모양의, 바늘처럼 뾰족한, 가시(강모)가 있는
aciculate : a, 바늘 모양의, 바늘로 긁은 자국이 있는, 바늘처럼 뾰족한
acid : n, a, 산, 신맛(이 있는), 신, 신랄한, 부루퉁한
acidfast : a, 항산성의, 산에 퇴색하지 않는
acidhead : n, LSD 상용자
acidic : a, 산을 내는(만드는), 산성의, (태도, 말, 성질이) 까다로운, 신랄한, 가혹한
acidification : n, 산성화, 산패
acidify : vt, vi, 시게하다, 시어지다, 산(성)화하다
acidity : n, 산성, 신맛
acidophile : a, (미생물이)호산성인
acidophilus milk : x, 유산균우유
acidosis : n, 산성증
acid test : n, 산시험, 엄밀한시험
acid trip : x, LSD에의한 환각체험
acidulate : vt, 신맛이 나게 하다
acidulated : a, 신맛이 나는, 성미가 까다로운
acidulous : a, ad, 다소 신맛이 있는, 찌무룩한, 심술궂은. ...ly
acidy : a, 산성의, 신
aciform : a, 침상의, 끝이 뾰족한
acinous : a, 입상과의, 소핵과의, 포도상선의, 선포의
acinus : n, 입상과, 소핵과, 소핵, 작은 씨, 포도상선, 선방
acious : suf, ...의 경향이 있는, ...을 좋아하는
acity : suf, aciou로 끝나는 형용사에 대응하는 명사를 만듦
ack. : vt, =acknowledge;acknowledg(e)-ment인정하다
ackack : n, 고사포(의 포화), 비행기수리공
ackemma : n, 오전(에), 비행기 수리공 
ackgt : x, acknowledg(e)ment
acknowledge : vt, a, 인정하다, 승인하다, 감사하다, (편지 따위의)받았음을 알리다
acknowledged : a, 일반적으로 인정된, 정평있는
acknowledgement : n, 승인, 받았다는 통지(증명), 영수증, 사례
aclinic : a, 무경각의, 무복의
aclutter : a, 어지러이 흩어진, 몹시 혼란한
acme : n, 절정, 극치(climax)
acne : n, 여드름
acock : pred, a, (모자의)챙을 세워서
acolyte : n, 조수, 카톨릭의 옷담당
aconcagua : n, 아콩가과(남미 Andes 산맥 중의 최고봉)
aconite : n, 바곳, 아코나이드(뿌리에서 체취한 진통제)
aconitic : a, 
aconitine : n, 아코니틴(바곳속의 식물에서 빼내는 유독 물질, 진통제)
acopic : a, 피로회복의
acorn : n, 도토리, 상수리
acorn shell : n, 도토리껍질, 굴껍질
acorn tube : x, 에어콘관(도토리모양의 작은 진공관)
acorn worm : n, 주둥이가 도토리 모양이며 벌레 비슷한 바다 동물 (척색동물)
acotyledon : n, 무자엽식물
acoumeter : n, 청력계
acoustic : a, 청각의, 보청의, 음향학의
acoustical : a, ad, =ACOUSTIC, ~ly
acoustical cloud : n, 음향반사판(뮤직홀 따위의 음향 효과를 높이기위한 장치)
acoustical guitar : n, 보통기타(전기 기타가 아닌)
acoustical mine : n, 음향기뢰(배위 엔진 따위의 소리로 폭팔함)
acoustician : n, 음향학자
acousticon : n, 보청기(원래는 상표명)
acoustic phonetics : x, 음향음성학
acoustics : n, (홀 등의)음향효과
acoustics : n, pl, 음향학, 음향 상태
acoustoelectronics : n, (단수 취급)음향 전자 공학
acquaint : vt, 알리다, 숙지시키다, be(get)~ed with~을 알고 있다(알게 되다), ~ed(-id)아는, 정통한
acquaintance : n, 아는 사람(사이), 알고 있음, 면식, 지식, 숙지
acquisition : n, 취득, 획득, 취득물, 획득물
acquisitive : a, ad, 습득성이 있는, 얻고싶어하는, 욕심많은, -ly
acquit : vt, n, 석방하다, 방면하다, 면제하다, 다하다, 석방번, 변제, 수행, -tance 변제, 영주증
acquittal : n, 무죄 방면, 석방, 책임 해제, 변제(부채의)
acquittance : n, (채무의)면제, 소멸, 책임 해제, 채무 소멸증서, 영수증
acrawl : ad, a, 우글거려, 들끓어, 득실거려
acre : n, 에이커, 토지, 경작지
acreage : n, 에이커 수, 평수, 면적, (넓은)토지
acred : a, 토지의, 토지를 소유하는, ...에이커 되는
acrefoot : n, 에이커풋트(에이커를 1피트깊이로 체우는 수량)
acreinch : n, 에이커 인치
acrid : a, 매운, 쓴, (코를) 톡 쏘는(피부에) 스미는, 짓궂은, 신랄한
acridine : n, 아크리딘, 물감, 의약품 원료
acriflavine : n, 아크라플라빈, 방부소독약
Acrilan : n, 아크릴란
acrimonious : a, 매서운, 말과 태도가 격렬한, 신랄한
acrimony : n, (태도, 말 등의)호됨, 신랄함, 독살스러움
acro : x, 최고의, 끝의, 뾰족한의 뜻의 결합사
acrobat : n, 곡예사, 기회주의자, 편의주의자
acrobatic : n, 곡예
acrobatics : n, 곡예
acrobatism : n, =ACROBATICS
acrogen : n, 식물, 고사리이끼류
acrogenous : a, 정생의
acrolect : n, (어떤 사회, 집단의) 가장 유력한 방언
acrolein : n, 아크롤레인, 최류가스원료
acrolith : n, (옛 그리스의) 머리, 손, 발은 돌이고 몸은 나무로 된 상
acromegalic : a, n, 선단 비대증의 (사람)
acromegaly : n, 말단거대증
acronical : a, (별 등이) 일몰에 나타나는(일어나는), 저녁의(별의 출몰에 관해서 말함)
acronym : n, 두문자어, 머리 글자만 모아 만든 말
acronymize : vt, 머릿글자로 나타내다
acronymous : a, 머릿글자의
acrophobe : n, 고소 공포증인 사람
acrophobia : n, 고소 공포증
acrophony : n, 두음서법
acropolis : n, 아크로폴리스, 고대 그리스 도시의 성채, 아테네의 성채
acrosin : n, 아크로신(정자의 첨체에 있는 효소)
across : ad, prep, 가로질러, 건너서, 저쪽에, 엇갈리어, 교차되어, 지름으로
acrosstheboard : a, 전면적인
acrossthetable : a, (정면으로) 맞대놓고 하는, 직접적인 (협의)
acrostic : a, n, 각주에서 처음과 끝을 맞추면 어구가 되는 시
acroterion : n, 조상대
acrotheater : n, 곡예(연극)
acrotism : n, 무맥증, 약맥, 정맥
acryl : n, 아크릴
acrylamide : n, 아크릴아미드(플라스틱, 접착제 원료)
acrylic : a, 아크릴의
acrylic acid : n, 아크릴산
acrylic fiber : n, 아크릴섬유
acrylic resin : n, 아크릴수지
acrylonitrile : n, 아크로릴로니트릴, 합성고무섬유의 원료
act : n, 행위, 행동, 극의 막, 결의, 행동하다, 연기하다, 작용하다
actable : a, (희곡, 배역, 장면 등이) 상연하기에 알맞은, 상연할 수 있는, 실행할 수 있는
actin : n, 악틴, 단백질의 일종
acting : a, n, 대리의
actinia : n, 말미잘
actinic : a, 화학선의
actinide series : n, 악티니드 계열, 방사선원소
actiniform : a, 방사형의
actinism : n, 화학선작용
actinium : n, 악티늄, 방사선원소
actinoid : a, 방사선 모양의(성게, 불가사리 등의)
actinolite : n, 각섬석의 일종(녹색의 결정체)
actinometer : n, 광량계, 노출계
actinometry : n, 광량(일사량)측정, 방사 에너지 측정(학)
actinomyces : n, (악티노미세스속의)방선균
actinomycete : n, 방사산균
actinomycin : n, 악토노마이신, 항생물질
actinomycosis : n, 악티노미세스증, 방선균증
actinon : n, 악티논
actinotherapy : n, 방사선치료
actinouranium : n, 악티노우라늄(우라늄의 방사성 동위 원소의 하나)
actinozoan : n, 화형충류
action : n, 활동, 작용, 행동, 행위, 동작, 작용, 소송, 전투, 소설의 줄거리 전개
actionist : n, 행동파의 정치가(사람)
actionless : a, 움직임이 없는
activate : vt, 활동적으로      하다, 동원하다, 활성화하다, 방사능을  부여하다, 하수를 정화하다
activated : a, 활성화된
activation : n, 활동적으로 하기, 활성화, 부대 신설(편성)
activator : n, 활동적이 되게 하는 사람, 활성물, 활성제, 활성체
active : a, 활동적인, 적극적인, 힘센, 능동의
actively : ad, 활발히, 활동적으로, 적극적으로, 능동으로
activism : n, 행동주의, 적극적인 행동주의
activist : n, (정치적)활동가, 행동주의자, 행동 대원
activity : n, 활동, 활약, 활기, 활황, 능동성, 활동범위
activize : vt, =ACTIVATE
acton : n, 갑옷 밑에 입는 홑옷
actor : n, 배위, 행위자
actress : n, 여배우
actual : a, 현실의, 실제의, 현재의
actualist : n, 현실주의자
actualite : n, 현대적(시사적)흥미, 시사(적 화제), 뉴스
actuality : n, 현실, 현장, 실태
actualization : n, 현실화, 실현
actualize : vt, 실현하다
actually : ad, 실지로, 참으로(설마 하겠지만)
actuarial : a, 보험 통계의, 보험 수리사의
actuary : n, 보험 계리사
actuary : n, 보험계리사
actuate : vt, 움직이다, 남을 자극하여 시키다
actuation : n, 발동(충동)작용
actuator : n, 작동시키는 것, 작동기(장치), 발동자(물)
acuity : n, 예민, 격렬, 신랄
aculeate : a, 끝이 뾰족한, 예리한, 가시가 있는, 침이 잇는, 날카로운, 신랄한
aculeus : n, (식물의)가시, (동물의)침, 독침
acumen : n, 혜안, 명민
acuminate : a, (잎 등이)뾰족한, 날카로운
acuminous : a, 예민한, (잎 등이) 뾰족한
acunation : n, 화폐 주조
acupressure : n, 지압
acupuncture : n, 침술, 침 치료
acushla : n, (아일)=DARLING
acute : a, 날카로운, 뾰족한, 예민한, 빈틈없는, 격렬한, 급성의
acutecare : a, 급성병(급성 환자) 치료의
acyclice : a, 비순환식의
AD : x, 서력
ad : n, 광고
adage : n, 격언, 속담
ad agency : n, 광고 대행소
ad agent : n, 광고 대행업자
adagio : ad, a, n, 느리게, 느린, 아다지오장
adaline : n, 아달린(최면제)
Adam : n, 아담
adamancy : n, 견고 (무비), 확고, 불굴, 완고
adamant : a, n, 대단히 단단한, 의지가 견고한
adamantine : a, 금강석 같은, 견고 무비한, 철석같은, 불굴의
Adamism : n, 노출증
Adamite : n, 아담의 자손, 나체주의
adamsite : n, 애덤자이트
adapt : vt, 적응시키다, 개작하다, 수정하다
adaptability : n, 적응성, 순응성, 융통성
adaptable : a, (동식물이)적응할 수 있는, (사람, 기질이) 순응성 있는, 융통성 있는, 개조할 수 있는, 개작
adaptation : n, 적응, 개작, 각색
adapter : n, 각색자, 가감장치, 어댑터
adaption : n, 가감장치
adaptive : a, 적합한, 적응한, 적합할 수 있는
adaptometer : n, 명암 순응 측정기, 순응계
adaptor : n, 각색자, 가감장치
Adar : n, (유대력의) 12월(태양력의 2-3월)
adazzle : ad, 눈부시게, 휘황찬란하여
adcraft : n, 광고 취급업자
add : vt, vi, 더하다, 더해지다, 늘다, 가산하다
addax : n, 큰 영양(북아프리카, 아라비아 산)
addedvalue : x, =value added tax
addend : n, 가수
addendum : n, 보유, 추가
adder : n, 살무사의 무리, 덧셈하는 사람 
adderstongue : n, 나도고사리삼속의 일종
addible : a, 더할 수 있는
addict : vt, 탐닉하게 하다, 빠지게하다
addicted : ad, (마약 등을)사용하여, (...에)중독 되어, 빠져, 탐닉하여, 열중(몰두)하여
addiction : n, 탐닉, (마약 등의) 중독, 열중, 몰두
addictive : a, (약제 등이) 습관이 되는, 습관성(중독성)의
addie : n, 여자 이름
addio : int, 안녕히 가시오
Addison : n, 에디슨
Addisonian : a, 에디슨류의
additament : n, 부가(첨가)물
addition : n, 부가, 증가, 가산, 부가물, 증축
additive : a, 부가적인, 첨가의
addle : a, 썩은, 혼탁한
addle brained : a, 우둔한
addlepated : a, 머리가 혼돈된, 우둔한(stupid)
addon : n, 추가물, 부가장치
address : n, 인사, 연설, 제언, 청원, 수신인 이름, 주소, 구혼
addressable : a, 어드레스로 불러낼 수 있는
addressee : n, 수신인
addressing : n, 어드레싱, 어드레스 지정
Addressograph : n, =ADDRESSING MACHINE(상표명)
adduce : vt, 인용하다, 증거로서 들다
adducent : a, 내전의
adducible : a, 인증(인용)할 수 있는, 예증으로 들 수 있는
adduct : vt, 내전시키다
adductive : a, 내전하는, 내전의
adductor : n, 내전근
addup : n, 결론, 요점
Adelaide : n, 여자 이름, 애들레이드
ademption : n, 유증의 철회(취소)
Aden : n, 아덴
Adenauer : n, 아데나워(서독의수상)
adenectomy : n, 선 절제(술)
adenine : n, 아데닌
adenitis : n, 선염
adenocarcinoma : n, 선암, (의학용어)
adenoid : a, pl, n, 아데노이드의, 선증식 비대(의)
adenoidal : n, =ADENOID
adenoidectomy : n, 아데노이드 절제술
adenoiditis : n, 두 편도염, 아데노이드 인두염
adenoma : n, 선종
adenose : a, 선의, 선 모양의
adenosine : n, 아데노신, 리보핵산의 효소분해에 의하여 얻어짐
adenovirus : n, 아데노비루스
adental : a, n, 우연의, 우발적인, 임시 기호
adenyl : n, 아데닐(아데닌에서 유도되는 1가의 기)
adept : n, 숙련자
adequacy : n, 적당함, 타당
adequate : a, 적당한, 충분한
adfat : a, 광고를 잔뜩 게재한
adfreeze : vt, 어는힘으로 고정(고착)시키다
ADH : n, antidiuretic hormone, 항이뇨 호르몬
adhere : vi, 들러붙다, 신념을 굳게 지키다, 집착하다
adherence : n, 고수, 집착, 충실, 지지(=ADHESION 1)
adherent : a, 들러붙는, 집착하는 붙어 떨어지지 않는
adhesion : n, 집착, 점착, 유작
adhesive : a, 점착성의, 끈끈한, 잘 들러붙는
adhibit : vt, (사람, 물건을)들이다, 넣다, 붙이다, (약, 요법등을)쓰다
adhoc : a, 특별한
adhocery : x, 임기응변의 정책
adhocracy : n, 특별위원회(중심의 정치(기구)
ADI : n, acceptable daily intake, (유해물질의)1일 허용 섭취량
adiabatic : a, 단열의
adiantum : n, 공작 고사리속(maidenhair)
adieu : int, n, 안녕, 이별
adios : n, int, 이별, 안녕
adipocere : n, 사체의 지방
adipose : n, a, 지방, 지방의
adiposity : n, 지방과다, 비만
Adirondack : n, 아디론댁족, 아디론댁족의 사람
adit : n, 입구, 횡갱
aditorial : n, 논설 광고
ADIZ : n, Air Defense Identification Zone
adjacency : n, 인접, 이웃, 인접물, 인접지
adjacent : a, 부근의, 인접하는
adject : vt, 더하다, 덧붙이다, 부가하다
adjectival : a, n, 형용사의(적인), 형용사가 많은, 형용사적 어구
adjective : n, 형용사
adjoin : vi, vt, 인접하다, 서로 이웃하다
adjoining : a, 인접하는, 이웃의, 부근의
adjourn : vt, vi, 연기하다, 회를 휴지하다, 휴회하다
adjudge : vt, 판결하다, 심판하다, 심판하여 상을 주다, 교부하다
adjudgement : n, 판결, 선고, 심판, 판정, (심사한 뒤의)수여, 수상
adjudicate : vt, 판결하다, 재정하다
adjudication : n, 판결, 재결, 선고, 파산선고
adjudicative : a, 판결의
adjunct : n, 부가물, 부가사
adjunction : n, 부가, 부속, 첨가
adjunctive : a, 부속의
adjuration : n, 서원, 간청, 엄명
adjuratory : a, 엄명의, 간청의
adjure : vt, 엄명하다, 탄원하다
adjust : vt, 맞추다, 조정하다, 화해시키다
adjustable : a, 조정(조절, 순응)할 수 있는
adjuster : n, 조정자, 조절기, 손해 사정인
adjustment : n, 조정, 조절, 수정, 정산, (쟁의 등의)조정
adjutage : n, (분수 등의)방수관
adjutant : a, 보조의
adjuvant : a, n, 보조의, 조수, 보좌역
adland : n, 광고업계
adless : a, 광고 없는, (잡지 따위)
adlib : vt, vi, 즉흥적으로 노래하다
adlibitum : x, 마음대로, (악기)
ADM : n, 공중발사유인미사일, air launched decoy missile
adman : n, 광고업자, 광고문안 제작자
admass : n, 매스컴에 좌우되기 쉬운 일반대중
admeasure : vt, 할당하다, 달다, 재다, 계량하다
Admetus : n, 아드메토스
admin : n, =ADMINSTRATION
adminicle : n, 보조(aid), 보조자(물), 보강 증거, 부증
adminicular : vt, (업무 등을)관리하다, (국가, 회사, 가정 등을)다스리다, 통치하다
administer : vt, 관리하다, 처리하다, 시행하다, 타격을 주다, 치료를 하다
administerial : a, =ADMINISTRATIVE
administrable : a, 관리(집행)할 수 있는
administrant : a, n, 관리하는(사람)
administrate : vt, 관리하다, 지배하다
administration : n, 관리, 경영, 행정, 관료의 임기, 줌, 시행
administrative : a, 관리상의, 행정상의, 경영상의
administrator : n, 관리인, 행정관
administratrix : n, 여자 관리인, 여자 관재인
admirable : a, 훌륭한
admiral : n, 해군 대장, 제독, 해군 장성 사령관
admiralship : n, 해군 대장(장성)의 직(지위)
admiralty : n, 해군대장의 직, 해사재판소
admiration : n, 감탄, 칭찬, 찬미, 경탄
admire : vt, vi, 감탄하다, 찬미하다, 칭찬하다, 기뻐하다, 좋아하다
admirer : n, 찬양자, 팬, (여성의)환심을 사려는 남자, (여성에 대한)숭배자, 구혼자
admiring : a, ad, 감탄하는, 찬양하는, ~ly 감탄하여
admissibility : n, 허용됨, 허용(성)
admissible : a, 용인될 수 있는, 취임할 자격이 있는
admission : n, 입장, 입학이나 입회 허가, 입장료, 승인, 자인, 고백
admissive : a, 허용의, 입장허가의
admit : vt, 인정하다, 승인하다, 허락하다, 들이다, 입장을 허용하다, 수용할 수 있다
admittable : a, 용인할 수 있는, 허용할 수 있는, 들어갈 자격이 있는
admittance : n, 입장, 입장권
admitted : a, 공인된
admittedly : ad, (보통 문장전체를 수식하여)일반적으로 인정하듯이, 자기가 인정하는 바와 같이, 틀림없이, 확실히
admix : vt, 혼합하다, 섞다
admixture : n, 혼합
admonish : vt, 훈계하다, 타이르다, 깨우치다, 충고하다
admonition : n, 훈계, 타이름, 충고
admonitor : n, 경고(충고)하는 사람
admonitory : a, 설유하는, 권고하는, 경고하는
adnate : a, 착생한
adnexa : n, 부속기, 자궁 부속기
adnominal : ad, 연체인, 관형사적인
adnoun : n, 명사적 용법의 형용사
ado : n, 법석, 소동
adobe : a, 햇볕에 말려 만든 찰흙, 멕시코벽돌(로지은)
adolesce : vt, 청년(청춘)기에 이르다, 청년기를 지내다, 청년기의 사람답게 행동하다
adolescence : n, 청년기, 청춘, 남자14~25세, 여자12~21세
adolescent : a, 청년기의, 청춘의, 한창 젊은, 미숙한, 불안정한
Adolf : n, 남자 이름
Adolphus : n, 남자 이름
Adonai : n, 상제, 주(헤브루 사람이 하느님을 완곡하게 부른 말)
Adonis : n, 미소년, 비너스가 사랑한 소년
adonize : vt, 멋부리다, 모양내다, 미남인 체하다, (남자가)멋부리다, 모양내다
adopt : vt, 채택하다, 채용하다, 양자로 삼다
adoptable : a, 양자로 삼을 수 있는, 채택할 수 있는
adopted : a, 양자가 된, 채택된
adoptee : n, 양자, 채용(채택)된 사람(것)
adopter : n, 채용(채택)자, 양부모
adoption : n, 양자 결연, 채택, 채용
adoptionism : n, 양자론(예수는 본래 보통 인간이었으나 성령으로 신의 아들이 됐다는 주장)
adoptive : a 채용(채택)하는, 양자 관계의
adorable : a 숭배할 만한, 귀여운
adoration : n, 숭배, 경모, 애모, 동경
adore : vt, 숭배하다, 무척 좋아하다
adorer : n, 숭배자, 열렬하게 애모하는 사람
adoring : a, 숭배(경모)하는, 경배할 만한, 홀딱 반한
adorn : vt, 꾸미다, 미관을 더하다
adornment : n, 꾸미기, 장식, 장식품
adown : ad, 밑으로, (時語)
adperson : n, 광고인, 광고계의 사람(카피라이터, 광고 대행사 직원)
ad rate : n, 광고료, 
adrenal : a, n, 신장에 가까운, 부신의
adrenalin : n, 아드레날린
adrenalize : vt, 흥분시키다, 자극하다(excite)
adrenocortical : a, 부신 피질의, 부신 피질로부터의
adrenocorticotrophic hormone : x, 부산피질자극 호르몬
adriamycin : n, 아드리아마이신
Adrian : n, 남자이름
Adriatic : a, n, 아드리아해의, 아드리아 해
adrift : ad, a, 표류하여, 떠돌아, 헤매어, 일정한 직업 없이, 어찌할 바를  몰라
adroit : a, 교묘한
adscititious : a, 외부로부터의, 본래적이 아닌, 부가적인
adscript : a, 뒤(후)에 쓴, 오른쪽에 쓴, (농노가) 토지에 부속된
adscription : n, =ASCRIPTION
adsmith : n, 광고문안작성자
adsorb : vt, 흡착시키다
adsorbate : n, 흡착된 것, 흡착질
adsorbent : a, 흡착성의
adsorption : n, 흡착(작용)
adsorptive : a, 흡착(작용)의, 흡착성의
adsum : int, 네(호명에 대한 대답)
Adulamite : n, 어덜럼 당원, 탈당파 의원
adulate : vt, 아첨하다
adulation : n, 추종, 아첨, 알랑거림
adulatory : a, 아첨하는, 추종하는, 알랑거리는
adult : n, a, 성인, 성인의, 어른, 어른의
adult education : x, 성인교육
adulterant : n, a, 혼합물의, 섞음질에 쓰는
adulterate : vt, 섞음질하다, 질을 떨어뜨리다
adulterated : a, 섞음질을 한, 순도(제조법, 상표 표시)가 법정 기준에 반지 않는, 불순한
adulteration : n, 섞음질, 불순물, 저질품
adulterator : n, 불순품(저질품), 제조자, 통화위조자
adulterer : n, 샛서방, 간부
adulteress : n, 간
adulterine : a, 불순한, 가짜의, 간통의, 간통으로 태어난, 부정한, 불법의
adulterous : a, 간통의, 섞음질한, 불순한, 가짜의
adultery : n, 간통, 간음
adulthood : n, 성인(어른)임, 성인기
adultify : vt, (어린이를)성인같이 만들다, 성인화하다
adultrated : a, 어른(성인)용의
adumbral : a, 그늘진, 그늘
adumbrate : vt, 예시하다, 어렴풋이 보인다, 그늘지게 하다
adust : a, 바싹 마른, 해에 그을린, 우울한
advance : vt, 나아가게 하다, 승진시키다, 값을 올리다, 의견을 내다 선불하다
advanced : a, 진보한, 고등의, 진보적인
advancement : n, 진보, 발달, 증진, 촉진, 전진, 승진, 출세
advantage : n, 이익, 편의, 유리, 이점, 강점
advantaged : a, (태생, 환경등에서)유리한, 혜택받은 (아이 등)
advantageous : a, 유리한, 형편이 좋은
advect : vt, 이류시키다, (수증기를)이류로 수송하다
advection : n, 이류, 대기의 수평이동
advent : n, 출현, 예수의 강림
Adventism : n, 그리스도 재림설
Adventist : a, 그리스도 재림론자(=Second ~ )
adventitious : a, 우발의, 이례의 장소에서 발생하는
adventive : a, 외래종의
adventure : n, 모험, 흔치않은 체험
adventurer : n, 모험가, 누기가
adventuress : n, ADVENTURER의 여성형
adventurism : n, 모험주의
adventurous : a, 모험적인, 모험을 즐기는
adventurous : a, 모험을 좋아하는, 대담한, 모험적인, 새로운 요소(신선미)가 있는
adverb : n, 부사
adverbial : a, 부사의, 부사적인
adverbially : ad, 부사적으로, 부사로서
adversaria : n, (단수, 복수취급)주해, 주석, 각서, 메모, 비망록, 발췌(본)
adversarial : a, 반대자의, 반대하는, 당사자주의의
adversary : n, 적, (경기 따위의) 상대방
adversative : a, 반대의
adverse : a, 역의, 거꾸로의, 반대의, 적의가 있는, 불리한
adversely : ad, 거꾸로, 반대로, 불리하게, 불운하게
adversity : n, 역경, 불행한 일
advert : vt, (...에)주의를 돌리다(to), (...에)언급하다(to)
advert : n, 광고
advertence : n, 주의, 언급
advertent : a, 주의 깊은
advertise : vt, vi, 광고하다, 공고하다
advertisement : n, 광고, 통고
advertiser : n, 광고자(주), 신문
advertiser : n, 광고자
advertisering agency : x, 광고대리업
advertising : n, 광고업
advertising man : x, 광고 담당자(업자)
advertorial : n, 기사형식을 취한광고
advice : n, 충고, 조언, 의견, 보고, 통지, 안내(a eltter of ~통지서)
advisability : n, 권할 만함, 타당함, (방책의)적부
advisable : a, 권할 만한, 적당한, 현명한, 분별 있는
advisably : ad, (보통 문장 전체를 수식하여)타당하여, 현명하게
advise : vt, 충고하다, 조언하다, 알리다
advised : a, 숙고한, 신중한(deliberate), 무분별한
advisedly : ad, 숙고를 거듭한 끝에, 고의로
adviser : n, 조언자, 상담역, 고문
advisory : a, 충고의, 고문의(~committee자문 위원회)
advocacy : n, 변호, 주장, 지지
advocate : n, vt, 변호인, 주장자, 옹호자-변호하다, 주장하다
advocator : n, 주창(창도)자
adwriter : n, 광고문안작성업자
adynamia : n, 쇠약
adynamic : n, 근 무력증
adytum : n, (고대 신전의) 지성소, 사실, 밀실
adz : n, vt, 까뀌, 까뀌로 깍다
Aeacus : n, 아이아코스(Zeus의 아들, 저승 Hades의 재판관이 됨)
aedes : n, (황열병을 매개하는)각다귀의 일종
aedile : n, 조영관, 옛로마의
aeffect : a, 이화 효과(alienation effect)
Aegean : a, n, 에게해의 다도해의, 에게해, 다도해(그리스와 터키사이의 바다)
Aegean sea : x, 에게해, 다도해
aeger : n, 진단서
Aegir : n, 아에기르(항해와 고기잡이를 방해하는 바다의 신)
aegis : n, 제우스의 방패, 보호, 옹호
Aegisthus : n, 아이기스트스(Agamemnon의 아내를 유혹하고, 귀환한 그를 살해, 나중에 그의 아들 Orestes에게 살해됨)
aegrotat : n, 질병 진단서(수험 불능을 증명하는)
AEIS : x, aeronautical en-route information service
Aeneas : n, 트로이의 용사
Aeneid : n, Aeneas의 유량을 읊은 서사시
aeneous : a, 청동색의 (곤충)
Aeolian : a, 바람에의한
Aeolic : a, Aeolis 지방(사람)의
aeolipile : n, (기원전 2세기에 발명된 증기력에 의한)회전 장치
Aeolis : n, 아이올리스(소아시아 북서 안의 고대 그리스 식민지)
Aeolisn harp : x, 풍명금
Aeolus : n, 바람의 신
aeon : n, 영겁
aepyornis : n, 융조(타조비슷한 거대한 새, 지금은 명종)
aerate : vt, 공기에 쐬다, 탄산가스를 넣다
aerated : a, 공기의, 공기 같은, 희박한
aeration : n, 통기 통풍, 탄산가스 넣기
aerator : n, 통풍기, 탄산수제조기, (밀 등의)훈증 살충기
aerial : a, n, 공중의, 항공의, 기체의, 희박한, 공상적인, 공중에 치솟은, 공중에 생기는-안테나(공중 그네)곡예사
aerial bomb : x, 투하 폭탄
aerial current : x, 기류
aerialist : n, 공중 곡예사
aeriality : n, 공기 비슷한 성질, 공허
aerial ladder : x, (소방용)접사닥다리
aerial mine : x, 공중 폭뢰
aerial photography : x, 항공 사진(술)
aerial plant : x, 기생식물
aerial railroad : x, (railway)가공 철도, 삭도
aerial root : x, 기근
aerial torpedo : x, 공중 어뢰)
aerial tramway : x, 공중 케이블, 삭도
aerie : n, 보금자리, 높은 곳에 있는집
aerification : n, 공기와의 화합, 기체화, 기화
aeriform : a, 기체의, 공기상의, 무형의, 실체 없는
aerify : vt, 기화하다, 공기와 혼합시키다, 공기에 쐬다
aero : a, 항공기의
aeroallergen : n, 공기 알레르겐(알레르기를 일으키는 대기중의 물질)
aeroballistics : n, 항공탄도학
aerobatic : a, 고등 비행의, 공중 곡예의
aerobatics : n, 곡예비행, 곡예비행술
aerobe : n, 호기성미생물
aerobee : n, 에어로비형로켓(과학 조사 계기류를 탑재)
aerobic : a, n, (세균등이)호균성의, 호기성 (세)균류
aerobics : n, 에어로빅(운동으로 체내의 산소 소비량을 늘리는 건강법)
aerobiology : n, 공중 생물학
aeroboat : n, 수상비행기, 비행정
aerobus : n, 합승비행기
aerocade : n, 비행기편대
aerocamera : n, 비행기용사진기
aerocar : n, =HOVERCRAFT
aerocycle : n, 소형헬리콥터
aerodonetics : n, (글라이더를)활공역학, 비행안전역학
aerodraft : n, =AIRCRAFT
aerodrome : n, 비행장
aero dynamicist : n, 공기 역학자
aerodynamics : n, 기체동역학, 공기역학
aerodyne : n, 중항공기(기구, 비행선 따위에 대해서)
aeroembolism : n, 항공색전증
aeroengine : n, 항공발동기
Aeroflot : n, 에어로플롯(소련 국영 항공사)
aerofoil : n, =AIRFOIL
aerogenerator : n, 풍력 발전기
aerograme : n, 항공서한, 무선전보
aerograph : n, (고층의 기온, 기압, 습도 등의)자동기록기
aerographer : n, 항공 기상 관측병
aerography : n, 기술 기상학, 대기지
aerohydroplane : n, 수상비행기
aerolite : n, 운석
aerology : n, 고층 기상학
aeromagnetic : a, 공중자기의
aeromarine : a, 해양비행의
aeromechanics : n, 항공역학
aeromedicine : n, 항공의학
aerometeorograph : n, 항공자기기상계
aerometer : n, 기량계, 기체계
aerometry : n, 기체측정, 양기학
aeromodeller : n, 항공 모형 제작자
aeromotor : n, 항공기용 발동기
aeronaut : n, 비행선, 경기구, 조종사
aeronautic : a, 비행기술의, 항공의
aeronautical : a, 항공학의, 항공술의
aeronautics : n, (단수취급)항공술, 항공학
aeroneurosis : n, 항공신경증
aeronomy : n, 초고층대기물리학
aerootitis media : n, 항공중이염
aeropause : n, 대기계면(지상 약20-23km간의 공기층)
aerophobe : n, 비행 공포증자
aerophone : n, 접근탐지청음기
aerophore : n, 인공 호흡기, (탄갱 등에외)송풍기
aerophoto : n, 항공사진
aerophotography : n, 항공사진술
aerophyte : n, 기생(착생)식물
aeroplane : n, 비행기
aeroplankton : n, 공중 부유 생물
aeropohobia : n, 공기증
aeropolitics : n, 항공정책
aeroscope : n, 대기검사기(대기 중의 극미한 물질을 수집하는 장치)
aerosol : n, 연무질, 에어러솔
aerospace : n, a, 대기권과 우주, 항공우주
aerosphere : n, 대기권, 
aerostat : n, 기구, 비행선
aerostatic : a, 기체 정역학의, 항공술의, 경항공기의
aerostatics : n, 기체 정역학, 기구 항공학
aerostation : n, 경항공기 조종법
aerotherapeutics : n, (단수 취급)대기(공기) 요법(학)
aerotherapy : n, =AEROTHERAPEUTICS
aerothermodynamics : n, 공기 열역학
aerotitis : n, 공기염(공기압의 변화에 의한 귀의 염증)
aerotrain : n, 에어러트레인(프랑스에서 개발한 공기 분사로 부상하는 고속 열차)
aertex : n, 에어텍스(셔츠, 내의용의 성긴 직물, 상표명)
aeruginous : a, 녹청의, 청록색의
aerugo : n, 녹, (특히)녹청
Aeschylus : n, 그리스의 비극 시인
Aesculapian : a, 의술의 신 Aesculapius의, 의술의
Aesculapius : n, 의료의 신
Aesir : n, 아사신족(Asgard에 살았던 신들)
Aesop : n, 이솝, 고대 그리스의 우화작가
Aesopian : a, 이솝(식)의, 이솝 이야기 같은, 우의적인
aesthete : n, 미각자, 탐미주의자, 탐미가
aesthetic : a, 미의, 미술의, 심미적인, 미를 아는
aesthetic distance : x, 미적 거리
aesthetician : n, 미학자
aestheticism : n, 유미주의, 탐미주의, 예술지상주의
aesthetics : n, (단수취급)미학, 미적 정서의 연구
aesthophysiology : n, =ESTHESIOPHYSIOLOGY
aestival : a, 여름(철)의, 하계의
aestivate : vt, 여름을 지내다, 피서하다, 여름잠을 자다
aestivation : n, 피서, 여름잠
aetatis : a, (나이가)살의
aether : n, vt, =ETHER
aetherial : a, =ETHERIAL
aetiologic : a, =ETIOLOGIC
aetiology : n, ETIOLOGY
Aetna : n, =ETNA
afar : ad, 멀리, 아득히(`off 멀리 떨어져서, 원방에, from~멀리서, 원방에서
afeared : a, 두려워하여
afebrile : a, 열 없는, 무열(성)의
aff : x, affirmative, affirming
affability : a, 상냥한, 붙임성 있는, 사근사근한, 정중한
affable : a, 상냥한, 붙임성 있는, 부드러운
affair : n, 일, 사건, 사무, 일, 물건, 물품, 하기
affaire de coeur : x, 정사 로맨스(love affair)
affect : vt, 영향하다, 작용하다, 감동시키다, 침범하다, 좋아하다, 체 하다
affectation : n, 체함, 짐짓 꾸밈
affected : a, 영향을 받은, 침범된, ...체하는, 짐짓 꾸민, 젠체하는
affecting : a, 감동시키는, 감동적인, 가련한, 애처로운
affection : n, 애정, 감정, 영향, 병, 성질, 특성
affectionate : a, 애정 있는, 깊이 사랑하고 있는
affectionately : a, 애정을 다하여, 자애로운, 상냥한, (말, 편지 등)애정어린, 친애하는
affective : a, 감정의, 감정적인
affectless : a, 감동 없는, 무정한, 냉혹한
affenpinscher : n, 아펜핀셔(털이 복슬복슬한 애완용 작은 개)
afferent : a, (기관, 현관, 신경으로)인도 되는
affettuoso : ad, 감정을 담아
affiance : n, 신뢰, 약혼
affianced : a, 약혼한
affiant : n, 선서, 진술인
affidavit : n, 선서, 진술서
affiliate : vt, 가입시키다, 관계시키다, 회원으로 하다, 합병하다, 양자로 삼다
affiliated : a, 가입(가맹)한, 제휴하고 있는, 계열의, 지부의
affiliation : n, 가입, 제휴, 친밀, 관계
affined : a, 연고가 있는, 일가의, 동맹한
affinitive : a, 밀접한 관계가 있는
affinity : n, 친척(관계), (타고난)취미, 기호(for), 유사, 친근성, 근연
affirm : vt, vi, 단언하다, 확언하다, 확인하다
affirmable : a, 확언(긍정)할 수 있는
affirmance : n, 단언, 확인
affirmant : n, AFFIRM하는 사람
affirmation : n, 단언, 긍
affirmative : a, n, 확정의, 긍정의, 긍정문, 찬성자
affirmatively : ad, 긍정적으로, 단언적으로
affirmatory : a, 단정적인, 긍정의(affirmative)
affix : vt, n, 첨부하다, 붙이다, 도장을 누르다, (책임, 비난, 따위를)씌우다-첨부불, 접미사, 접두사
affixation : n, 첨부, 부가, 덧붙임, 접사 첨가
affixture : n, 부가, 첨부, 부가(첨부)물
afflated : a, 영감을 받은, 신령에 감응한
afflatus : n, 시인의 영감
afflict : vt, 괴롭히다
afflicted : a, 괴로워하는, 고민하는
affliction : n, (심신의)고통, 괴로움, 고민거리, 불행의 원인
afflictive : a, 고통을 주는, 쓰라린
affluence : n, 풍부, 풍부한 공급, 부유
affluencet : n, 풍부, 풍부한 공급, 부유
affluent : a, 풍부(풍족)한, 부유한, 거침 없이 흐르는
affluenza : n, 부자명(막대한 상속 재산을 물려받은 여성이 걸리는 병)
afflux : n, 유입, 쇄도
afford : vt, 여유가 있다, 산출하다
affordable : a, 줄 수 있는, 입수 가능한, 알맞은 (가격)
afforest : vt, 식림하다
afforestation : n, 
affranchise : vt, 해방하다
affray : n, 싸움, 법석
affreight : vt, 화물선으로 용선하다
affricate : n, 파찰음
affright : vt, n, 무서워하게 하다, 놀래다, 공포, 놀람
affront : n, vt, 경멸, 모욕, 모욕하다, 직면하다, 반항하다
affusion : n, 주수, 세례의
Afghan : n, 아프카니스탄 사람
afghani : n, 아프가니(아프가니스탄의 화폐 단위)
Afghanistanism : n, 가까운 문제를 등한시하고 먼 나라의 문제에 역점을 둠
Afghistan : n, 아프카니스탄(인도 서북의 공화국)
aficionado : n, 열애자, 팬, 애호가
afield : ad, 들에, 들로, 벌판에, 싸움터에서, 집에서 떨어져, 상궤를 벗어나
afire : ad, a, 불타서
aflame : ad, (불)타올라
aflatoxin : n, 애플로톡신(곰팡이에서 생기는 발암물질)
afloat : ad, a, 떠서, 떠돌아, 해상에, 범람하여, 퍼져, 유통되어
aflutter : ad, a, 팔락이어
afond : ad, 철저하게
afoot : ad, a, 걸어서, 일어나서, 진행중에
afore : ad, 앞
aforementioned : a, 앞서 말한, 전술한
aforesaid : a, 전술한
aforethought : a, 미리 생각된, 계획적인
aforetime : ad, 이전에
afoul : ad, 충돌하여, 뒤엉키어
afraid : pred, a, 두려워하여, 근심하여
afresh : ad, 새로이, 다시 한 번
Afric : a, 아프리카
africa : n, 아프리카
Africana : n, pl, 아프리카에 관한 문헌, 아프리카지
Africander : n, =AFRIKANER, 남아프리카산의 육우
Africanist : n, 아프리카 언어 연구자, 아프리카 민족 해방주의자
Africanize : vt, 아프리카화 하다, 아프리카 흑인의 세력하에 두다
afrikaans : n, 남아프리카의 공용네덜란드 말
afrikander : n, 남아프리카 태생의 백인(네델란드계)
Afrikaner : n, 남아프리카 태생의 백인(특히 네덜란드계)
afro : a, (아메리카 니그로식의)아프로형 두발의
afro- : x, 아프리카뜻의 결합사
afroamerican : n, a, 아메리카인(의), 아메리카 흑인(의)
afroasian : a, 아시아 아프리카의
afroasiatic : n, 아시아 아프리카어족
Afrobeat : n, 하이라이프, 칼립소, 아메리카 재즈의 요소를 갖춘 음악
afroism : n, 아프리카 흑인주의
afrormosia : n, 아프로모지아(아프리카산의 가구 장식제)
aft : n, 고무쪽에, 후미에
after : ad, prep, conj, a, n, (...의)뒤에, ...하였으므로, ...하고나서, ...을 찾아서, ...에 따라서
afterages : n, pl, 후세
afterbirth : n, 후산(後産)
afterbrain : n, 후뇌(後腦)
afterburner : n, (제트엔진의)강력재연장치
afterburning : n, (제트엔진의)재연소(법)
aftercabin : n, 후부 선실
aftercare : n, 치료 후의 몸조리, 아프터케어
afterclap : n, 도짐, 후탈, 뜻밖의 재발
aftercrop : n, 그루갈이, 두모작
afterdamp : n, 잔류가스(갱내의 폭발(화재) 뒤에 발생하는 유독 가스)
afterdark : a, 해진 뒤의, 밤의
afterdeck : n, 후갑판
afterdinner : n, 식후의
aftereffect : n, 뒤에 남는 영향, 여파
afterfive : a, 애프터파이브의(저녁 5시 이후 모임 등에서 입는 옷의)
afterglow : n, 저녁놀, 회상
aftergrass : n, 두벌갈이
aftergrowth : n, 두번째나는것(곡물, 목초 등)
afterguard : n, 요트 소유주와 승객들, 후갑판원
afterheat : n, 여열(잔류방사능에서 나는)
afterhours : a, 영업시간후의, 폐점시간의(영업 등)
afterimage : n, 잔상
afterlife : n, 내세, 여생
afterlight : n, 때 늦은 생각
aftermarket : n, 수리용부품시장
aftermath : n, (농자물의)두번째 거둠, (사건 따위의)여파
aftermost : a, 최후미의
afternoon : n, a, 오후, 오후의, 석간
afternoons : ad, 오후에는 흔히(언제나)
afterpain : n, 산후 진통
afterpiece : n, (본 연극 뒤에 하는)익살맞은 촌극(寸劇)
afters : n, 디저트
aftersales : a, n, 판매 후의, ~ service 애프터 서비스
aftersensation : n, 잔류 감각(자극이 없어져도 남아 있는 감각)
aftershave : a, n, 면도 후의
aftershock : n, 여진
aftertaste : n, 뒷맛, 여운
aftertax : a, 세금공제의, 실수령의
afterthought : n, 늦은생각, 뒷궁리
aftertime : n, 금후, 장차, 앞날
afterwar : a, 전후의
afterward : ad, 뒤에, 나중에, 그 후
afterword : n, 발문(跋文)
afterworld : n, 후세, 내세
afteryears : n, 그후의 세월, 후년, 만년
again : ad, 다시, 또, 대답하여, 응하여, 반향하여, 만큼 반복하여, 그 위에, 또 한편
against : prep, 에 대해서, 을 향하여, 와 대조하여, 에 부딪쳐, 에 기대어, 에 대비하여
agama : n, 아가마도마뱀(아프리카, 인도산)
agamemnon : n, 미케네의 왕(트로이 전쟁의 지휘관)
agamogenesis : n, 무성 생식, 단위생식
agamospermy : n, (성결합 부전으로 인한)단성 생식
agamous : a, 무성의, 무성생식의, 은화의
agamy : n, (어느 집단에서)결혼이 없음
agapanthus : n, 아가판서스, 자주군자란
agape : ad, 입을 딱 벌리고, 아연하여
Agapemone : n, 사랑의 집(19세기 중엽 영국의 자유 연애주의자 집단), 자유연애자 집단
agaragar : n, 우뭇가사리, 한천
agaric : n, 버섯
agate : n, 마노, 튀김들
agateware : n, 마노 무늬의 도기(범랑 철기)
Agatha : n, 여자 이름
agave : n, 용설란
agaze : ad, a, 응시하며, 바라보고
age : n, 연령, 노년, 세대, 시대, 성년, 정년, 오랫동안
age bracket : x, 연령층
aged : a, 나이먹은, 오래된, 낡은, 삶의
agedate : vt, vi, (발굴물등의)연대를 과학적으로 결정하다
agedness : n, 늙음, 노인
agegrade : n, 같은 연령층
agegroup : n, 같은 연령층
agehardening : n, (합금의)시효 경화
ageing : n, =AGING
ageism : n, (노인에 대한) 연령차별
agelimit : x, 연령제한, 정년
agelong : a, 영속하는(everlasting)
agena : n, 어지너(우주 로켓의 상부의 단)
agency : n, 대리점, 대리권, 일, 작용, 매개, 주선, 기관, 청
agencyshop : x, 에이젼시 숍(미 가입자도 조합비를 무는 노동 조합 형태의 하나)
agenda : n, 회의사항, 의제
agendum : n, =agenda
agene : n, 염화질소(밀가루 표백에 쓰임)
agenesis : n, 발육(형성)부전, 음위, 불임
agenize : vt, (밀가루를) 삼염화 질소로 표백하다
agent : n, 대리인, 주선인, 행위자, 작인
agentgeneral : n, (런던 주재 캐나다, 오스트레일리아의)자치령(주) 대표
agential : a, 행위자의, 대리자(점)의
agentive : a, 동작주를 나타내는 (접사)
agentry : n, AGENT의 직무(의)
ageold : a, 예부터의, 오랜
ager : n, 발색(고착)기계(설비)
ageratum : n, 아게라툼(엉거시과의 일년초)
agespecific : a, 특정한 연령층에 고유한
AGF : n, Asian Games Federation 아시아 경기 연맹
agfay : n, (남성의)호모
agger : n, 이중 조수(일시적으로 작은 간만을 수반하는 썰물 또는 밀물)
aggie : n, 마노(같은 유리)구슬
aggie : n, 농업 학교, 농대, 농업 학교(농대)학생
aggiornamento : n, 현대적으로 함, 근대화
agglomerate : n, a, 덩이, 덩이진, 뭉쳐진, 모인
agglutinant : n, a, 접착제, 접착성의
agglutinate : vt, vi, 접착시키다, 유착시키다, 유착하다, 접착하다
agglutinated : a, 점착한, 교착성의
agglutination : n, 
agglutinative : a, 교착하는, 접합적인, 교착성의
agglutinin : n, 응집소
agglutinogen : n, (세포) 응집원
aggradation : n, 매적 작용
aggrade : vt, 매적 하다
aggrandize : vt, 증대하다, 확대하다, 늘리다, 계급을 올리다
aggrandizement : n, (부, 지위 등의) 증대, 강화
aggravate : vt, 악화시키다, 심하게 하다, 괴롭히다, 노하게 하다
aggravated : n, 가중 폭행
aggravating : a, 더욱 악화하는, 약오르는, 화나는
aggravation : n, 악화, 도발, 결발
aggravator : n, 더욱 악화시키는 것
aggregate : n, a, 집합, 집합의, 집성, 집성의, 총계, 총계의, 집합체
aggregation : n, 집합, 집성, 집합체, 집단
aggregative : a, 집합하는, 집합성의, 사교적인
aggress : vi, 공격으로 나오다, 싸움을 걸다
aggression : n, 침략, 침해, (부당한)공격
aggressive : a, 침략적인, 공세의
aggressor : n, 침략자
aggressor nation : x, 침략국
aggrieve : vt, 괴롭히다, 압박하다
aggrieved : a, 고민하는, 고통받고 있는, 화가 난, 기분히 상한
aggro : n, 화남(폭력적인)항쟁, 분쟁, 도발
aghast : pred, a, 질겁하여, 두려워 떨며, 어안이 벙벙하여
agile : a, 재빠른, 민활한
agility : n, 민첩, 명민함
agin : prep, 에 대하여, 에 반대하여
aginner : n, 변화(개혁)반대자
agio : n, 프리미엄, 환전 수수료, 환전업
agiotage : n, 환전업, 주식매매
agist : vt, (가축을)위탁 사육하다, (토지나 그 소유주에)과세하다
agitate : vt, vi, 몹시 뒤흔들다, 휘젓다, 들썩이다, 흥분시키다, 여론을 환기하다, 선동하다
agitated : a, 흥분한, 동요한
agitatedly : ad, 동요(흥분)하여
agitation : n, 동요, 흥분, 동란, 선동
agitative : a, 선동적인
agitato : ad, 격하여, 흥분하여
agitator : n, 선동가, 교반기
agitprop : a, 선동과 선전의, 아지프로의(베터런)
Aglaia : n, 아글라이아의 3여신 중의 하나
aglare : a, 번쩍번쩍 빛나고
aglaze : a, (눈이)흐릿한
agleam : a, 번쩍번쩍, 반짝반짝이는, 빛나는
aglet : n, (구두끈 등의 끝을 감은)쇠붙이, (군복 등에 다는)장식용 술
agley : ad, 비스듬히, 빗나가, 어긋나서, 잘못되어
aglimmer : ad, a, 깜박깜박(희미하게) 빛나서(빛나는)
aglitter : ad, a, 번쩌번쩍 빛나서(빛나는)
aglow : ad, 타올라, 빛나서
aglycon : n, 아글리콘(배당체의 가수 분해로 얻어지는 당 이외의 성분)
agma : n, 비음(기호)
agnail : n, (손톱의)거스러미
agnate : a, n, 부친쪽의친족, 동족의
agnation : n, 남계친
Agnes : n, 여자 이름
agnomen : n, (옛로마)넷째 이름, 덧붙이는 이름, 별명
agnosia : n, 실인(증), 인지 불능(증)
agnostic : a, n, 불가지론의, 불가지론자
agnostic : a, n, 불가지론(자)의, 불가지론자
agnosticism : n, 불가지론
agnus dei : n, 어린양의 상
ago : ad, 전에, 지금부터 전에, 현재를 기준으로 과거를 가르키는 표현
agog : ad, a, (기대 따위로)마음 부풀어, 들먹들먹하여
agogo : ad, a, 마음껏, 싫것, 디스코텍
agoing : ad, 움직여, 진행하여(set~ ...을 움직이다(작용하다), ...을 시작(착수)하다
agon : n, (옛그리스) 현상 경기회, (희극에서 주요 인물간의)갈등, 언쟁 부분
agonal : a, 고민의, (특히)죽음의 고통의
agonic : a, 각을 이루지 않는, 무편각선의
agonist : n, 싸움(경기)의 가담자, (문학 작품의)주인공, 주동(작동)근, 작용(작동)약(물질)
agonistic : a, 논쟁의(을 좋아하는), 승벽의, 효과를 노린, 무리한(포즈 따위)(고대 그리스의)경기의
agonize : vt, vi, 몹시 번민케 하다, 번민하다, 고민하다
agonized : a, 괴로워하는, 고민하는
agonizing : a, 고민을 주는, 괴로워하는, 고민하는
agony : n, 고통, 고뇌, 단말마의 괴로움, 희비의 극치
agony colnmn : x, (찾는 사람 따위의)사사 광고난
agora : n, 공공 광장
agoraphobia : n, 광장 공포증, 군중 공포증
agoraphobic : a, n, 광장 공포증의(사람)
agouti : n, 기아픽(중남미산으로 마못 비슷함)
agouti : n, 기니아픽
agraffe : n, 작은 꺽쇠, (의류, 갑옷의) 걸쇠, (피아노 현의)진동 방지 장치
agranulocyte : n, 무과립 백혈구
agrapha : n, 아그라파(성서외의 그리스도 어록)
agrarian : a, 토지의, 토지에 관한, 농민으로 위한 야생의
agravic : a, 무중력상태의
agree : vi, 동의하다, 찬성하다, 일치하다, 합의에 달하다(upon)
agreeable : a, 기분 좋은, 유쾌한, 사근사근한, 상냥한, 적당한
agreeably : ad, 기꺼이, 유쾌하게
agreed : a, 일치한, 협정한, 동의하여
agreement : n, 동의, 계약, 일치, 호웅
agrement : n, 아그레망(대, 공사파견에 앞서 상대국에 요구하는 승인)
agrestic : a, 시골(풍)의, 촌스러운
agribaron : n, 종업 관련 산업계의 거물
agribusiness : n, 농업 관련 사업
agrichemical : a, n, 농약의, 농약
agricultural : a, 농업의
agriculture : n, 농업, 농예, 농학
agriculturist : n, 농업경영자, 농가, 농학자
agrimony : n, 짚신나물
agrimotor : n, 농경용트랙터
agriology : n, 원시종족의 비교연구
agrobiology : n, 농업 생물학
agrobusiness : n, 사업으로서의 농업, 기업 농업
agrochemical : n, 농약, 농작물에서 얻어지는 화학 물질
agroecosystem : n, 농업 생태계
agroindustrial : a, 농업 및 공업의, 농공용의, 농업 관련 산업의
agrology : n, 농업(응용)토양학
agronomics : n, 농경학
agronomist : n, 농업 경제학자, 경종학자
agronomy : n, 농경학법, 농업경영
agropolitics : n, (단수 취급)농업 정책
agrostology : n, 화본학(禾本學), 초본학
agrotechnology : n, (혁신적)농업 기술
agrotype : n, 토양형, (농작물의) 재배 제품
aground : ad, 지상에, 좌초되어
ague : n, 학질, 오한
agued : a, 학질에 걸린
aguish : a, 학질의 학질에 걸린, (몸을)와들와들 떠는
ah : int, 아아(슬픔, 한탄, 기쁨등을 나타냄)
aha : int, 아하, 기쁨, 만족, 승리등을 나타냄
ahchoo : int, 에치, 재치기소리
Ahead : n, 암페타민(LSD) 상용자
ahead : ad, 앞서서, 앞으로, 앞질러, 나아가, 우세하여, 이겨
aheap : ad, a, 산더미같이 (여)
ahem : int, 에헴, 에에
ahermatype : n, 암초를 만들지 않는 산호
ahimsa : n, (힌두교, 불교 등의) 불살생(不殺生)
ahistoric : a, 비역사의, 역사에 무관한, 역사적이 아닌
ahorse : a, ad, 기마의, 말탄, 말을 타고
ahoy : int, 어어이(먼 배를 부를때 내는 소리)
Ahriman : n, (조로아스터교)아리만(암흑과 악의 신)
ahuisclos : ad, 비밀히, 방청금지로
ahull : ad, 돛을 걷고 키손잡이를 바람맞이 쪽으로 잡아(폭풍우에 대한 대비)
ai : n, 세손가락나무늘보
aid : vt, vi, 돕다, 조성하다, 거들다
Aida : n, 아이다(베르티의 오페라(1871), 그 여주인공인 에티오피아의 왕녀)
aide : n, 부관
aidedecamp : n, (왕족, 장성에게 딸린)부관
aidememoire : n, 비망록, 외교 각서
aidman : n, 육군 위생병, 야전 부대 소속 육군 위생병
aid society : x, 여성 자선 바자회
aid station : n, 전방응급치료소
aigrette : n, 해오라기, 꼬꼬마, 관모, (부인 모자의) 장식털
aiguille : n, 뾰족한산봉우리
aiguillette : n, (군복의)장식술, 장식꾼
ail : vt, vi, 괴롭히다, 괴로와하다, 앓다
ailanthus : n, 가죽나무속의 식물
ailanthus : n, 가죽나무속의식물(꽃에 악취가 있음)
Aileen : n, 여자 이름(Helen의 아일랜드 어형)
aileron : n, 보조익
ailing : a, 병든, 괴로워하는
ailment : n, 병
aim : vi, vt, 겨누다, 노리다, 목표로 하다, 뜻하다
aiming : n, a, 겨냥(하는), 조준(의)
aimless : a, (이렇다 할)목적(목표)없는
Ainu : a, 아이누사람의
aioli : n, 아이올리(마늘, 노른자위, 올리브유, 레몬 주스로 만든 소스)
air : n, 공기, 대기, 공중, 하늘, 산들바람, 선율, 가락, 노래, 모양, 태도
air alert : n, 공습경보(경계)
air attack : n, 공습
air bag : n, 에어백(자동차 충돌시의 안전 장치)
air ball : n, 풍선
air base : n, 공군기지
air bath : n, 공기욕(공기를 매체로 하는 가열 장치)
air bed : n, 공기가든매트리스, 공기가든매트리스
air bladder : n, (물고기의)부레
air blast : n, 충풍, 인공 부나 기행정
airboat : n, 수상기, 초계비행정
airborne : a, 공수된, 바람에 의해 운반된
air brake : n, 공기제동기
airbreathe : v, (제트기 따위가 연료 산화를 위해)공기를 빨아들이다
airbrush : n, 에어브러시
airbus : n, 에어버스(중단거리용 대형 여객기)
air cargo : n, 공수화물
air carrier : n, 항공회사, 항공기
air castle : n, 공중누각, 몽상
air chamber : n, 기포, 기실
air chiefmarshal : n, 공군대장
air coach : n, 대중여객기
air cock : n, 공기콕
air command : n, 공군사령부, 항공군집단
air commodore : n, 공군준장
air condition : vt, 공기 조절하다, 냉난방 창치를 하다
air conditioner : n, 냉난방(공기 조절)장치
air conditioning : n, 공기조절, 냉난방장치
air controlman : n, 항공관제원
air cool : vt, 공랭하다
air corridor : n, 항공회랄(특히, 제 2차 대전 후의 동베들린, 서독간의)
air craft : n, 항공
air craftman : n, 항공병
air craftwoman : n, 여성 항공병
air crew : n, 항공기 승무원
air current : n, 기류
air curtain : n, 에어커튼
air cushion : n, 공기방석
air cushionvehicle : n, 호버크래프트
air defense : n, 방공
air division : n, 항공사
airdrome : n, 비행장, 공항
airdrop : n, vt, 공중 투하, 공중 투하하다
airduct : n, 통풍관, 송풍관
airedale : n, 에어데일 개(테리어의 일종)
air edition : n, 라디오판(항해중인 배안 등에서 무전으로 뉴스를 받아 발행함)
air express : n, 공수소하물, 소하물공수
airfare : n, 항공운임
airfield : n, 비행장
airfight : n, 공중전
air fleet : n, 항공기편대
airflow : n, (비행기, 자동차등이 일으키는)기류
airfoil : n, 날개, 프로펠러날개
air force : n, (육, 해군으로 구성된)항공부대
airframe : n, 비행기, 로케트의기체
airfreight : n, 항공 화물
air gauge : n, 기압계
airgraph : n, (마이크로 필름에 의한)항공축사
air hammer : n, 공기해머
airhead : n, 공두보(공수 부대가 확보한 적지내의 거점), 전선 공군 기지
air hole : n, 빙상의구멍, 에어포켓
air hostess : n, (여객기의)스튜어디스
airing : n, 공기에 쐼, 바람에 말림, 산책, 야외운동, 드라이브
air jacket : n, 자켓식구명대
air lane : n, 항공로
airless : a, 바람이 없는, 환기가 나쁜
air letter : n, 항공우편, 항공 서한
air lift : x, 공수보급
airline : n, 항공로, 항공 회사, 직행로
airliner : n, 정기 여객기
air lock : n, 기갑, 잠함의 기밀실
air log : n, 비행거리계(유도탄의)비행 거리 종정 장치
airmail : n, 항공 우편(제도)
airmailedition : n, 공수판
airman : n, 비행가, 비행사
air map : n, 항공사진을 이용한 지도
air marshal : n, 공군중장
air mile : n, 공로마일(약1853미터)
airminded : a, 항공에관심을가진, 비행 여행을 즐기는
air ministry : n, 공군성
air motor : n, 압착공기발동기
airpark : n, 작은공항
air patrol : n, 공중정찰, 비행정찰대
air piracy : n, 하이잭, 공적행위
airplane : n, 비행기(영국에서는 보통 aeroplane)
air planecloth : n, 비행기익포, (셔츠, 파자마용)무명
air plant : n, 공기식물
air pocket : n, 에어포켓, 직강기류
air pollution : n, 대기오염
airport : n, 공항
air power : n, 공군력
air pressure : n, 기압
airproof : a, 공기를 통하지 않는, 내기성의, 밀봉의
air pump : n, 공기펌프
air raid : n, 공습
air rifle : n, 공기총
air right : n, 공중권
air route : n, 항공로
air sac : n, 새의기낭
airscape : n, 공감도, 항공사진
air scout : n, 정찰기, 비행정찰병
airscrew : x, 프로펠러
airsea : a, 해공의
air service : n, 항공수송
air shaft : n, 통풍공
airship : n, 비행선
airsick : a, 고공병에 걸린, 비행기 멀미가 난
air space : n, 공적, 영공
air speed : n, 대기속도
air spring : n, 공기스프링
air stewardess : n, 여객기 스튜어디스
air stop : n, (항공기의)기항지, 헬리포트
airstream : n, 기류
airstrip : n, 임시 활주로, 가설 활주로
air terminal : n, 에어터미널(항공 승객이 출입하는 건물)
airtight : a, 기밀의, 공기를 통하지 않는, 철통같은, 몰샐 틈 없는
airtoair : a, 공대공(空對空)의, 기상발사의, 두 비행기 간의
airtoground : a, 공대지(空對地)의
airtounderwater : a, 공대수중의
air transport : x, 공중수송, 공수
air trap : x, 공기트랩, 방취관
air umbrella : x, 항공 원호(엄호)대
air valve : n, 공기판
air warden : x, 공습경비원
air way : n, 항공로, 통풍구멍
air waybeacon : x, 항공표지등(등대)
air well : x, 통풍구멍
airwise : a, 항공에 정통한
airwoman : n, 여자 비행사
airworthy : a, 내공성이 있는
airy : n, 공기의, 공중의, 바람이 잘 통하는, 경쾌한, 우미한, 경솔한, 공허한
aisle : n, 측량, 좌석.객차등의 통로, 복도
aisled : a, 측랑이 있는
aisle seat : x, 통로쪽 좌석
aitch : n, 글자h발음
Ajanta : n, 아잔타(인도 서부의 마을, 석굴과 벽화가 유명)
ajar : ad, (문이)조금열려
ajar : ad, 조화되지 않아
Ajax : n, 트로이전쟁의 그리스군의 용사
akimbo : ad, 두 손을 허리에 대고
akin : a, 혈족의, 동족의, 같은, 비슷한
akinesia : n, 무운동(완전한, 부분적 운동 마비)
Akkad : n, 아카드(Nimrod 왕국에 있었던 도시중의 하나)
Akkadian : n, 아카드 말(바빌로니아, 아시리아 지방을 포함하는 동부지방의 셈어)
Alabama : n, 미국 남부의
Alabamian : a, 알라바마의 
alabamine : n, 앨라배민
alabaster : n, 설화석고
alabastrine : a, =ALABASTER
alacarte : ad, a, 메뉴 정가표에 따른, 일품요리의
alacritous : a, 민활한, 팔팔한, 활발한
alacrity : ad, 활발, 민활
aladdin : n, 알라딘(마법의 남포를 발견한 아라비안나이트)
Aladdin's lamp : x, (소원대로 해준다는)얼래딘의 램프
alae : n, ala의 복수
alaking : x, 고추등을 넣고 크림을 친
alalia : n, 발어 불능주의
alameda : n, (포플라 등의)가로수 길
alamo : n, 얄은 비단, 미국 텍사스주에 있는 지명
alamode : n, 얇은 비단, 스카프용의 윤기 있는 얇은 비단
Alan : n, 남자 이름
alanine : n, 알라닌(아미노산의 일종)
alanyl : n, 알라닐
alapage : a, 첨단적인, 최신 유행의
alar : a, 날개의, 깃의, 날개(깃)가 있는, 겨드랑이의
alarm : n, 놀란, 공포, 경보, 경보기, 자명종
alarm : n, 놀람, 공보, 경보, 경보기, 자명종
alarm bell : x, 경종
alarm clock : n, 자명종
alarmed : a, 겁 먹은, 불안해 하는, 깜짝 놀란
alarming : a, 놀랄 정도의
alarmism : n, 사람을 놀램, 법석, 기우
alarmist : n, 걸핏하면 놀라는 사람, 법석꾼
alarm signal : n, 비상 경보
alarum : n, 경보기, 경종, 자명종 소리
alary : a, 날개(깃)의, 날개 모양의
alas : int, 아아, 슬픈지고
alaska : n, 북아메리카 서북단의 주
Alaskan : a, 알래스카(사람)의
Alastor : n, 알라스토르(복수의 신), 남자 이름
alated : a, 날개가 있는
alb : n, 천주교 예배시 입는 희고 긴옷
albacore : n, 다랑어의 무리
Albania : n, 유고 슬라비아와 그리스 사이의 공화국
Albanian : a, n, 알바니아 (사람, 말)의, 알바니아 사람, 알바니아 말
albany : n, New York주의 주도
albata : n, 양은
albatross : n, 신천옹
albedo : n, 알베도(원자로내의 반사체에 의해 반사되는 중성자의 비율)
albeit : conj, 비록 ...이기는 하나, ...(임)에도 불구하고(even though)
Albert : n, 남자 이름, 앨버트공
Alberta : n, 여자 이름, 앨버타(캐나다 서부의 주도)
albescent : n, 희어지는, 희끔한
Albigenses : n, 알비파(12-13세기 남프랑스의 종교 개혁자들)
Albin : n, 남자 이름
Albina : n, 여자 이름
albinism : n, 색소결핍증
albino : n, 백인, 털과 피부가 병적으로 흰, 변색종
albinotic : a, 선천성 백피증의, 백변종의
Albion : n, 앨비언(Great Britain, 후에 England의 옛 이름)
albite : n, 조장석
album : n, 사진첩, 앨범
albumen : n, 흰자위, 단백질, 배유
albumenize : vt, (인화지 등에)단백을 칠하다, 단백으로 처리하다
albumin : n, 알부민
albuminoid : a, n, 단백성의, 경 단백질, 골격성 단백질
albuminous : a, 단백성의, 단백질을 함유한, 배젖이 있는
albuminuria : n, 단백뇨
albumose : n, 알부모스(소화 효소 작용으로 단백질이 분해된 것)
alburmous : a, 백목질의
alburnum : n, 백재, 백목질
alcahest : n, =ALKAHEST
Alcaic : n, 고대 그리스의 시인
alcaide : n, (스페인 등의)요새 사령관
alcalde : n, (스페인, 포르투갈 등의)재판관 겸 시장
alcatraz : n, 미국의 작은섬(형무소)
alchemic : a, 연금술의
alchemist : n, 연금술사
alchemistic : a, 연금술적인
alchemize : vt, (연금술로)변질시키다
alchemy : n, 연금술
alclad : n, 앨클래드(이중 금속관)
ALCM : n, air launched cruise missile 공중 발사크루즈 미사일
Alcmene : n, 알크메네(그리스신화의 헤라클레스의 어머니)
alcohol : n, 알코올
alcoholic : a, 알코올성의, 알코올의
alcoholicity : n, 알코올 도수(함유량)
alcoholism : n, 대주, 알코올 중독(증)
alcoholize : vt, 주정화하다, 알코올에 담그다, 알코올로 취하게 하다
alcoholometer : n, 알코올 비중계, 주정계
alcoholysis : n, 알코올 분해
alcometer : n, 취도계
Alcoran : n, 이슬람교의 경전, =KORAN
Alcott : n, 올콧(미국의 여류 작가)
alcove : n, (큰방 깊숙이 딸린)골방, 구석진 칸, (정원의)정자
Alcyone : n, 황소자리의 3등성
Aldebaran : n, 황소자리 중의 1등성
aldehyde : n, 알데히드
aldente : a, (마카로니 등이)되직하게 (씹히게) 요리한
alder : n, 오리나무
alderman : n, (영국과 아일렌드의)시참사의원, 부시장
aldermanic : a, ALDERMAN의 (다운)
alderney : n, 젓소의 일
Aldershot : n, 올더숏(잉글랜드 남부의 도시)
aldohexose : n, 알도헥소스
aldosterone : n, 알도스테론(부신 피질 호르몬)
Aldous : n, 남자 이름
aldrin : n, 앨드린(강력 살충제)
ale : n, (쓴맛이 강한)맥주
aleatoric : a, 우연성의, 임의적인
aleatory : a, 우연에 의한, 사행적인, 도박적인
alebench : n, 선술집의 긴 의자
Aleck : n, 남자 이름(Alexander의 애칭)
aleconner : n, 주류 검사관
alee : ad, 바람맞이쪽으로
alegar : n, 맥아초, 맥주초
alehouse : n, 비어홀
Alemannic : n, 알라만 말, a, 알라만 말(사람)의
alembic : n, 옛날의 증류기, 정련(정화)시키는 것
aleph : n, 알레프(헤브라이어 알파벳의 첫자)
alephnull : n, 알레프 제로(자연수 전체 또는 그것과 1대1로 대응하는 집합의 농도)
alert : a, 방심 않는, 민활한, 경계, 경계경보
aleukia : n, 무백증(백혈구의 감소, 결여)
aleurone : n, 호분
Aleut : n, (얼류션군도의)에스키모토인
Aleutians : n, 알래스카남서부의 군도(미국령)
A level : x, 상급학년시험
alevin : n, 치어, 연어 새끼
alewife : n, 청어의 일종
Alex : n, 남자 이름(Alexander의 애칭)
Alexander : n, 마케도니아의왕
Alexandra : n, 여자 이름
Alexandria : n, 나일강어귀의 항구
Alexandrian : a, 알렉산드 대왕의
alexandrine : n, 알렉산더구격(억양 6시각)
alexandrite : n, 알렉산더 보석(짙은 초록색)
alexia : n, 독서불능증
alexin : n, 알렉신, 살균소
alexipharmic : a, 해독의
alfalfa : n, 자주개자리
alfatah : x, 알파타(반 이스라엘 아랍 특공대의 하나)
alfine : ad, 끝까지(to the end)
alforja : n, 안장주머니의, (비비)의 볼주머니
Alfred : n, 남자 이름, 앨프레드 대왕
alfresco : a, ad, 야외의
alg : n, 해조
alga : n, 해조
algal : a, n, 해조의
algebra : n, 대수, 대수학
algebraic : a, 대수의, 대수학의
algebraist : n, 대수학자
Algeria : n, 아프리카 북부의 공하국(1962 독립)
algerian : a, n, 알제리의, 알제리사람의
algicide : n, 살조제(殺藻劑)
algid : a, 추운, 한기가 드는
algidity : n, 오한
Algiers : n, 알제리의 수도
alginicacid : x, 알긴산
algoid : a, 조류(말류) 비슷한, 말류 모양의
Algol : n, 프로그램언어(알골)
algolagnia : n, 기통애(매저키즘과 사디즘)
algologist : n, 조류학자
algology : n, 조류학
Algonkian : a, n, 알곤키안(원생)대의, 알곤키안(원생)대
Algonquian : n, a, 알곤킨족(의)(북 아메리카 토인중 가장 널리 분포된 어족)
algophobia : n, 공포증, 동통
algorism : n, 아라비아 기수법
algorithm : n, 연산방식
algraphy : n, 알루미늄 평판 인쇄
alguazil : n, 연산장치
algum : n, 백단향무리
Alhambra : n, 스페인의 Gramada에있는 무어족의 여러왕의 궁전
Alhambresque : a, 알함브라 궁전식의 (건축 양식)
alias : a, n, 별명(으로)
alibi : n, 알리바이, 현장 부재 증명, 변명
alible : a, 영양분 있는
Alice : n, 앨리스, 여자이름
alidade : n, 조준의
alien : a, 외국의, 외국인의, 다른, 반대의, 조화되지 않는
alienability : n, 양도할 수 있음
alienable : a, (재산 등이)양도할 수 있는
alienage : n, 외국인임, 외국인의 신분
alienate : vt, (친구 등을)멀리 하다, 소원하게 하다, 이간하다
alienation : n, 소원, 소외감, 양도, 이전, 전용
alienator : n, 소원하게 하는 사람, 양도인
alienee : n, 양수인
alienism : n, 정신병학(치료)
alienist : n, 정신과 의사
alienor : n, 양도인
aliform : a, 날개 모양의
alight : vi, 내리다, 하차하다, 착륙하다, 새가 앉다
align : vt, vi, 일렬로세우다
alignment : n, 일직선(을 이루기), (일렬) 정렬, 정돈(선)
alike : pred, a, 같은, 똑같은, 같이, 같게
aliment : n, 영양물, 음식물
alimental : a, 영양물의, 음식물의
alimentary : a, 영양의, 음식의
alimentation : n, 영양, 자양물, 부양
alimentative : a 영양이 있는
alimony : n, 별거(이혼)수당
A line : a, vi, 라인의, A라인의(여성복이 A자처럼 위가 좁고 밑이 퍼짐)
alinement : n, =ALIGNMENT
aliped : a, n, (박쥐처럼)익수가 있는, 익수동물
aliphatic : a, 지방족의, 지방질의
aliquant : a, n, 정제되지않은, 나누어 떨어지지않는
aliquot : a, n, 정제되는, 나누어 떨어지는
Alison : n, 여자 이름
Alitalia : n, 이탈리아 항공 회사
alive : pred, a, 살아서, 혈기왕성하여, 활기를 띠어
aliyah : n, (유대교에서)성전대로 가기, (유대인의)이스라엘 이주
alizarin : n, 알리자린(적색 물감)
alkahest : n, (연금술사가 구하던)만물융해약
alkalescent : a, 약알칼리성의
alkali : n, 알칼리
alkalic : a, 알칼리(성)의
alkalify : vt, vi, 알칼리성으로 되다, 알칼리성으로 하다
alkalimetry : n, 알칼리 정량(분석)
alkaline : a, 알칼리성의
alkalinity : n, 알칼리성
alkalinization : n, 
alkalinize : vt, =ALKALIFY
alkalize : vt, 알칼리성으로 하다
alkaloid : n, a, 알칼로이드, 알칼로이드의
alkaloidal : a, =ALKALOID
alkalosis : n, 알칼리 혈증
alkanet : n, 알카넷, 붉은물감(뿌리에 뽑는)붉은 물감
alkene : n, 알켄(에틸렌열 탄화수소)
alkyd : n, 알키드수지
alkyl : n, a, 알킬, 알킬의(지방족의 포화탄화수소기)-알킬의을 포함한)
alkylate : vt, n, 알킬화하다, 알킬레이트(알킬화 반응의 생성물)
alkyne : n, 알킨(아틸렌계 탄화수소)
all : a, 모든, 전부의, 전, 온
allah : n, 알라(회교의 신)
All American : n, a, 전미대표의, 미국인으로만 된, 미국제일의(사람)
allantoin : n, 알란토인(요산의 산화 생성물, 외상약에 씀)
allantois : n, 요막
allargando : ad, a, 차차 느리게(느린) 또 세게 (센)
allaround : n, 연합국
allatonceness : n, 동시 다발(한꺼번에 많은 일이 일어남)
allay : vt, 가라앉히다, 누그러뜨리다
allday : a, 하루 걸리는
allegation : n, 확언, 주장, 진술, 변명
allegdely : ad, 주장하는 바에 의하면
allege : vt, 단언하다, 증거 없이 주장하다
alleged : a, (증거 없이)주장된, 추정(단정)된
alleghenies : n, 엘러게이니산맥(미국 동부의 산맥)
allegiance : n, 충성, 충실, 전념
allegiant : a, n, 충성을 다하는, 충성의 의무가 있는 자, 신하
allegoric : a, ad, 풍유의, 우화(적)인
allegorise : v, =ALLEGORIZE
allegorism : n, 풍유(사용), (성서의)비유적 해석
allegoristic : a, 비유(풍유)적인, 우화적인
allegorize : vt, vi, 우화적으로 말하다, 비유를 쓰다
allegory : n, 비유, 우화, 비유담
allegretto : ad, 좀 빠르게
allegro : ad, n, 빠르게, 급속도로
allegroist : n, 풍유가, 우화 작가
allele : n, 
allelectric : a, 모두 전력에 의한
allelomorph : n, 대립유전자, 대립형질
allemande : n, 독일 댄스의 일종, 그 곡
allemande : a, 모든 것을 포함하는, 포괄적인, 총괄적인
Allen : n, 남자 이름
allergen : n, 알레르겐(알레르기를 일으키는 물질)
allergenic : a, 알레르기를 일으키는
allergic : a, 알레르기의
allergist : n, 알레르기 전문 의사
allergology : n, 알레르기학
allergy : n, 알레르기
alleviate : vt, 경감하다, 완화하다
alleviative : n, 경감, 완화, 경감(완화)하는 것
alleviator : n, 경감(완화)하는 사람(것)
alleviatory : a, 경감용의, 완화적인, 위자의
allexpense : a, 전 비용 부담의, 전액 포함의 (여행 등)
alley : n, 뒷골목, 뒷길, 좁은 길, 샛길
alley : n, 튀김돌
alley cat : n, 도둑고양이, 매춘부
alley way : n, 골목길, 좁은통로
allfired : a, ad, 무서운, 굉장한, 무섭게
Allhallowmas : n, Allhallows의 축제
Allhallows : n, =all saints day
allheal : n, 쥐오줌풀, 꿀풀, (외상용)약초
alliaceous : a, 파속의, 파(마늘, 부추)냄새가 나는
alliance : n, 동맹, 결연, 인척관계, 협력, 협조, 동맹자, 연합국
allicin : n, 알리신(마늘에서 추출되는 항균성 물질)
allied : a, 동맹한, 연합국의, 결연한
allies : n, 연합국의
alligation : n, 혼합법
alligator : n, (미국 중국산의)악어
allimportant : a, 극히 중요한
allin : a, 모든 것을포함한, 기진맥진하여, 무일푼이 되어, 자유형의
allinclusive : a, 모든 것을 포함한, 포괄적인
alliterate : vt, 두운을 사용하다, 맞추다
alliteration : n, 두운
allium : n, 파, 마늘류
allknowing : a, 전지의
allmains : (수신기가)어떤 전압에도 쓸 수 있는
allness : n, 전체성, 보편성, 완전, 완벽
allnight : a, 철야의
alloantibody : n, 동종(이계)항체
alloantigen : n, 동종(이계)항원
allobar : n, 기압 변화역, 기압 등변화선
allocable : a, 할당(분배)할 수 있는
allocate : vt, 할당하다, 배분하다, 배치하다
allocatee : n, 배급받는 사람, 수급자
allocation : n, 배당, 배급, 배치, 배당액
allocator : n, 배당자, 배치자
allocution : n, 훈시, 유시(로마 교황등의)
allodial : a, 완전 사유지의, 자유 보유 토지의
allodium : n, (봉건 시대의)완전 사유지
allogamous : a, 타화(타가) 수정의, 타식의
allogamy : n, 타가생식, 타화수정
allograft : n, 타가 이식
allograph : n, 대필, 대리 서명
alloimmune : a, 동종 면역의
allomerism : n, 이질 동형
allomerous : a, 이질 동형의
allometry : n, 상대 성장 측정(연구)
allomorph : n, 이형태(형태소의 이형), 이형 가상
allomorphic : a, 이형태의
allonym : n, 필명, 가명 작품
allopath : n, 대중 요법의사
allopathy : n, 대증 요법
allopatric : a, 이소(성)의, 지역마다 다른
allophane : n, 알로페인(무정형 함수 알루미늄 규산염)
allophone : n, 이음
allophylian : a, 아리안 및 셈어족에 속하지 않는
alloplasm : n, 이형질
allornone : a, 전부가 아니면 아예 포기하는
allornothing : a, 과단성 있는, 전부가 아니면 아예 포기하는
allosaurus : n, 알로사우루스(육식 공룡)
allosteric : a, 알로스테릭한(효소, 단백질)
allostery : n, 알로스테릭 효과
allot : vt, 분배하다, 할당하다, 충당하다, 기대하다, 믿다, 생각하다
allotment : n, 할당, 분배, 몫, 분담액, 지정, 배치
allotransplant : vt, n, 타가(이물)이식하다, 타가(이물)이식
allotrope : n, 동소체의
allotropic : a, 동소체의
allotropy : n, 동질 이체, 동소체, 동질 이형
allottee : n, 할당받는 사람
allotype : n, (분류상의)별모식, 표본, 알로타이프(종족내 항원)
allout : a, 전력을 다한, 전면적인
allouter : n, 극단론자
allover : n, a, (무늬따위가)전면에걸친, 전면무늬의
alloverish : a, 불안한, 몸이 불편한
allow : vt, 허용하다, 인정하다, 참작하다, 할인하다, 학자, 수당을 주다
allowable : a, 허락할 수 있는, 무방한, 정당한
allowance : n, (정기적으로 지급하는)수당, 급여액, (가족에게 주는)용돈
allowed : a, 양자수의, 변화를 포기한
allowedly : ad, 인정되어, 명백히
alloy : n, vt, 합금, 비급속, 섞음질, 품위, 합금하다, 섞음질하다, 품질을 떨어뜨리다
allpossessed : a, 악마에 홀린 듯한, 열중해 있는
allpowerful : a, 최강의, 전능의
allpurpose : a, 무엇에든 쓸 수 있는, 만능의
allrightnik : n, 중간(의 지위)에 안주하는 사람
allround : a, 다방면에 걸친, 만능의, 융통성 있는
allseed : n, 씨 많은 풀(마디풀, 명아주 등)
allseeing : a, 널리 만물을 내다보는
allsorts : n, 갖가지 구색을 섞은 것, 각종 캔디의 구색
allspice : n, 서인도산의향료
allstar : a, n, 스타 총출연의, 일류 선수로 짜인-선발 팀 선수
alltime : a, 전시간의(full-time), 공전의, 기록적인, 근무의
allude : vi, 넌지시 비추다, 에 관해 말하다
allupweight : x, (항공기의)총중량
allure : vt, 꾀다, 부추기다(tempt), 매혹하다
allurement : n, 매혹, 유혹, 유혹물
allurer : n, 유혹하는 사람
alluring : a, 유혹하는, 마음을 끄는, 매혹적인, 황홀한
allusion : n, 암시, 변죽 울림, 약간의 언급, 인유
allusive : a, 암시적인, 넌지시 빗대고 말하는, 인유가 많은
alluvia : n, ALLUVIUM의 복수
alluvial : a, 충적의
alluvial gold : x, 사금
alluvion : n, 충적지, 물가의 신생지, 파도의 들이침, 홍수
alluvium : n, 충적층, 충적토
allwave receiver : x, 전파수신기
allway : n, 골목길, 좁은 통로
allweather : a, 어떤 날씨에도 사용할 수 있는, 전천후의
allwhite : a, 백인만의, 백인 전용의
Almagest : n, 알마게스트, 연금술 저서
Alma Master : x, =foresting mother
almanac : n, 달력, 책력, 연감
almandine : n, 귀석류석
almentary canal : x, 소화관의
almightiness : n, 전능
almighty : a, ad, 전능한, 대단한, 대단히
almirah : n, 옷장, 찬장
almond : n, 편도
almondeyed : a, 편도형의 눈을 가진(몽고 인종의 특징)
almoner : n, (왕가.수도원 등의)구휼품분배관
almonry : n, 구휼품분배소
almost : ad, 거의
alms : n, 보시, 베풀어주는 사람
alms box : x, 자선함
almsfolk : n, 구호금으로 생활하는 사람들
almsgiver : n, 시주, 자선가
almsgiving : n, 베풂, 자선
almshouse : x, 공립구빈원, 사립양로원
almsman : n, 피보호자
almswoman : n, 구호를 받는 여자
alnico : x, 알니코(알루미늄, 니켈, 코발트)
alodial : a, =ALLODIAL
alodium : n, =ALLODIUM
aloe : n, 노회, 침향
aloeswood : n, 가라목
aloft : ad, 높이, 위쪽에, 위로, 돛대 꼭대기에(go~ 천국에 가다, 죽다)
alogical : a, 비 논리적인, 논리에 반대하는
aloha : n, 사랑, 애정, 환영
alohaoe : int, 어서 오세요, 안녕희 가세요
aloha shirt : x, 알로하셔츠
aloin : n, 알로인(aloe를 원료로한 완하제)
alone : pred, a, ad, (실제로 또는 감정적으로)홀로, 혼자, 단지(leave~ 내버려 두다, let~ ..은 말할 것도 없고)
along : prep, 을 따라, 을 끼고
alongshore : ad, 해안을 따라
alongside : ad, prep, 곁에, 옆으로 대어, 와 나란히
aloof : ad, pred, a, 떨어져서, (keep(stand, hold)~(...에서)떨어져 있다, (...에) 초연해 있다(from)-초연한, 무관심의
alopecia : n, 탈모증, 독두증
aloud : ad, 큰 소리로, 똑똑히
alp : ad, 높은 산(알프스 산 중턱의) 목초지
alpaca : n, 알파카
alpenglow : n, 아침놀, 저녁놀(높은 산꼭대기에서 볼 수 있는)
alpenhorn : n, (스위스 사람의) 목재 나팔
alpenstock : n, 등산지팡이
alpha : n, 그리스자모의 첫째글자
alphabet : n, 알파벳, 초보
alphabetic : a, 알파벳의, 초보의
alphabetize : vt, 알파벳순으로 하다, 알파벳으로 표기하다
alphahelix : n, (단백질 중의 polypeptide 사슬의)알파( )나선
alphametic : n, 숫자 퍼즐
alphanumeric : a, 알파뉴머릭, 알파벳등의 문자와 숫자된, 문자와 숫자 양용의
alpha particle : x, 알파입자
alpha plus : x, 최고급의
alpha rays : x, 알파선
alpha rhythm : x, (뇌파의)알파리듬
alphascope : n, 알파스코프, 컴퓨터 브라운관 표시장치
alpha test : x, 지능테스트
Alpheus : n, 알페오스(강의 신)
alphorn : n, =ALPENHORN
Alpine : a, 알프스의, 고산의, 대단히 높은
alpinism : n, 알프스 등산, (고산의)등산
alpinist : n, 알프스 등산가, 등산가
Alps : n, pl, 알프스 산맥
already : ad, 이미, 벌써, 곧
alright : ad, 
Alsatia : n, 프랑스 동북부 Alsace의 옛이름, 도피장소
Alsatian : a, 알자스(Alsace)(주민)의, (런던의) 알세이셔(Alsatia)의
alsike : n, 클로버의 일종(유럽산, 목초)
also : ad, 또한, 역시, 그 위에
alsoran : n, 등외말, 낙선자, 샐패자, 범재
alsorunner : n, (경기 등의)패자
alt : n, 알토, 중고음
Altai : n, 알타이(소련의 한 지방)
Altaic : n, a, 알타이어족-알타이어족의, 알타이 산맥
Altair : n, 견우성, 독수리자리의 주성
Altamira : n, 스페인 북부의 구석기 시대의 동굴 유적
altar : n, (교회의)제단, 제대, 성찬대
altarage : n, (교회의)제단 위의 공물, 교회에 바치는 공물, 공물중에서 성직자에게 지불하는 세례
altarboy : x, (미사의)복사
altarpiece : n, 제단의뒷장식
altarrail : x, 제단앞의 난간
altazimuth : n, 경위의
alter : vt, vi, a, n, 바꾸다, 박뀌다, 거세하다, 변경할 수 있는, 변경
alterability : n, 변경할 수 있음, 가변성
alterable : a, 변경할 수 있는
alterant : a, n, =ALTERATIVE
alterantor : n, 교류
alteration : n, 변경, 개조
alterative : a, (체질 등을)바꾸는, 대사 기능을 개선하는, 서서히 회복시키는
altercate : vt, 언쟁(격론)하다
altercation : n, 언쟁, 격론
alterego : x, 타아, 친구
alternant : a, n, 교호의, 교대의, 교대 함수
alternate : a, n, vt, vi, 번갈아서의, 호생의, 교체, 대리(위원)교체원, 번갈아 하다 교체하다, 교류하다
alternating current : x, 교류
alternation : n, 교호, 번갈음
alternative : n, (둘 중에서)하나를 택해야 할, 양자 택일의, 둘 중에서의 선택
alternative judgment : x, 양자택일적판단
alternative question : x, 선택의 문
althaea : n, 접시꽃속의 식물, 무궁화
Althea : n, 여자 이름
althorn : n, 알토호른
although : conj, 비록 ...일지라도, ...이기는 하지만(though)
altigraph : n, 자동고도표시기
altimeter : n, 고도측량기
altimetry : n, 측고법
altissimo : a, n, (음조의)가장 높은
altitude : n, 높이, 고도
altitude flight : x, 고도비행
altitude record : x, 고도기록
altitude sickness : x, 고공병
altitudinal : a, 고도의, 표고의
alto : n, 알토
altocumulus : n, 고적운, 높쎈구름
altogether : n, 아주전혀, 전부해서, 대체로-전체적 효과
altometer : a, n, 고도의, 고도계
altorelievo : n, 고부조, 높은 돋을 새김
altostratus : n, 고층운
altruism : n, 애타주의
altruistic : a, 이타적인
alula : n, (새의)작은 날개(깃)
alum : n, 명반
alumina : n, 알루미나, 반토
aluminate : n, 알루민산염
aluminize : vt, ...에알루미늄을입히다, ...을 알류미늄으로 처리하다
aluminous : a, 명반의
aluminum : n, 알루미늄
alumnus : n, 졸업생
alumroot : n, 범의귀속의 식물
alunite : n, 명반석
alveolar : a, n, 폐포의, 치조의
alveolate : a, 벌집모양의
alveolus : n, 벌집의작은구멍
always : ad, 언제나, 늘
alyo : n, 늘 정해진 일, 평온한 상태, 침착한 사람, 매수, 뇌물
alyssum : n, 알리섬 뜰냉이(겨자과의 1년생 식물)
amadavat : n, 방울새 비슷한 작은 명금
amadou : n, 말굽버섯과의 버섯으로 만든 해면상 물질(부섯깃, 지혈등에 씀)
amah : n, 어멈, 유모, 업저지, 하녀
amain : ad, 힘껏, 전속력으로
amalgam : n, 아말감(수은과 딴 금속의 합금), 혼합물
amalgamate : vt, vi, 수은과 섞다, 아말감으로 하다, 합동하다, 합병하다
amalgamation : n, 아말감화, 이인종의 융합, 흑인과 백인의 혼혈
amalgamative : a, 혼합하기 쉬운, 융합적인, 합동적인
amalgamator : n, 혼홍기, 혼합기, 합병자
Amanda : n, 여자 이름
amanita : n, 독버섯의 일종
amantadine : n, 아만타딘(항 바이러스 약)
amanuensis : n, 필기자
amaranth : n, 시들지않는꽃
amaranthine : a, 시들지 않는, 불사의, 자주빛의
amarelle : n, 몹시 신 양버찌
amaryllis : n, 아마릴리스
amass : vt, 다, 모으다, 저축하다
amateur : n, a, 아마추어, 비직업적인, 취미의
amateurish : a, 아마추어 같은, 전문적이 못되는, 서투른
amateurism : n, 아마추어 솜씨, 도락, (스포츠의)아마추어의 자격(규정)
amative : a, 연애의
amatol : n, 아마톨 폭약(질산 암모늄과 TNT화약을 혼합한)
amatory : a, 연애의, 호색적인
amaurosis : n, 흑내장
amaurosis : n, 흑내장
amaze : vt, 깜짝 놀라게 하다, 놀래다, 경이감을 품게 하다
amazed : a, 놀란
amazedly : ad, 몹시 놀라서
amazement : n, 놀람, 소스라침
amazing : a, 놀랄 만한, 굉장한
Amazon : n, 아마존강, 그리스 전설에 나오는 흑해 부근에 있던 용감한 여장부
Amazonian : a, 아마존강의, 아마존 강 유역(지방)의, 용맹한, 여장부 같은, 남자 못지 않은
amazonite : n, 천하석, 아마조나이트(녹색 장석의 일종)
ambages : n, 우회적인 길(말, 방법)
ambagious : a, 굽이굽이 돈, 우회적인, 에두른
ambassador : n, 대사, 사절
ambassadoratlarge : n, 무임소 대사, 특사
ambassadorial : a, 대사의, 사절의
ambassadress : n, 여자 대사(사절), 대사부인
amber : a, 호박
ambergris : n, 용연향(향유고래의 장에서 얻는 향료의 원료)
amberite : n, 앰버라이트(입상 무연 화약)
amberjack : n, 방어류
amberoid : n, 인조 호박
ambi : pref, 양쪽, 둘레)따위의 뜻
ambidexter : n, 양수 잡이, 두 마음이 있는 사람
ambidexterity : n, 양수잡이, 비범한 손재주, 표리 부동
ambidextrous : a, 양수잡이의, 교묘한, 두 마음을 품은
ambience : n, 환경, (장소의)분위기
ambient : a, 주위의, 주위를 둘러싸는
ambiguiy : n, 애매함, 다의, 애매한 말
ambiguous : a, 두 가지 뜻으로 해석할 수 있는(cquivo-cal)모호한
ambisextrous : a, 남녀 구별이 어려운(복장), 남녀 혼합의 모임
ambisexual : a, n, 양성의, 양성애의, 양성애자
ambit : n, 주위, 범위, 경계
ambitendency : n, 서로 상반되는 경향의 공존
ambition : n, 야심, 대망, 야심의 대상, 패기
ambitious : a, 야심적인, 대망이 있는
ambivalence : n, 양면 가치(동일 대상에 대한 애증 병존)
ambivalent : a, 서로 용납하지 않는, 상극인, 양면 가치의
ambiversion : n, 양향 성격(내향성과 외향성의 중간 성격)
ambivert : n, 양향성 성격자
amble : n, vi, 측대걸음(같은 쪽의 양발을 한 쪽씩 동시에 들고 걷는 느린 걸음)으로 걷다, 완보하다
ambler : n, 측대보로 걷는 말, 느리게 걷는 사람
ambling : a, 느린 걸음걸이의
amblyopia : n, 약시
ambo : n, (초기 기독교회의)설교단, 낭독대
amboceptor : n, 양수체
Amboina : n, 암보이나(인도네시아 Molucca 제도 중위 섬), 암보이나 (항) (그 섬에 있는 해항)
ambrosia : n, 신의 음식, 대단히 맛있는것
ambrosial : a, 맛있는, 향기로운, 거룩한
ambrotype : n, 유리판 사진
ambry : n, 찬장(cupboard), (교회의)성기장
ambsace : n, 따라 지탱(주사위 두 개를 던져 둘 다끗임), 최하점, 무가치, 불운
ambulance : n, 상병자 운반차, 구급차, 야전 병원
ambulance chaser : x, 사고의 피해자를 부추겨 소송을 제기케 하여 돈벌이하는 변호사, 악덕변호사
ambulant : a, 보행하는
ambulate : vt, 걸어다니다, 이동하다
ambulation : n, 보행, 이동
ambulatory : a, 보행의, 보행용의, 이동성의, 일시적인
ambush : n, 매복, 잠복, 복병, 매복장소
amebiasis : n, 아메바증
Amelia : n, 여자 이름
ameliorable : a, 개량(개선)할 수 있는
ameliorate : vt, 개량하다, 개선하다
amelioration : n, 개량, 개선, 개수, 향상
ameliorative : a, 개량의, 개선적인
ameliorator : n, 개량자
amen : n, 아멘(기독교에서 기도 끝에 하는 말)
amenability : n, 복종할 의무, 기꺼이 복종함, 순종
amenable : a, 복종해야 할, ...을 받아들이는
amend : vt, vi, (행실 등을)고치다, (의안 등을)수정하다, 고쳐지다, 개심하다
amendable : a, 수정할 수 잇는, 수정의 여지가 있는
amendatory : a, 개정의, 수정의
amendment : n, 개정, 수정(안), 개심
amends : n, pl, 보상, (...에게 ...을)배상하다, 보상하다(make up)
amenity : n, 호감을 줌, 온아함
amenorrhea : n, 무월경, 월경 불순
ament : n, (선천성)정신 박약자
ament : n, 꼬리꽃차례(catkin)
amentia : n, (선천성)정신 박약
Amerasian : n, a, 미국인과 동양인의 튀기(의)
amerce : vt, ...에게 얼마의 벌금을 과하다, 벌하다
amerciable : a, 벌금을 과할 수 있는
AmerEnglish : n, 미국 영어
America : n, 아메리카, 미합중국, 미국
American : a, 아메리카의, 아메리카 사람의, 아메리카 원주민의, 미합중국의
Americana : n, 아메리카에 관한 문헌, 아메리카의 풍물, 아메리카지
American aloe : x, 용설란
American Beauty : x, 붉은장미의 일종
American cloth : x, 광택있는 유포
American dream : x, 아메리카의 꿈
American eagle : x, 흰머리수리, 미국의 문장
American English : x, 미국영어, 미어
American football : x, 미식축구
American Indian : x, 아메리카토인
Americanist : n, 미국 기질(정신), 친미주의, 미국 특유의 말
Americanization : n, 미국 귀화, 미국화
Americanize : vt, vi, 아메리카화하다(되다), 미국식으로 하다(이 되다), 미국에 귀화시키다(하다)
Americanologist : n, 미국 정책 연구가, 미국 정치통
Americanophile : n, 친미파의 사람
Americanophobia : n, 미국을 싫어함(두려워 함)
americium : n, 아메리슘(  방사성 원소, 기호Am, 번호95)
Amerika : n, 파쇼적 미국, 인종 차별 사회인 미국
Amerind : n, a, 아메리카 원주민(인디언 또는 에스키모인)
Amerindian : n, a, 아메리카 원주민(의)
amethopterin : n, 아메톱테린(면역 억제제, 제암제)
amethyst : n, 자석영, 자수정, 자주색(purple)
amethystine : a, 자수정의(과 같은)
ametropia : n, 비정시안, 굴절 이상(증) (난시, 원시, 근시 등)
ametropic : a, 비정시안(굴절 이상)의
Amhara : n, 암하라(에티오피아 북서부의 주의 구칭, 옛 왕국)
Amharic : n, a, 암하라 말(의) (에티오피아의 공용어)
amiability : n, 사랑스러움, 상냥함, 온화, 온후
amiable : a, n, 붙임성 있는, 귀염성 있는, 마음씨 고운, 상냥한, 온화한
amianthus : n, 석면(asbestos)의 일종
amic : a, 아미드의, 아민의
amicability : n, 우호, 친선, 화친, 친선 행위
amicable : a, 우호적인, 평화적인, 타협적인, 유쾌한
amice : n, 개두포(옛날 승려의)털모자, (프랑스의 canon의) 왼팔 완장
amid : prep, ...의 한 복판에, ...이 한창일 때
amide : n, 아미드
amidol : n, 아미돌(사진 현상약)
amidone : ad, 배 복판에, 중앙에
amidship : ad, 배의
amigo : n, 친구, 스페인어권의 친미적인 사람
amimia : n, (뇌질환에 의한)무표정증
amine : n, 아민
aminobenzoic acid : x, 아미노안식향산
aminophylline : n, 아미노필린(이뇨제, 혈관 확장제)
aminopterin : n, 아미놉테린(백혈병 치료제)
aminopyrine : n, 아미노피린(해열 진통제)
aminotriazole : n, 아미노트리아졸(제초제)
Amish : a, n, 아미시
amiss : a, ...이 적절하지 않은, 형편이 나쁜, 고장난, 잘못한
Amitabha : n, 아미타, 불교에서 쓰는 용어
amitosis : n, 무사분열
amity : n, 침목, 친화
Amman : n, 암만(Jordan 왕국의 수도)
ammeter : n, 전류계
Ammon : n, 아몬(고대 이집트의 태양신)
ammonal : n, 암모날(강력폭약)
ammonia : n, 암모니아
ammoniac : n, 암모니아고무
ammoniacal : a, 암모니아의(와 같은), 암모니아를 포함하는
ammoniate : vt, n, 암모니아와 화합시키다, 암모니아 화합물
ammonite : n, 암몬조개, 국석
ammonium : n, 암모늄(암모니아 염기)
ammono : a, 암모니아의, 암모니아 유도체의
ammunition : n, 탄약, 공격(방어)수단
amnesia : n, 기억력 상실(증), 건망증
amnestic : a, 건망증의
amnesty : n, 은사, 대사, 특사
amnighraphy : n, 양막조영법
amniocentesis : n, 양막천자
amnion : n, 양막(태아를 싸는)
amnioscope : n, 양수경
amnioscopy : n, 양수경 검사(법)
amniotic : a, 양막이 있는
amoeba : n, 아메바
amoebean : a, (시 등이)대화체의, 문답체의
amoebiasis : n, 아메바증
amoebic : n, 아메바의(같은), desentery아메바 적리
amoebocyte : n, 변형유주 세포
amoeboid : a, 아메바 모양의
amok : n, 광열병
among : prep, ...의 사이에, 의 가운데서, 에 둘러싸여
amontilado : n, 아몬틸라도(스페인산의 셰리술)
amoral : a, 초도덕의, 도덕에 관계 없는
amorce : n, 장난감 권총의 뇌관, 기폭제, 도화선
amorist : n, 호색꾼, 연애 유희자, 연애 문학 작가
amorous : a, 호색의, 연애의, 연애를(사랑을)하고 있는, 사라을 표시하는, 요염한
amorphism : n, 무형 무정형 비결정, 무조직
amorphous : a, 무형의, 비결정의, 무조직의
amort : a, 죽은 듯한, 원기(활기)없는, 이기소침한
amortization : n, (감채 기금에 의한)할부 변제금
amortize : vt, (감채기금으로)상각하다(부동산을)법인에게 양도하다
Amos : n, 아모스(히브리의 예언자)
amount : vi, n, 총계...이 되다(to), 결(..과)같다-합계, 총액(sum total), 양 결국, 원리 합계
amour : n, 연애, 정사
amourette : n, 한때의(잠깐)정사, 바람(연애)상대자(여자)
amourpropre : n, 자존심, 자부심
Amoy : n, 아모이
ampelopsis : n, 담쟁이덩굴류의 식물
amperage : n, 암페
ampere : n, 암페어
amperehour : n, 암페어시
amperemeter : n, 전류계
ampersand : n, (and)의 명칭
amperturn : n, 암페어 횟수
amphetamine : n, 암페타인(충추 신경을 자극하는 각성제)
amphi : x, 두가지, 양...
amphiaster : n, 쌍성상체(유사핵분열에서 비염색질의 방추체가 성상체를 가진 상태)
Amphibia : n, 양서류
amphibian : a, 양서류의, 수륙 양용의
amphibiology : n, 양서류학(론)
amphibious : a, 양서의, 수륙 양용의, 육해공군 공동의, 상륙작전의
amphiblous : a, 두 가지로 해석되는, 뜻이 모호한
amphibole : n, 각섬석
amphibolic : a, 각섬석의, 모호한, 불분명한, 불안정한
amphibology : a, 글귀의 모호함, 모호한 어법(어구, 어문)
amphibrach : n, 약강약격
amphicar : n, 수륙 양용 자동차
amphictyon : n, 인보 동맹 회의의 대의원
amphictyony : n, 인보 동맹, 근린 동맹
amphigamous : a, (식물이)뚜렷한 자웅기를 가지지 않은
amphigory : n, 무의미한 문장
amphimixis : n, 양성 환합, 교배
amphioxus : n, 활유어
Amphipod : n, 단각목의 (동물)
amphiprostyle : a, 양면 주랑식의(건물)
amphisbaena : n, (전설적인)쌍두의 뱀(몸통 앞뒤에 머리가 있어 전후로 움직일 수 있음)
amphistylar : a, 2주식(양주식)의
amphitheater : n, (고대 로마의)원형 극장(경기장), (극장의)계단식 관람석, 계단 교실
amphitheatric : a, 원형 극장(식)의
Amphitrite : n, 암피트리테, 바다의 여신
Amphitryon : n, 암피트리온(Alcmene의 남편), (접대하는)주인역, 접대역
amphora : n, 그리스, 로마시대의 족자리 둘 달린 긴 항아리
amphoric : a, 공동음의
amphoteric : a, 쌍방에 작용하는, (산성과 염기성의)양쪽 성질을 가지고 있는
ampicillin : n, 암피실린(페니실린 비슷한 항생물질)
ample : a, 넓은, 광대한, 풍부한, 충분한
amplexicaul : a, 포경형의, (잎이)줄기를 감싸고 있는
amplidyne : n, 앰플리다인(계자 전류를 변화시켜 출력을 변화시키는 직류 발전기)
amplification : n, 확대, 배율, 증폭, 확충, 부연
amplificatory : a, 확충(부연)적인
amplifier : n, 확대하는 물건(사람), 확대경, 증폭기
amplify : vt, vi, 넓게하다, 넓어지다, 확대하다, (학설을)부연하다
amplitude : n, 폭, 넓이, 크기, 풍부함, 충분, 진폭
amplitude modulation : x, 진폭변조
amply : ad, 충분히, 널히
ampoule : n, 앰풀(주사액 넣은)
ampulla : n, (고대 로마의) 양손잡이가 달린 병, 앰풀
ampullaceous : a, 단지(병)모양의
amputate : vt, 절단하다
amputation : n, 자름, 절단(수술)
amputator : n, 절단 수술자, 절단기
amputee : n, (수족의)절단 수술을 받은 사람
amrit : n, (인도 신화의)불로불사의 음료, 감로, 불로불사
Amsterdam : n, 네델란드의 수도
amtrac : n, 수륙 양용차
Amtrak : n, 앰트랙(전미국 철도여객 수송공사의 애칭)
amuck : ad, 미친 듯이 날뛰어(run~ 함부로 날뛰다(설치다)
amulet : n, 부적
amuse : vt, 즐겁게(재미있게 하다), 위안하다(~oneself 즐기다, 놀다)
amused : a, 즐기는, 명랑한, 즐거워 하는
amusedly : ad, 재미나서, 즐거웁게
amusement : n, 위안, 즐거움, 재미, 재미로 하는 것, 오락
amusia : n, 실 음악(증), 음치
amusing : a, 재미나는, 즐거운, 우스운
amusive : a, =AMUSING
Amy : n, 여자 이름
amygdala : n, 편도류, 복숭아류
amygdalic : a, 편도의, 아미그달린의
amygdalin : n, 아미그달린(살구 등의 씨에 있는 배당체)
amygdaloid : n, 행인상 용암
amygdaloidal : a, 행인상 용암의, 편도 모양의, 아몬드형의
amyl : n, 아밀
amylaceous : a, 전분성의, 녹말 같은
amylase : n, 아밀라제
amyloid : n, 아밀로이드, 유전분체
amylopectin : n, 아밀로펙틴(전분 주성분의 하나)
amylopsin : n, 아밀롭신(녹말 당화소)
amylose : n, 아밀로오스
amylum : n, 전분, 족말, 밀의 녹말
Amytal : n, 아미탈(진정제, 상표명)
an : indef, 
an.nor.ni.ty : n, 이상, 변칙, 변태, 기형
anabaptism : n, 재침례, 재세례, 재세례교
anabaptist : n, 재침례파
anabas : n, 아나바스
anabasis : n, (내륙으로의)진군, 원정, 병세악화
anabatic : a, 상승의
anabiosis : n, 소생
anabolism : n, 동화작용
anabranch : n, (본류에 다시 합류하는)지류
anachronic : a, =ANACHRONISTIC
anachronism : n, 시대착오
anachronous : a, =ANACHRONISTIC
anaclastic : a, 굴절성
anaclastic : a, 굴절(성)의
anacoluthon : n, 파격 구문
anaconda : n, 아나콘다 뱀
Anacreon : n, 그리스의 서정 시인
Anacreontic : a, n, (고대 그리스의)아나크레온풍의 시
anacrusis : n, 행수 잉여음(행의 첫머리에 파격으로 덧붙인 하나 또는 두 개의 약한 음질)
anaculture : n, 약독 세균 배양, 애너컬쳐(세균 발육 가능한 배양기 전부를 포르말린으로 처리한 것)
anadem : n, 화환, 화관(여성의 머리를 꾸미는)
anadromous : n, (고기가)소하성의(연어따위)
anaemia : x, =anemia, anemic
anaerobe : n, 혐기성생물
anaesthesia : n, =anesthesia
anaesthetic : n, =ANESTHETIC
anaesthetist : a, n, =ANESTHETIST
anaesthetize : vt, =ANESTHETIZE
anaglyph : n, 얕은 돋을새김, 입체 사진
anagoge : n, (성서 어구 등의)신비적(영적)해석
anagogic : a, (성서 어구 등의)신비적(영적)해석의, (무의식적인)이상(덕성)추구의
anagram : n, 글자바꿈수수께끼
anagrammatic : a, 어구의 철자 바꾸기(놀이)의, 철자를 바꾼 어구의
anagrammatism : n, 어구의 철자 바꾸기
anagrammatize : vt, (어구의 철자를)바꾸어 다른 말로 만들다
anal : a, 항문의, 항문부근의
analects : n, 어록
analeptic : a, n, 체력(기력)회복의, 몸을 보하는, 강장제, (중추)흥분제
analgesia : n, 무통각증
analgesic : a, 진통의, 진통제
anality : n, (심리적 특질로서의)항문애
analog computer : x, 아날로그 계산기, 상사형 전자 계산기
analog computer : x, 아나로그계산기, 상사형계산기
analogic : a, 유사한, 유추의
analogical : a, 유사한, 유추적인
analogism : n, 유추 추리, 추론, 유추 진단
analogize : vt, 유추하다, 유추에 의해 설명하다, 유사하다
analogous : a, 유사한, 상사의
analogue : n, 유사물, 상사기관
analogy : n, 유사, 유추
analphabetic : a, 알파벳 순이 아닌, 알파벳 문자에 의하지 않은, 읽고 쓰지 못하는, 문뱅의
analysand : n, 정신부석을받는사람
analyse : v, 
analysis : n, 분석, 해석, 분해
analyst : n, 분석자, 분해자, 해석학자, 정신분석학자, 경제분석가
analytic : a, 분석의, 분석적인, 해석적인, 분해의, 해석의
analytical chemistry : x, 분석화학
analytical geometry : x, 해석기하학
analytics : n, 분석학, 분석론
analyzability : n, 분석 가능성
analyzable : a, 분해(분석, 해부)할 수 있는
analyzation : n, 분석, 분해, 해석, 해부
analyze : vt, 분석하다, 분해하다, 해석하다
analyzer : n, 분석하는사람
anamnesis : n, 회상, 생전의추억, 환자의병력
anamorphic : a, 일그러져 보이는 상의, 왜상의
anamorphosis : n, 왜상, 기형, 변체, 점변진화
ananas : n, 아나나스, 파인애플
anandrous : a, 수술이 없는
Ananias : n, 아나니아(거짓말을 하여 벌받아 죽은 남자), 거짓말장이
anapest : n, 단단장격, 약약강격
anapestic : a, 약약강(단단장)격의
anaphase : n, (핵분열의)후기
anaphora : n, 수어반복(반복을 피하기 위한 대명사, 대동사 등의)대용어
anaphoric : a, 성찬식의, 전방조응의
anaphrodisiac : a, n, 성욕억제의
anaphylactic : a, n, 성욕을 억제하는, 성욕 억제제
anaphylaxis : a, 과민증(과님성)의, 아나필락시스의
anaplasia : n, 퇴화
anaplastic : a, 성형(수술)의, (세포가)퇴화하는, 미분화의(암)
anaplasty : n, 성형수술
anarak : n, =anorak
anarch : n, =anorchist
anarchic : a, 무정부(상태)의, 무질서의, 무정부주의의
anarchism : n, 무정부주의, 무질서, 테러행위, 무정부상태의
anarchistic : a, 무정부주의(자)의
anarcho : n, 무정부주의, 아나키스트
anarchosyndicalism : n, 무정부주의에 기초를 둔 노동조합 운동 사상
anarchy : n, 무정부, 사회의무질서, 혼란
anarthria : n, 구어 장애, 실구어증(뇌장애로 인한)
anarthrous : a, 관절이 없는, 무절지의, (그리스)무관사의
anasarca : n, 전신 부종
anastatic : a, 철판의, =ANABOLIC
anastigmat : n, 무수차렌즈
anastigmatic : a, 비점수차를 보정한
anastomose : vi, 문합하다
anastomosis : n, 문합, 동맥의 문합, 교차연락, 강의교류
anastrophe : n, 도치법
anathema : n, 파문, 저주, 파문, 저주받은물건
anathematic : a, 저주할, 혐오할, 증오에 찬
anathematization : n, 비난, 저주, 파문
anathematize : vt, 저주하다, 파문하다
Anatolia : n, 아나톨리아, 옛날의 소아시아, 현재의 아시아 터키
Anatolian : a, n, 아나톨리아의, 아나톨리아 사람(말)의, 아나톨리아 사람(말)
anatomic : a, 해부의, 해부(학)상의
anatomist : n, 해부학자, 분석학자
anatomize : a, 해부하다, 분석하다
anatomy : n, 해부, 분석, 구조
anatoxin : n, 아나톡신
anbury : n, (마소의)연종, 근경 비대증
ancestor : n, 조상
ancestral : a, 조상의, 조상전래의
ancestress : n, 여자 조상
ancestry : n, (집합적)선조, 조상, 계통, 문벌
Anchises : n, 안키세스(그리스 신화에서 아들 Aeneas에 의해 불길에 싸인 Troy에서 구출됨)
anchor : n, 닻, 힘이되는 것(릴레이의)최종 주자
anchorage : n, 닻을 내림, 투묘, 정박, 정신적 의지, 은자의 주거, 은둔처
anchored : a, 닻을 내린, (표적구가)서로 가까이 모여 있는
anchoress : n, 여은자
anchoret : n, 은자, 속세를 떠난 사람
anchorhold : n, 닻의 박힘, 닻이 걸리는 곳, 안전
anchorite : n, 은자, 은둔자
anchoritic : a, 은자의(와 같은), 은둔적인
anchorman : n, 중심인물, 최종주자, 방송앵커맨
anchorpeople : n, pl, =ANCHORPERSONS
anchorperson : n, (뉴스 프로의)종합 사회자
anchorwoman : n, (뉴스 프로의)여성 종합 사회자
anchovy : n, 안초비
anchusa : n, 지치과
ancienne noblesse : x, 구귀족
ancienregime : n, 구제도(혁명이전의 프랑스의정치, 사회조직)
ancient : a, n, 고대의, 옛날의, 고래의, 늙은(very old), 기수
ancient history : x, 고대사, 주지의사실
ancient lights : x, 채광권(법)
ancientry : n, 고풍, 고대 양식, 고대, 먼 옛날
ancilla : n, 부속물, 도움이 되는 것, 시녀, 하녀
ancillary : a, 보조의
ancon : n, 팔꿈치, 첨차
anconeal : a, 첨차의, 팔꿈치의
ancy : a, ...한 성질(상태)의
ancylostomiasis : n, 십이지장충증
and : conj, 그리고, 및, 또한, 그러자, 그러면, (and/or=and or(newspapers and/or magazines 신문 및 또는 잡지)
Andalusian : n, 안달루시아(스페인 남부의 지방, 옛 More 문명 중 심지)
andalusite : n, 홍주석
andante : a, 안단테(보통빠르기)의, 안단테의 곡
andantino : a, ad, n, 안단티노, 안단텝보다 좀 빠른 속도
andean : a, n, 안데스산맥의, 안데스사람
andersen : a, n, 덴마크동화작가
andes : n, 안데스산맥
andesite : n, 안산암
andiron : n, 철제장작받침
Andorra : n, 안도라(프랑스, 스웨덴국경에있는공화국, 수도)
andragogy : n, 성인 교육학(법)
Andrew : n, 남자 이름(애칭), 안드레(그리스도 12사도 중의 한 사람)
androcentric : a, 남성 중심의
Androcles : n, 안드로클레스(로마 전설 중의 노예, 예전에 구해준 사자와 원형경기장에서 재회함)
androecium : n, 수꽃술군
androgen : n, 안드로겐(남성 호르몬)
androgenesis : n, 웅성(웅핵)발생, 동정 생식(단위 생식의 하나)
androgenize : vt, (남성 호르몬을 주사하여)남성화 하다
androgenous : a, 웅성 자손 산출의
androgyne : n, 남녀 양성 구유자, 반음양, 여성적인 남자, 자웅 동화서
androgynous : a, 자웅화동체의, 남녀추니의, 양성의
androgyny : n, (남녀)양성을 지님, (동일 화서내의)자웅 동주, 남녀 공용 의상
android : n, 인간모양의 로봇
andrology : n, 남성병학, 남성과학
Andromache : n, 안드로마케(Hector의 정숙한 아내)
Andromeda : n, 안드로메다자리, 바다괴물의 산 제물이 될 뻔한 것을 구조된 이디오피아 공주, 이디오피아 자리
androsphinx : n, 머리가 남자인 스핑크스(보통은 여자의 머리임)
androsterone : n, 남성호르몬의일종
anecdotage : n, 일화집, (dotage와 결부시켜)옛이야기하고싶어하는나이
anecdotal : a, 일화의, 일화거리가 많은
anecdotalism : n, 일화주의, 일화적 방법을 즐겨 쓰기
anecdote : n, 일화, 기담
anecdotic : a, 일화적인, 일화 같은, 일화가 많은
anecdotist : n, 일화를 이야기 하는 사람, 일화 수집가
anechoic : a, 무반항의, 소리없는
anele : vt, 임종의 성유를 바르다
anemia : n, 빈혈증
anemic : a, 빈혈(증)의
anemochore : n, 풍매 식물
anemograph : n, 자기풍속계
anemometer : n, 풍력계
anemometry : n, 풍력 측정법
anemone : n, 아네모네;말미잘
anemonetric : a, 풍력 측정의
anemophilous : a, 풍매의
anemoscope : n, 풍향 측정가, 풍향계
anencephaly : n, 무뇌증
anent : prep, 에관하여, 의곁에
anergy : n, 아네르기, 무력 체질, 정력 결핍, 면역성 결여
aneroid : a, n, 무액의, 액체를이용하지않는-아네로이드 무액 청우계
anesthesia : n, 마취
anesthesiology : n, 마취약
anesthetic : a, n, 마취의, 마취제
anesthetist : n, (수술할 때)마취사
anesthetization : n, 마취(법), 마취 상태
anesthetize : vt, 마취를 걸다, 마비시키다
anestrous : a, 발정이 없는, 발정 휴지기의
anestrus : n, 비발정기, 발정 휴지기
aneuploid : a, n, (염색체가)이수서의, 이수체
aneurysm : n, 동맥류
aneurysmal : a, 동맥류의
anew : ad, 새로이, 다시, 재차
anfractuous : a, 굴곡이 많은, 구불구불한 길(수로)
anfractusity : n, 굴곡(상태)
anga : n, (요가의)행법
angary : n, 전시수용권(교전국이 군사적 필요로 중립국의 재산을 수용할 수 있는 권리, 전후 완전 배상의 의무가 잇음)
angel : n, 천사(같은 사람), 영국의옛금화, (배우, 극장등의)재정적후원자
Angela : n, 여자 이름
angel cake : x, 힌카스테라의일종
Angeleno : n, 로스앤젤레스 주민
angelfish : n, 전자리상어(angelshark라고도 함), 에인젤피시
angelic : a, 천사의, 천사같은
angelica : n, 안젤리카(멧두릅속의 식물, 요리, 약용), 그 줄기의 설텅절임, (안젤리카로 맛을 낸)일종의 리큐르술
Angelina : n, 여자 이름
angelolatry : n, 천사 숭배
angelology : n, 천사론(학), 천사 신앙
angelus : n, 도고기도, 시간을알리는종(아침, 오정, 해질녘에 울림)
anger : n, vt, 노염, 성, 화
Angevin : a, n, Anjou지방의 사람, Anjou 왕가의 사람(영국왕Henry2dptju Richard2까지)
angi : n, (혈관, 림프관, 혈관종, 과피)의 뜻
angidemocratic : a, 반민주주의의
angigiitis : n, 맥관염
angihijacking : a, 하이잭 방지의, 비행기의 공중 납치 방지의
Angilles : n, 앤틸리스 열도(서인도 제도의 일부)
angina : n, 인후통, 안기나
angina pectoris : x, 협심증
angiogram : n, 혈관 촬영(조영)도
angiographic : a, 
angiography : n, 혈관 조영법
angioma : n, 혈관종
angiomatous : a, 혈관종의
angiosperm : n, 피자식물
angiospermous : a, 피자 식물의
angiotensin : n, 앤지오텐신(혈액 중에 만들어지는 혈압 상승 물질)
Angkor : n, 앙코르(캄푸치아 북서부의 석조 유적, 크메르 왕조의 수도)
angle : n, vt, 모퉁이, 귀퉁이, 각도, 관점, 견지, (각지게)구부리다, 각을 이루다, 굽다, (보도르르)왜곡하다
angle : n, vt, 낚시, 낚시도구, 낚시질하다, 낚다(~for trout), (ryaygl)
angled : a, 모난, 각이 있는, 각을 이루는
angledozer : n, 사판식불도져
angle iron : x, 앵글철
angleparking : n, 비스듬한 주차
angler : n, 낚시꾼, 아귀
angles : n, 앵글족(5세기겨 영구에 이주한 튜튼 민족)
anglesite : n, 황산연광
anglewise : ad, 각을 이루고, 각 모양으로
angleworm : n, 지렁이, 낚시밥용지렁이
Anglia : n, England의 라틴명
Anglian : a, n, 앵글로족의, 앵글사람, 앵글어
Anglic : n, 앵글릭스(스웨덴의 영어 학자)
Anglican : n, 영국 국교회의, 성공회의
anglican church : x, =church of england
Anglice : ad, 영어로는
Anglicise : vt, 영국식으로 하다, =ANGLICIZE
Anglicism : n, 영국풍
anglicist : n, 영국통, 영어문학자
Anglicization : n, 영국식
Anglicize : vt, vi, 영국화하다, 영어화하다
angling : n, 낚시질
Anglistics : n, 영어학
anglo : a, 영국의, 영국뜻의 결합사
AngloAmerican : a, n, 영미의, 영국계미국인의
AngloCatholic : n, a, 영국 국교회 카톨릭파(의)
AngloCatholicism : n, 영국국교회카톨릭주의
AngloFrench : n, a, 영불의=ANGLO-NORMAN
AngloIndian : a, 영국과 인도의, 영국 혼혈아의, 인도 거주 영국 사람의, 인도 영어의
AngloIrish : a, n, 잉글랜드와 아일랜드(간)의, 영국계 아일랜드 사람, 아일랜드 영어
anglomania : n, 영국심취
Anglomaniac : n, 영국 심취자
AngloNorman : n, (영국 정복후 영국에 이주한)노르만 사람의, 앵글로노르만어
Anglophile : n, 친영파사람
Anglophilia : n, 영국 편애, 영국 숭배
Anglophobe : n, 영국을싫어하는사람, 반영주의자
Anglophobia : n, 영국 혐오, 공영사상
Anglophone : a, n, 영어상용의, 영어외에도 공용어가 있는 나라에서 영어사용자
AngloSaxon : n, a, 앵글로색슨민족, 앵글로색슨의
AngloSaxonism : n, 영국 사람 기질, 앵글로색슨계의 말
Angola : n, 아프리카남서부의 한공화국
angololgy : n, 맥관학
Angora : n, 앙고라고양이(염소, 토끼)
Angostura : n, 앙고스투라(나무)껍질(해열 강장제)
angrily : ad, 노하여, 성나서, 화내어
angry : a, 성난, 성나있는(at, with), 몹시쑤시는(get~성내다)
angst : x, 불안, 염세
angstrom : n, 옹스트롬(파장단위1cm의1억분의 1)
anguine : a, 뱀 같은, 뱀의(snakelike)
anguish : n, 고뇌, 격통(in~괴로와서, 괴로운 나머지)
anguished : a, 고민의, 고뇌에 찬
angular : a, 각이있는, 모난, 말라빠진, 태도가묵뚝뚝한
angularity : n, 모남, 모짐, 묵뚝뚝한
angular momentum : x, 각운동양
angular velocity : x, 각속도
angulate : a, 모가난, ...에 모를 내다
angulation : a, 모서리를 만듦, 모서리가 있는 모양(부분, 부위)
Angus : n, 남자 이름, 사랑과 젊음과 아름다움의 신
anhelation : n, 호흡 촉박
anhinga : n, 뱀가마우지의 일종
anhydride : n, 무수물
anhydrite : n, 무수석고
anhydrous : a, 무수의
aniconic : a, (종교가)우상이 없는, 우상 반대의, 상징적인, 암시적인
ANICS : n, Asian newly industrialized countries 아시아 신흥 공업국(한국, 대만, 홍콩, 싱가포르)
anil : n, 개물깜싸리, 목람, 쪽빛
anile : a, 노파같은, 노망한
anile : a, 노파의
aniline : n, 아닐린
aniline dye : x, 이닐린 물감
anilingus : n, 항문 입맞추기(에 의한) 성감 자극
anility : n, 망령, 노쇠
anilogarithm : n, 진수
anima : n, 영혼, 생명, 재적개성, 남성의여성적요소
animadversion : n, 비평, 비난, 혹평
animadvert : vi, 비평하다, 혹평하다, 비난하다
animal : n, 동물, 짐승, 금수
animal courage : x, 만용
animalcule : x, 극미동물
animalculism : n, (병원체 등의)극미 동물설
animalculum : n, =ANIMALCULE
animal husbandry : x, 축산
animalier : n, 동물 화가(조각가)
animalism : n, 동물적 생활, 동물성, 수성, 수욕주의, 인간 동물설, 수욕주의자
animalistic : a, 동물성의, 수욕주의적인, 동물의 모양을 한
animality : n, 동물성, 수성
animalization : n, 동물화, (음식 등의)동물질화
animalize : vt, 동물화하다, 짐승같이 만들다, (음식을)동물질로 바꾸다
animal kingdom : x, 동물계
animally : ad, 육체적으로
animal magnetism : x, 최면력, 성적매력
animal spirits : x, 생기, 원생
animate : vt, 살리다, 생명을주다, 활기띠게하다, 격려하다
animated : a, 기운찬, 싱싱한, 살아있는
animateur : n, 추진자, 주모자(계획 등의)발기인
animating : a, 생기를 주는, 고무하는
animation : n, 생기, 활발, 만화영화제작, 원기
animatism : n, 자연물의 유의식론(무생물에 의식, 인격을 인정하는 원시 종교)
animato : a, ad, 힘차게, 활발하게
animatograph : n, (초기의)영화 촬영기
animator : n, 생기를 주는 사람(것), 고무자, 만화 제작자
anime : n, 아니메(방향성 수지, 니스의 원료)
animism : n, 물활설
animist : n, 물활론자, 정령 신앙자
animistic : a, 물활론적인
animosity : n, 격심한 증오
animus : n, 의도, 적의
anion : n, 음이온
anise : n, 아니스(지중해 지방의 약초)
aniseed : n, anise의 열매 향료
aniseikonia : n, (두 눈의)부등상시중
anisette : n, 아니스 술
anisogamous : a, 이형 집합의
anisometric : a, 부등의, 부동의, 부등곱의, (결정체가)등축이 아닌
anisomysin : n, 아니소마이신(항 트리코모나스 약)
anisotropic : a, 이방성의
Anita : n, 여자 이름(Anna의 애칭)
Anjou : n, 프랑스 서부의 옛 고령
Ankara : n, 터키의 수도
anker : n, 앙커(네덜란드, 덴마크, 러시아 등의 액량 단의, 약 10갤런), 1앙커 들이 통
ankh : n, 안사타(앙크)십자
ankle : n, 발목
anklebone : n, 복사뼈
ankledeep : ad, a, 발목까지(올라오는)
anklet : n, 발목장식, (여자용의)짧은 양말, 속스
ankylose : vt, vi, (뼈 등)교착시키다, 교착하다, (관절 등)경직되게 하다, 경직 되다
ankylosis : n, 교착, 뼈와 뼈의 교착, (관절의)강직
anlace : n, (끝이 가는 양날의 중세기의)단검
anlage : n, 원기(기관이 될 세포), 소질
anna : n, 아니(인도의 화폐, 1rupee의 16분의 1)
Annabel : n, 여자 이름
annalist : n, 연대기의 편자, 연보작가
annalistic : a, 연대기(편자)의
annals : n, pt, 연대기, 연보, 연감, (학회 따위의)기록, 역사
Annam : n, 안남(Viet Nam의 일부)
Annamese : a, n, 
Annapolis : n, 미국 Maryland 주의 항시(해군사관 학교가 있음)
Annapurna : n, SIVA의 배우 여신, 안나푸르나(히말라야 산맥 북부의 산)
Anne : n, 여자이름, 영국의 여왕
anneal : vt, 달구어 서서히 식히다, 구워넣다, 정신을 단련하다
annelid : n, a, 환충(지렁이, 거머리 따위)
Annelida : n, 환형 동물문
annelidan : a, =ANNELID
annex : vt, n, 부가하다, 추가하다, (영토 따위를)병합하다, 착복하다, 추가물 부록, 중축
annexation : n, 부가, 첨가, (영토의)합병, 부가물, 부록, 부대물
Annie Oakley : x, 무료 입장권(승차권), 우대권
annihilate : vt, 전멸시키다
annihilation : n, 전멸
annihilative : a, 전멸을 초래하는
annihilator : n, 절멸(섬멸)자
anniversary : n, a, 기념일, 축전, 예년의, 기념일의
annlose : a, 고리(마디)가 있는, 환상의, 환상체의
annnexe : n, =ANNEX
annodomini : x, 서기(ad), 나이
annotate : vt, vi, 주석하다
annotation : n, 주석, 주해
annotator : n, 주석자
annouing : a, 성가신, 지리한
announce : vt, 발표하다, 고지하다, 알리다, ~이 왔음을 알리다
announcement : n, 발표
announcer : n, 아나운서
annoy : vt, 성나게하다, 괴롭히다, 속태우다, 당황케하다, 해치다
annoyance : n, 성가심, 약오름, 두통거리, 성가신 일
annual : a, 1년의, 예년의, 매해의, 연1회의, 1년생의
annually : ad, 매년, 1년에 한 번씩
annuitant : n, 연금타는사람
annuity : n, 연금
annul : vt, 무효로하다, 취소하다
annular : a, 고리모양의, 윤형의
annular eclipse : x, 금환식
annulate : a, 고리의, 고리가 달린, 고리 모양의 무늬가 있는
annulet : n, 작은고리, (원주의)고리모양테두리
annulment : n, 취소, 실효, 폐지, (혼인의)무효 선언
annuloid : a, 환상의
annulus : n, 환대
annum : n, 해, 년, 한해
annumciator : n, 고지자(벨 번호)표시기
annunciate : vt, 고지하다
annunciation : n, 통고, 포고, 성수 태고지(천사gabriel이 예수 수태를 알린 3월 25일)
annus mirabilis : n, 경이(재액)의해
anode : n, 양극
anode rays : x, 양극선
anodize : vt, 양극처리다다(금속에)
anodyne : a, n, 진통의, 진통제, 완화물, 기분(감정)을 누구러뜨리는(soothing)
anoia : n, 정신 박약, (특히)백치
anoint : vt, 머리에 기름으 부어 신성하게 하다, 기름을 바르다
anointment : n, 기름 부음, (약제 등의)도포, 문질러 바름
anolyte : n, 양극액, 애노드액
anomalism : n, 변칙(성), 이상한 상태, 예외, 이례
anomalistic : a, 보통과 다른, 예외의, 근점의, 근일(근지)점의
anomalous : a, 변칙의, 이례의, 예외적인, 파격의
anomalous finite : x, 변칙정(형)동사
anomalous verb : x, 변칙동사
anomaly : n, 불규칙, 변칙(irregularity), 이상한 것
anomia : n, 건망성 실어증
anomie : n, 사회규범의 상실상태, (개인의)정신력 허탈 상태
anon : ad, 이내, 얼마안있어, 다시, 언젠가
anonym : n, 가명, 익명자, 작자 불명의 저작
anonymity : n, 익명, 무명, 작자 불명
anonymous : a, 익명의, 작자불명의, 개성없는
anopheles : n, sing
anorak : n, 후드달린 방한용자켓
anorectic : a, 식욕이없는, 식욕을감퇴시키는
anorexia : n, 식욕부진
anorexia nervosa : x, 신경성 식욕 부진
anorexic : a, n, 식욕 부진의, 식욕을 감퇴시키는, 신경성 무식욕증 환자
anorgastic : a, 오르가즘을 얻지 못하는, 성불감증의
anorthite : n, 회장석(사장석의 일종)
anorulatory : a, 배란을 수반치 않는, 무배란(성)의, 배란을 억제하는
anosmia : n, 후각상실
anotherguess : a, 종류가 다른, 다른 모양의
anovulant : n, 배란억제제
anovulation : n, 무배란, 배란 정지
anoxemia : n, 무산소혈증
anoxia : n, 산소결핍
anpn : ad, 이내, (곧)얼마 안 있어, 다시, 언젠가, ever
Anschluss : n, 결합, 합병
anserine : a, 거위의(같은), 어리석은
answer : vi, 대답(회답)하다, 고개를 끄덕여 대답하다
answerable : a, 답할 수 있는, 책임이 있는
answerback : n, 응답(텔레타이프, 컴퓨터의 자동 응답 장치로 송신되는 응답신호)
answerer : n, 회답(해답)자, 답변인
answering : a, 응답(대답)의, 상응(일치)하는
answering pennant : x, (만국 선박 신호의)응답기
ant : n, 개미
Antabuse : n, 알코올에 싫증을 나게 하는 약, 술 끊는 약
antacid : a, 산을중화하는, 제산성의, 산중화제, 제산제
Antaean : a, 초인적인 힘을 가진, 매우 거대한
Antaeus : n, 안타이오스
antagonism : n, 적대, 적개심, 적극적반항
antagonist : n, 적대자, 대립자
antagonistic : a, 상반하는, 적대하는, 대립하는, 반대의
antagonize : vt, 적대하다, 대항하다, 적으로돌리다, 반작용하다, 상쇄하다, (어떤이        약이 딴     약을)중화하다
antalkali : n, 알칼리 중화제
antalkaline : n, a, 알칼리 중화제(의)
Antananarivo : n, 안타나나리보
antaphrodisiac : a, 성욕을 억제하는
antarctic : a, n, 남극의, 남극, 남빙양
Antarctica : n, 남극대륙(남극 주변의 무인 지대)
antarctic circle : x, 남극권
antarctic ocean : x, 남빙양
antarctic pole : x, 남극
antarctic treaty : x, 남극조약(남위 60도 이남의 대륙과 공해의 비군사화, 조사 연구의 자유를 협정)
antares : n, 안타레스(전갈자리의 주성, 붉은 일등 변)
ante : n, (포커의)태우는돈, 돈내다
anteater : n, 개미핥기
antebellum : a, 전전의, 남북전쟁전의, 아방게르의
antebrachial : a, 전박의
antebrachium : n, 전박
antecdssor : n, 전임자, 전소유자
antecede : vt, 에선행하다
antecedence : n, (순서, 시간등이)앞섬, 선행, 선재, (행성의)역행
antecedent : a, 앞서는, 선행의, ...보다 이전의
antechamber : n, (큰방으로 통하는)앞방, 대기실
antechapel : n, 예배당 전실
antechoir : n, (교회의)성가대석앞의 공간
antedate : n, vt, 앞서다, 내다보다, 예상하다, 실제보다도 앞의 날짜
antediluvian : a, n, 노아의홍수이전의(사람, 생물), 시대에뒤진, 노인
antefix : n, (처마 끝의)장식 기와, 막새
anteflexion : n, (특히 자궁)전굴(증)
antelope : n, 영양
antemeridian : a, 오전(중)의, 오전에 일어나는
antemeridiem : n, a, 노아의 홍수 이전의, 시대에뒤진, 노인
antemortem : a, 죽기 전의
antemundane : a, 천지 창조 이전의
antenary : a, 촉각(모양)의, 촉각이 있는
antenatal : a, 출생전의
antenna : n, 안테나, 더듬이, 촉각
antenna circuit : x, 안테나회로
antennal : a, 촉각의
antennate : a, 촉각을 가진, 더듬이가 있는
antennule : n, (새우 등의)작은 촉각
antenuptial : a, 결혼전의
antepaschal : a, 부활절 이전의
antependium : n, (교회의)계단의 앞장식
antepenult : n, a, 어미에서 세번째의 음절, 끝에서 세번째의
antepenultimate : a, n, 끝에서 세번째 음절
anteposition : n, 보통 뒤에 두는 말을 앞에 두는 일, 정상 어순의 역
antepost : a, 경쟁마의 번호가 게시되기 전에 내기를 하는
anteprandial : a, 식사 전의
anterior : a, 전의, 앞의(...에) 앞서는(선행하는), 전면의, 전부의
anteriority : n, 전(앞, 먼저)임, 선재, 앞선 시간(위치)
anteroom : n, =antechamber
anteroposterior : a, 전후 방향의, 복배의
antetype : n, 원형
Anthea : n, 여자 이름
anthelion : x, 의일륜, 반대환일(태양과 정반대 위치의 구름(안개)에 나타나는 광점)
anthelmintic : a, n, 장내의 충을 제거하는, 구충제
anthem : n, 찬미가, 서가, 축하의 노래
anthemion : n, 인동 무늬(인동덩굴을 도안화한 일종의 당초 무늬)
anther : n, 약
antheral : a, 약의, 꽃밥의
antheridirm : n, 웅기, 장정기(고사리 등의)
anthesis : n, 개화(기), 수술의 성숙
anthill : n, 개밋둑, 개미집, 많은 사람이 늘 붐비는 거리(건물)
anthill : x, 개밋둑
anthocarpous : a, 가과의
anthological : a, 시집의, 명시 선집의, 명문집의
anthologize : vt, vi, 명시 선집을 편찬하다, 명시 선집에 수록하다
Anthony : x, 이집트의 은자, 수도원 제도 창시자
anthophore : n, 화피 간주(꽃받침과 꽃잎 사이의 자루)
anthotaxy : n, 꽃차례, 화서
Anthozoa : n, 산호충 무리(산호, 말미잘 등)
anthracene : n, 안트라센
anthracite : n, 무연탄
anthracitic : a, 무연탄의(같은)
anthracitous : a, 무연탄을 함유하는
anthracnose : n, 탄저병
anthracoid : a, 탄저병 같은, 비탈저 같은
anthranilate : n, 안트라닐산 염(에스테르)
anthrax : n, 비탈저, 탄저열, 부스럼
anthrophobia : n, 공포증
anthropic : a, 인류의, 인류 시대의, 인류 발생(발달)론의
anthropo : n, a, 사람, 인류, 인류학의
anthropocentric : a, 인간 중심의(사상, 관점 등)
anthropocentric : a, n, 인간 중심적인, trism 인간 중심주의
anthropocentricism : n, 인간 중심주의
anthropogenesis : n, 인류 발생(기원)론
anthropogenic : a, 인류 발생(론)의, 인위 개변의
anthropography : n, 인류지
anthropoid : a, n, 인간 비슷한, 유인원
anthropoidal : a, 유인원의(같은)
anthropolite : n, 인체 화석
anthropological : a, 인류학의
anthropologist : n, 인류학자
anthropology : n, 인류학
anthropometric : a, 인체 측정학의
anthropometry : n, 인체 측정
anthropomorphism : n, 신인동형동성설
anthropomorphize : vt, (신을)인격화하다, 의인화 하다
anthropomorphous : a, 사람 모양을 한
anthropophagi : n, pt, 식인종
anthropophagous : a, 사람 고기를 먹는, 식인의
anthropophagy : n, 사람을 잡아 먹는 풍습
anthroposophy : n, 인지, 인간성에 대한 지식, 인지학
anthropotomy : n, 인체 해부(학)
anthropozoology : n, 인류 동물학(인간을 동물계의 일종으로 봄)
anti : n, 반대론자
antiabortion : a, 인공 임신 중절에 반대하는
antiageing : a, 노화 방지의
antiair : a, 대 항공의
antiaircraft : a, 대항공기의, 고사의, 방공의
antialcoholism : n, 과음 반대, 절주, 금주
antialien : a, 배외적인, 배타적인
antiallergic : n, 항알레르기의
antiAmerican : n, 반미의, 미국 방침(정책)에 반대하는 사람
antiantibody : n, 항항체
antianxiety : a, 항 불안성의
antiart : a, 반예술의
antiauthoritarian : a, 반권위주의의
antiauthority : a, 반권위의
antibacchius : n, 역버카이어스격
antibacterial : a, 항균성의
antiballistic : a, 대탄도의
antiballisticmissile : n, 탄도탄 요격 미사일
antibiosis : n, 항생 작용
antibiotic : n, a, 상생물질, 항생 물질학
antiblack : a, 흑인에 적대적인, 반 흑인의
antiblastic : a, 세균 발육 억제성의, 항 세균 발육성의
antibody : n, 항독소, (혈액 중의)항체
antibusing : a, 버스 통학을 반대하는(흑인, 백인의 공학을 촉진하기 위한 버스 수송에 대해)
antic : a, n, vi, 이상한, 야릇한, 기괴한(grotesque)-(종종)익살맞은 짓, 어릿광대(clown), 익살떨다
anticancer : a, 제암성의
anticatalyst : n, 항촉매(반응속도를 느리게 하는 촉매), 촉매독(촉매작용을 방해하는 물질)
anticathode : n, (엑스선과의)대음극, (진공간의)양극
antiCatholic : a, 반 천주교주의의
antichlor : n, 염소 제거제
antichrist : n, 그리스도의 적
antichristian : a, n, 예수 반대의, 기독교 반대자
anticiflation : n, 앤티시플레이션(인플레 압력의 발생을 예상한 물가, 임금, 소비 지출의 상승)
anticipant : vt, 예기한, 앞을 내다본, 기대한
anticipate : vt, 예기하다, 예상하다
anticipation : n, 예기, 예상, 미리 씀 앞지름, 예방(in~of, ...을 미리 내다보고)
anticipative : a, 예상의
anticipatory : a, 예상(예기)하고서의, 예상하고(앞질러)하는, 선행하는
antick : a, 모양이 이상한, 괴기한
anticlerical : a, 교권 개입에 반대하는, 바교권적인
anticlimactic : a, 점강적인
anticlimax : n, 점강법(bathos), 용두사미의일, 사건
anticlinal : a, 배사의, 서로 반대쪽으로 경사진
anticline : n, 배사층
anticlockwise : ad, a, =counterclockwise
anticoagulant : a, n, 항응혈약(의)
anticodon : n, 대응 코돈
antiCommunism : n, 반공(산)주의
antiCommunist : a, 반공의
anticonvulsant : a, n, 항경련성의, 항경련제
anticorrosive : a, n, 방식의, 방식제
anticrime : a, 방범의
anticyclone : n, 역풍
anticydlonic : a, 역선풍의, 고기압성의
antidepressant : a, n, 항우울의, 항우울제
antidiphtheritic : a, 항 디프테이라성의, 항 디프테리아제
antidiscrimination : n, a, 인종 차별 반대(의)
antidotal : a, 해독제의, 해독의(효험이 있는)
antidote : n, 해독제, 교정 수단
antidraft : a, 징병 반대의
antidrug : a, 마약 사용을 반대하는, 반 마약의, 마약 방지의
antidumping : a, 덤핑 방지의
antielectron : n, =POSITRON
antiemetic : a, n, 구토방지(억제)작용의, 구토 방지(억제)제
antiestablishment : a, 반체제의
antiestablishmentarian : n, 반체제주의자
anti European : a, 서유럽의 (사회, 경제, 문화적) 통합 반대의, 영국의 EC가맹 반대의
antifebrile : a, n, 해열의, 해열제
antifederal : a, 연방주의에 반대하는
antifemale : a, 여성에 적대적인
antifeminist : a, n, 남성 상위의, 반 여권 확장주의의, 남성 상위주의자
antifertility : a, 불임의, 피임(용)의
antiforeignism : n, 배외사상
antiform : a, 반정형의, 전위적인
antifouling : n, 오염 방지 페인트(배 밑바닥에 동식물이 부착되는 것을 막는 유독 도료)
antifreeze : n, 부동제
antifriction : n, a, 감마재, 윤활재, 마찰을 감소시키는
antifungal : a, 항진균성의, 항균의, 살균용의
antigas : a, 방독용의
antigen : n, 항원(혈액중에 antibody의 형성을 촉진하는 물질)
Antigone : n, 안티고네(Oedipus와 그 어머니 Jocasta와의 사이의 딸)
antigovernment : a, 반정부적인
antigravity : n, a, 반중력, 반중력의
antigropelos : n, 방수 각반
antigsuit : n, 내중력복
antihelicopter : a, 대 헬리콥터용의
antihelix : n, 대이륜
antihero : n, 주인공 답지않은 주인공
antihistamine : n, 항히스타민제(알레르기나 감기 치료용)
antihistaminic : a, 
antihuman : a, 인간에 반항하는, 항인의
antiicer : n, 방빙장치
antiimperialism : n, 반제국주의
antiinflammatoru : a, n, 염증에 효험이 있는, 항염증의, 항염증약
antiintellectualism : n, 반지성주의, 지식인 불신
antiknock : n, 안티녹, 폭연 장지제
antileukemic : a, 항백혈병의, 백혈구의 증가를 억제하는
antilitter : a, 쓰레기 버리기를 금하는
antilogy : n, 자가 당착, 전후 모순
antimacassar : n, 의자덮개
antimagnetic : a, (시계 등)항자성의, 자기 불감의, 자화 방지의
antimalarial : a, n, 말라리아 예방의, 말라리아에 듣는, 말라리아 예방약
antiMarketeer : n, 영국의 EC가맹에 반대하는 사람
antimasque : n, 막간의 광대 놀이
antimatter : n, 반물질
antimicrobial : a, n, 항균성의, 항균제(물질)
antimilitarism : n, 반군국주의
antimissile : a, 미사일방어용의
antimitotic : a, n, 세포 분열 저지성의(물질)
antimonarchical : a, 군주 정치를 반대하는
antimonarchist : n, 군주 정치 반대자
antimonial : a, 안티몬의, 안티몬질의
antimonic : a, 안티몬성의
antimonopoly : a, 독점에 반대하는, 독점 금지의
antimonsoon : n, 반대 계절풍
antimony : n, 안티몬, 안티모니
antinatalism : n, 인구 증가 억제 주의
antinatalist : n, a, 인구 억제 존자, 인구 억제론의
antinational : a, 반국가적인, 국가주의에 반대하는
antiNegro : a, 반흑인의
antineoplastic : a, n, 항 종양성의, 항종양약
antineuralgic : a, n, 항 신경통의, 신경통약
antineutrino : n, 반중성미자
antineutron : n, 반중성자
antinoise : a, 소음 방지의
antinomian : a, n, 도덕률 폐기론자의, 도덕률 폐기론자
antinomianism : n, 도덕률폐기, 신앙 지상론
antinomy : n, 모순, 당착, 이율배반
antinovel : n, 반소설(비전통적인 수법의)
antinuclear : a, 반핵의, 핵무기반대의
antinucleon : n, 반핵자
antinuke : a, =antinuclear
antiobscenity : a, 외설물 단속의, 반외설의
Antiope : n, 앤티오프(프랑스의 문자 다중 방송 시스템)
antioxidant : n, 산화방지제, 노화방지제, (고무등의)노화 방지제
antiparticle : n, 반입자
antipasto : n, 전채, 오르되브르
antipathetic : a, 반감을 가진, 비위에 맞지 않는, 본래부터 싫은, 성미에 안 맞는
antipathic : a, 서로 맞지 않는
antipathy : n, 반감, 진저리냄
antipator : n, 예상자, 예기하는 사람, 선손을 쓰는 사람
antipersonnel : a, 대인살상용의
antiperspirant : a, 발한억제제
antiphlogistic : a, n, 염증을고치는, 소염제
Antiphlogistine : n, 소염고(상표명)
antiphon : n, 응답송가, (번갈아 부르는)교송가
antiphonal : a, 번갈아(노래)부르는
antiphonary : n, 교창(성가)집
antiphrasis : n, 어의반용
antipodal : a, 대척지, 대척적인, 정반대의
antipode : n, 정반대의
antipodean : a, n, 대척지의, 정반대쪽 주민의, 대척지 주민
antipodes : n, 대척지, 정반대의일
antipole : n, 반대의극, 정반대의것
antipolitics : n, 반정치
antipollution : n, a, 공해방지의
antipope : n, (정통의 로마 교황에 대립하는) 대립 교황
antipoverty : n, a, 빈곤 퇴치(의)
antiprostitution : a, 매춘 금지의
antiproton : n, 반양자
antipsychotic : a, n, 정신병에 효험 있는, 정신병 치료약, 항정신병약
antipyretic : a, n, 해열의, 해열제
antipyrin : n, 안티피린, 해열진통제
antiquarian : n, a, 고물연구, 고물연구의
antiquarianize : vi, 골동품 수집에 몰두하다
antiquary : n, 고물연구가, 고물 또는 골동 수집가
antiquate : vt, 낡게하다, 시대에 뒤지게 하다
antiquated : a, 낡은, 고풍의
antique : a, n, 고풍의, 낡은, 고대로부터의, 고물, 고기, 안티크체의 활자
antiquity : n, 낡음, 오래됨, 고대, 고대사람들, 고대의풍습
antirabic : a, 공수병 예방(치료)의
antirachitic : a, 구류병 치료의
antiracism : n, 인종 차별 반대주의
antiriot : a, 폭동 진압(방지)의
antiroman : n, 반소설
antirrhinum : n, 금붕어 꽃, 금어초
antirust : a, n, 녹슬지 않는, 녹슬지 않게 하는, 녹 방지제
antisabbatarian : a, 안식일 지키는 것을 반대하는
antisaloon : a, 주류 판매 반대의
antisatellite : n, 군사 위성을 공격하는, 군사(공격) 위성
antiscience : a, n, 인간성을 무시한 과학에 반대하는, 반과학(주)의
antiscorbutic : a, 괴혈병 치료의
antiscriptural : a, 성서에 반대하는
antiSemite : n, 반유대주의자
antiSemitic : a, 셈의, 유태주의의
antiSemitism : n, 셈족배척, 유태인배척운동
antisepsis : n, 방부(법), 소독(법)
antiseptic : a, n, 방부의, 방부제의
antisepticize : vt, 방부처리 하다
antiserum : n, 항혈청
antisex : a, 성해위나 성의 표현에 반대하는
antisexist : a, 여성차별(sexism)반대의
antiskid : a, 미끄럼 방지의
antiskyjacking : a, 비행기 납치 방지의
antislavery : n, a, 노예제도반대의
antismog : a, 스모그방지의
antismoking : a, 금연을 지향하는, 흡연에 반대하는
antismut : a, 포르노 금지를 목적으로 하는
antisocial : a, n, 반사회적인, 사교를싫어하는, ist 반사회주의자, 비사교가
antiSovietism : n, 반소주의(동유럽 여러 나라에서의 반소련 운동)
antispasmodic : a, n, 경련을 멈추는, 진경제
antistatic : a, 대전 방지의(직물 등)
antistrophe : n, 응답 가장, 대조 악절, 역용논법
antisubmarine : a, 대잠수함의
antisubversive : a, 파괴활동 방지의
antitank : a, 대전차용의
antitechnology : n, 반기술, 과학 기술 만능주의 반대
antiterrorist : a, 테러에 대항하는, 반테러리즘의
antitheism : n, 반유신론
antithesis : n, 정반대의, 대조, 대조법
antithetical : a, 대조되는, 대조를 이룬, 정반대의
antitoxic : a, 항독소의
antitoxin : n, 항독소
antitrade : n, 반대무역풍, 역항풍
antiTrinitarian : a, n, 삼위 일체론 반대의(사람)
antitrust : a, 트러스트반대의
antitumor : a, 제암성의, 항종양성의
antitussive : a, n, 기침을 억제하는, 진해제, 기침약
antitype : a, 대형의
antiunion : a, 노동 조합 반대의
antiuniverse : n, 반우주
antivenin : n, 항사독소, 사독 혈청
antiversity : n, 반대학
antivice : a, 매춘 반대의
antiviral : a, 항바이러스의
antivitamin : n, 항비타민(물), 비타민 파괴물
antivivisection : n, 생체 해부 반대
antiwar : a, 반전의
antiwhite : a, 반백인의
antiworld : n, 반세계
antler : n, 가지진 뿔, 사슴의 가지진 뿔
ant lion : x, 개미귀신
antogestion : n, (근로자 대표등에 의한 공장 등의)자주적 관리
Antoinette : n, 앙트아네트, 루이 14세의  왕비로서      프랑스혁명 때 처형당함
Antonia : n, 여자 이름
Antonio : n, 남자 이름
Antony : n, 남자 이름, 안토니우스
antonym : n, 반의어
Antoon : n, 남자 이름
Antowerp : n, 벨기에의 주, 그 주의 항구 도시
antre : n, 동굴(cavern)
Antrim : n, 앤트림(북아일랜드 북동부의 주)
antrum : n, (뼈의)공동
antsy : a, 초조한, 침착성이 없는
antu : n, 안투(회색의 쥐약)
Anura : n, 무미류
anuran : a, 무미류(동물)의
anuresis : n, 요폐, 무뇨(증)
anurous : a, (개구리 등)무미의
anus : n, 항문
ANVETS : n, 제 2차 세계 대전 미국 제향 군인회
anvil : n, (대장간용의)모루, (on the~ 심의(준비)중에
anxiety : n, 근심, 걱정, 열망(eager desire), 불안, 걱정거리
anxiolytic : a, n, 불안을 완화하는, 불안 완화제
anxious : a, 걱정스러운, 열망하는, 불안한, ...하고 싶어하는(for, to do)
anxiously : ad, 걱정스럽게
any : a, ad, 무엇이나, 누구든, 얼마든지, 누군가, 아무것도, 아무도, 조금도, 얼마간은 조금은, 조금이라도(~longer 이제 이 이상은)
anybody : pron, n, 누군가, 누구도, 아무도, 어엿한 인물
anyhow : ad, 어떻게든(in any way whatever), 적어도, 적당히, 되는 대로
anymore : ad, 이제는, 더 이상
anyone : pron, 누구라도, 누구도, 누군가
anyplace : ad, 어디나, 어디라도
anything : pron, 무엇이든, 무엇인가, 아무것도(~but ...외에는 무엇이든, ...는 커녕, 어림도 없는(far from)
anythingarian : n, 일정한 신념(신앙, 신조)이 없는 사람
anytime : ad, 언제든지, 언제나
anyway : ad, 어쨌든, 어떻게 해서든, 여하튼
anywhere : ad, 어디에든, 어디엔가, 어디에나
anywise : ad, 아무리 해도, 결코
Anzac : n, 앤잭(제 1차 대전 때의 오스트레일리아와 뉴질랜드 연합군단), 그 대원
aorist : n, 부정과거
aorta : n, 대동맥
aoudad : n, 야생의 양(북아프리카 산)
apace : ad, 빨리, 신속히
Apache : n, 아파치(아메리카 토인의 한 종족)
apache : n, 파리의 깡패, 무뢰한
apaneid : n, 거미
aparejo : n, (가죽 쿠션을 댄 멕시코의)길마
apart : ad, 떨어져, 떼어서(~from ...은 별문제로 하고, come ~흐트러지다, joking~ 농담은 집어치우고, take~ 분해하다다
apartheid : n, 민족격리, 인종차별정책
aparthetic : a, 무감각한, 냉담한
aparthotel : n, 임대 아파트식 호텔
apartment house : x, 아파트
apartmet : n, 방, 아파트, (공공 주택내의)한 세대의 방
apathtic : a, 보호색(형태)을 가진
apathy : n, 무감동, 무관심, 낸담
apatite : n, 인회석
ape : n, vt, 원숭이, 고릴라, 오랑우탄, 긴팔원숭이따위(go~ 발광하다, 열광하다, play the~ 서툴게 흉내내다, 흉내내다
apeak : ad, 수직으로 세워서
apeman : n, 원인
Apennine : a, (이탈리아의)아펜니노 산맥의
Apennines : n, (이탈리아의)아펜니노 산맥
apepsy : n, 소화 불량
aperidoic : a, 비주기적인, 불규칙한, 비반복성의
aperient : a, n, 용변을 순하게하는 약, 완하제
aperitif : n, 식전술(식욕 촉진을 위한)
aperitive : a, 식욕 증진의
aperture : n, 뻐끔히 벌어진데, 구멍, 틈새, 렌즈의 구경
apery : n, 모방, 흉내, 원숭이 우리
apetalous : a, 화판이 없는, 꽃잎이 없는, 무판의
apex : n, 선단, 꼭대기, 정점, 절정
aphaeresis : n, 어두 음절 탈락
aphaeretic : a, 어두음절탈락의
aphasia : n, 실어증
aphasic : a, n, 실어증의
aphelion : n, 원일점(opp.perihelion)
apheliotropic : a, 배광성의
apheliotropism : n, 
aphesis : n, 어두 모음 소실
aphetic : a, 어두 모음 소실의
aphicide : n, 살충제(진디용)
aphid : n, 진디
aphis : n, 진디(plant louse)
aphonia : n, 실성증
aphonic : a, 실성증의, 무성화한, 무성의
aphorism : n, 격언, 경구
aphoristic : a, 격언이 풍부한
aphotic : a, (바다밑 등)빛이 없는, 빛 없이 자라는(식물 등)
aphrodisiac : a, n, 최음의, 최음제, 미약
Aphrodite : n, 사랑과 미의여신(로마 신화에서는 Venus)
aphtha : n, 아구창
aphyllous : a, 잎이 없는
Apia : n, 아피아, 서사모아의 수도
apian : a, 꿀벌의
apiarian : a, 꿀벌의, 양봉의
apiarist : n, 양봉가
apiary : n, 양봉장
apical : a, n, 정점의, 설단음의
apices : n, apex의 복수
apiculate : a, (잎 등)끝이 짧고 뾰족한
apiculture : n, 양봉
apiculturist : n, 양봉가
apiece : ad, 한 사람에대하여, 제각기, 각각
apikoros : n, 쾌락주의자(hedonist), 무신론자(atheist)
Apis : n, 아피스, 멤피스에서 숭배된 성스러운 소
apish : a, 원숭이같은, 어리석은
APL : n, 산술, 논리 연산의 간결한 기술을 목적으로 고안된 프로그래밍 언어
aplanat : n, 구면 수차를 없앤 렌즈
aplastic anaemia : n, 재생불량성빈혈
aplenty : ad, 많이
aplite : n, 반 화강암
aplomb : n, 수직, 평형, 태연자약, 침착, 평정
apnoea : n, 호흡 정지
apoapsis : n, 궤도 최원점
apocalypse : n, 묵시, 천계
apocalyptic : a, 천계의, 계시의
apocalypticism : n, 계시록적 세계의 도래에 대한 기대, 계시 신앙, 지복 일천년설
apocalypticist : n, 계시록적 세계의 도래를 예언하는 사람
apocarpous : a, 이생 심피의
apochromat : n, 색수차 및 구면 수차를 없앤 렌즈
apochromatic : a, 색수차 및 구면 수차를 없앤
apocopate : vt, 어미음 소실에 의하여 간단히 하다
apocope : n, 끝음(절)생략
apocrine : a, 아포크린선이 분비하는
Apocrypha : n, (구약 성서의)경외전, 출처가의심스러운, 위서
apocryphal : a, 경외전의, 출처가 의심스러운
apod : n, 무족 동물, 배지느러미가 없는 물고기
apodal : a, 발이 없는, 배지느러미가 없는
apodictic : a, 필연적인, 명백한
apodosis : n, 귀결절, 조건문의귀결절
apoenzyme : n, 애포 효소
apogamy : n, 무배 생식
apogean : a, 원지점의
apogee : n, 최고점, 정상, 원지점
apograph : n, 사본, 등본
apolaustic : a, 향락적인
apolitical : a, 정치에 무관심한, 무관계한
Apollinaris : n, 독일산 광천수의 일종
Apollo : n, 아폴로(태양, 시, 음약, 예언, 의료의 신), 미남, 태양, (미국의)아폴로우주선
Apollonian : a, 아폴로의(같은), 고전미를 갖춘, 당당한
apollyon : n, 악마
apologetic : a, n, 사죄의, 변명의, 변명
apologia : n, 변명서
apologist : n, 변명자, 변증자
apologize : vi, 사죄하다, 사과하다(to him for that), 변명하다
apologue : n, 교훈담우화(예 이솝 우화)
apology : n, 사죄, 사과, 해명, 변명(defence), 명색뿐인 것(a mere~for a library 단지 이름만의 도서실)
apolune : n, 원월점
apomixis : n, 아포믹시스(단위 생식, 무배생식, 무포자 생식 등)
apophthegm : n, =apothegm
apophysis : n, 융기, 돌기
apoplectic : a, 졸중풍의에 걸리기 쉬운
apoplexy : n, 뇌일혈
aport : ad, 조현으로, (키를)좌현으로 바짝 돌려
aposematic : a, (체색 등이 방어 효과가 있는)경계(색)의
aposiopesis : n, 돈절법, 중단법
apospory : n, 무포자 생식
apostasy : n, 배교, 배신, 변절, 탈당
apostate : n, 배교자, 변절자, 탈당자
apostatize : vt, 신앙을 버리다, 변절하다(from, to)
aposteriori : x, 후천적인, 귀납적으로
apostil : n, 방주
apostle : n, 사도(예수의 12제자의 한 사람), (한 나라 한 지방의)최초의전도자
apostles'creed : n, 사도신경
apostolate : n, 사도직, 교황의 직
apostolic : a, 사도의, 사도와동시대의, 사도의신앙에관한, 교황의
apostrophe : n, 생략기호, 돈호법
apostrophize : vt, vi, 
apothecary : n, 약종상(druggist), 약제사
apothegm : n, 경구, 격언
apothegmatic : a, 
apotheosis : n, 신으로 모심, 찬미, 숭배
apotheosize : vt, 신으로 모시다, 신격화 하다, 예찬하다
apotropaic : a, 마귀를 쫓는 힘이 있는
appal : vt, 섬뜩하게하다
Appalachian : a, 애팔래치아 산맥의
Appalachians : n, 애팔래치아 산맥(북미 동해안을 세로 달리는)
appalling : a, 섬뜩한, 무서운, 끔찍한, 심한, 대단한
Appaloosa : n, 애팔루사종의 승용마
appaloosa : n, 북미산의말(흰털에 검은 반점이 있음)
appanage : n, 속성(지위, 신분에 따르는)이득, 부수입, (세자가 아닌)왕자의 속령, 속지
appanage : n, 왕자의 녹, 왕자령, 속지
apparat : n, 공산당의 기관(조직)
apparatus : n, 기구, 장치
apparel : n, vt, 의복, 제복의장식수-입히다, 차리다, 꾸미다
apparent : a, 명백한, 보이는, 외견의, 거죽만의, 겉꾸밈의
apparently : ad, 겉보기에는, 명백히, 일견하여
apparent time : x, (해시계등의)태양의 위치로 측정하는시간
apparition : n, 유령, 환영, 요괴, 출현물
apparitional : a, 허깨비의(같은)
apparitor : n, 하급 관리, 총장의 권표를 받드는 사람
appeal : vi, vt, 항소하다, 호소하다, 애원하다, 감동시키다, 흥미를 끌다, 마음에 들다(to), 항소하다, 상고하다
appealable : a, 항소(상고, 상소)할 수 있는
appealing : a, 애원적인, 사람의 마음에 호소하는, 마음을 끄느, 매력적인
appear : vi, 나타나다, 나오다, 보이다, 공표하다, 출두하다, 같다
appearance : n, 출현, 출두, 등장, 외관, 현상, 곡두, 유령, 발간, 모양, 상황, 형세(for~'s sake) 체면상
appearing : a, ...인 듯한
appeasable : a, 달랠수 있는, 가라앉힐 수 있는
appease : vt, 가라앉히다, 달래다, 누그러지게 하다(quiet), (식욕, 요구 따위를)채우다
appeasement : n, 위무, 진정, 완화, 양보
appel : n, 아펠(공격의 의사 표시로 마루를 쿵 딛거나, 상대방의 검을 세게 치는 것)
appellant : n, 항소인, 상고인, 간원자
appellate : a, 항소의, 상고의
appellate court : n, 항소법원
appellation : n, 명칭, 호칭, 명명
appellative : n, 명칭의, 명의의, 보통명사
appellee : n, 피항소인
append : vt, 부가하다, 첨가하다, 표찰등을 붙이다
appendage : n, (매달린)부가물, 부속물, 부속기관
appendant : a, 추가의, 부가의
appendectomy : n, 충양돌기절제술
appendicitis : n, 맹장염
appendicular : a, 부속지의, 충수의, 부속부분의
appendix : n, 부속물, 부록
apperceive : vt, 지각하다, 통각하다, (새 관념을)유화하다
apperception : n, 통각작용, 유화
appertain : vi, 속하다, 관계하다
appetence : n, 경향, 성향, 친화력
appetent : a, 본능적으로 바라고 있는, 열망하는
appetite : n, 식욕, 욕구, 욕망, 기호
appetitive : a, 식욕이 있는, 식욕을 증진시키는
appetizer : n, 식욕을 돋우는 음식
appetizing : a, 식욕을 돋우는, 맛있어 보이는
applaud : vt, 박수갈채하다, 칭찬하다, 찬성하다
applause : n, 박수갈채, 찬성, 칭찬(general~ 만장의 박수, win~ 갈채를 받다)
applausive : a, 박수 갈채의, 칭찬의
apple : n, 사과, 야구공, 대도시, 지구(~of sodom (집으로 재가 되는)소돔의 사과, 실망거리, ~of the eye 눈동자, 귀중한 것)
apple brandy : x, =apple jack
applecart : n, 사과운반수레(upset the (a person's)~계획을 망쳐놓다)
apple dumpling : x, 사과를 넣은경단
applejack : n, 사과브랜디
apple knocker : x, 무경험자
apple pie : x, 사과파이
apple piebed : n, 시트를 접어넣어 발이나오지 못하게한 침대
apple pieorder : x, 질서있음, 정돈, 양호상태
applepolish : vi, vt, 비위 맞추다
applepolisher : n, 아첨 잘 하는 사람
applesauce : n, 사과소스(난도질한 사과의 설탕찜), 허튼소리, 마음에도 없는 아첨
applewife : n, 사과 파는 여자
appliance : n, 기계, 장치(device), 기구
applicability : n, 적응성, 적당, 적절
applicable : a, ad, 응용(적용)할 수 있는, 적절한(suitable)-bly
applicant : n, 응모자, 지원자, 후보자
application : n, 신청, 원서, 적용, 응용, 지원, 신청서, 도포, 부지런함, 열심
applicative : a, 실용적인, 응용적인
applicator : n, 도포구, 화장용솔, 아이섀도 등을 펴기 위한
applicatory : a, 적용(응용)할 수 있는, 실용적인
applied : a, 응용된
applique : n, vt, 아플리케(를 달다)
apply : vt, vi, 적용하다, 물건을대다, 붙이다, 페인트를칠하다, 열이나 힘을 가하다, 용도에 쓰다, 돌리다
appoggiatura : n, 전타음, 장식음의일종
appoint : vt, 임명하다, 지명하다, 지정하다, 귀속을 정하다
appointed : a, 지정된, 설비된, 약속의
appointee : n, 피임명자
appointer : n, 임명자
appointive : a, 임명에의한
appointment : n, 임명, 선정, 지정, 관직, 지위, 회합의약속
apport : n, 환자
apportion : vt, 할당하다, 벼르다, 나누다, 배분하다
apportionment : n, 할당, 배분
appose : vt, 겉에놓다, 늘어놓다, 병치하다
apposite : a, 적당한, 적절한
appositely : ad, 적절히
apposition : n, 병치, 나란히놓음
appositional : a, 병치한, 동격의
appositive : a, n, 동격의
appraisal : n, 평가, 감정
appraise : vt, 평가하다, 감정하다
appraising : a, 평가하는(듯한)
appraxia : n, 운동 신경 장애
appreciable : a, 평가할 수 있는, 느낄 수 있을 정도의, 다소의
appreciate : vt, vi, 평가하다, 진가를인정하다, 음미하다, 감상하다, 이해하다, 감사하다, 시세가오르다
appreciation : n, 평가, 감상, 인식, 감사, 가격의증가, 진가의인정
appreciative : a, 감상안이 있는, 눈이높은(~audience 눈 톺은 관객(청중), 감상적인, 감사의(~remarks 감사의 말)
appreciativeness : n, 
appreciator : n, 진가를 아는 사람, 감상자
appreciatory : a, 평가의, 감상적인
apprehend : vt, vi, 염려하다, 우려하다, 붙잡다, 이해다다, 체포하다, 감지하다, 이해하다, 우려하다
apprehensigility : n, 이해할(깨달을)수 있음
apprehension : n, 이해, 우려, 걱정, 두려움, 파악, 체포, 이해력
apprehesible : a, 이해할수있는
apprehesive : a, 근심하는, 우려하는
apprentceship : n, 도제살이, 도제의 신분
apprentice : n, vt, 도제, 견습, 계시로삼다, 견습으로보내다(be bound~to ...의 도제가 되다)
appresmidi : n, 오후
appressed : a, 바싹(납작하게)밀어붙여진, 착 들러붙은
apprise, apprize : vt, 알리다
apprize : vt, =APPRAISE
appro : n, =approval
approach : vt, 접근하다, 접근시키다, 아무게이야기를꺼내다, 문제해결에착수 하다-vi 접근하다, 거의...와 같다
approbate : vt, 인가하다, 면허하다, 시인하다, 찬동하다
approbation : n, 허가, 시인, 칭찬
approbative : a, 승인하는, 인가의, 찬성의
approbatory : a, 승인의, 칭찬의
appropriable : a, 전용(사용)할 수 있는, 유용(충당)할 수 있는
appropriate : a, 적당한, 특유한, 고유의, 착복하다, 도용하다, 돌리다
appropriation : n, 사용, 충당, 충당금, 도용, 착복, 세출예산
appropriative : a, 전유(사용)의, 충당의, 특별 상용의
appropriator : n, 횡령자, 부당점용자
approvable : a, 인정할수있는
approval : n, 시인, 찬성, 인가(on~반품할 수 있는 조건으로)
approve : vt, 시인하다, 찬성하다, 마음에들다, 인가하다, 실증하다, 보여주다, 시인하다
approved : a, 인가된, 입증된, 정평있는, 공인된
approver : n, 승인자, 찬성자
approving : a, 시인하는
approximate : a, vt, vi, 근사한, 대체의, 접근시키다
approximately : n, 대체로, 대략
approximation : n, 접근, 근사치
approximative : a, 대략의, 개산의
appui : n, 지원, 지지, 거점, 거지점
appulse : n, (천체의)근접, (배, 파도등의)충돌, 접촉
appurtenance : n, 부속품, 기계장치, 종물
appurtenant : a, n, 부속의, 부속물
apresski : a, n, 스키를 타고난 뒤의 (모임)
apricot : n, 살구, 살구빛
April : n, 4월
april fool : x, 에이프릴 풀(만우절에 속아 넘어간 사람), 그 장난
apriori : ad, 연역적으로, 선천적으로
apriorism : n, 선천설, 연역(선험)적 추론
apriority : n, 선천적임, 선험성
apron : n, vt, 에이프런(같은 것), 앞치마, 행주치마, 앞무대, 바텐더, 격납고 , 앞의 광장
apronful : n, 에이프런 가득(한 분량)
apron string : x, 앞치마의끈, be tied to one;s wife's apron strings 아내게게 쥐어 살다
apropos : a, ad, 적절한, 알맞은, 적절하게
aprtment : n, 아파트, 방, 고동 주택내의 한 세대의 방
apse : n, 쑥내민반원형의 일부
apsis : n, 원일점, 근일
apt : a, 적당한, 이해가 빠른, 하기쉬운
apteral : a, 날개가 없는, 측주가 없는
apterous : a, 날개없는
apteryx : n, =kiwi
aptitude : n, 적절함, 경향, 재능, 소질, 적성
aptly : ad, 적절히, 잘
aptness : n, 적절, 적합성, 성향, 경향, 재능, 소질
aqua : n, 물, 용액
aquabelle : n, 수영복 차림의 미인
aquacade : n, 수중쇼
aquaculture : n, 양어, 양식
aquafarm : n, 양어장, 양식장
aquafortis : n, 질산
aquakinetics : n, pl, 부유 훈련법(술)
aqualung : n, 수중폐식장, (장시간 잠수구)
aquamarine : n, 남옥, 청녹색
aquanaut : n, 해저탐험가, 잠수기술자
aquanautics : n, (스쿠버를 사용한)수중 탐사
aquaphobia : n, 물공포(증)
aquaplane : n, vi, (모터보트로 끄는) 활주판(을 타다)
aquaregia : n, 왕수
aquarelle : n, 수채화
aquarist : n, 수족관원, 어류 사육가
aquarium : n, 양어지, 수족관, 목사관
Aquarius : n, 물병자리, 보병궁
aquaspaceman : n, 수중 생활자(작업원)
aquatel : n, 해상(수상)호텔
aquatic : a, n, 물의, 수상의, 물속에사는 수생 동물
aquatint : n, 식각요판
aquavit : n, (스칸디나비아산)투명한 증류수(식전 반주용)
aquavitae : n, 알콜, 독한 술
aqueduct : n, 도수관, 수도, 수도교
aqueous : a, 물의, 물 같은, (암석이)수성의
aqueous : a, 물의, 수성의
aqueous humour : x, (눈의)수
aqueous rock : x, 수성암, 
aquiculture : n, 수경법
aquifer : n, 대수층
Aquila : n, 독수리자리(The Eagle)
aquiline : a, 수리의, 독수리 부리 같은(an~nose미부리코)
Aquinas : n, 이탈리아의 카톨릭교의 신학자
Aquino : n, 아키노(필리핀 대통령)
aquiver : a, 부들부들(와들와들)떨며
aquose : a, 물이 풍부한, 물의, 물 같은
aquosity : n, 물기가(젖어)있음(wateriness)
Aquqrian : a, n, 물병자리의, 물병자리 태생의 사람
Arab : n, a, 아라비아사람, 아라비아 사람의
arabesque : n, a, 당초무늬, 아라베스크(양손을 앞뒤로 뻗치고 한 발로 섬), 당초무늬의, 이상한, 정교한
Arabia : n, 아라비아
Arabian : a, 아라비아의, 아라비아 사람의
arabian bird : x, 불사조(phoenix)
Arabic : a, n, 아라비아의, 아라비아사람의, 아라비아어
arabic numerals : x, 아라비아숫자
Arabism : n, 아랍어법, 아랍 민족주의
Arabist : n, 아랍학자
Arabize : vt, 아랍화하다
arable : a, 경작에 적합한
arab league : x, 아랍연맹
Arabsat : n, 아랍 통신 위성
Arachne : n, 아라크네(그리스신화의 Athena에게 베짜기 경기에서 지고, 거미로 변신을 당한 여자)
arachnid : n, 거미무리의 동물
arachnitis : n, 거미줄막염
arachnoid : n, 거미집 모양의, 거미 망막
Arafat : n, 아라파트, 팔레스타인 대통령
Aragon : n, 스페인의 북동부 지방(본디 왕국)
Aragonese : a, n, 아라곤의, 아라곤 사람(말)의, 아라곤 사람
Araldite : n, 애럴다이트(접착제)
Aral Sea : x, 아랄해(카스피 해 동쪽의 내해)
Aramaic : n, 아람어(셈에 속하는 고대어)
Aramean : a, Aram 사람(말)의
araneidan : n, 아라라트 산, 노아의 방주가 상륙한 곳
araucaria : n, 남양삼나무속의 나무
Arawak : n, (남미 인디오의)아라와크 족, 아라와크 말
Arawakan : n, 아라와크 어족의, 아라와크 족, 아라와크 어족
arbalest : n, 노궁, 석궁
arbiter : n, 중재인
arbiter elegantiarum : n, (심미안, 예법, 에티겟)권위자
arbitrable : a, 중재할수있는
arbitrage : x, 시세차를 이용한 되넘기기 거래
arbitral : a, 중재의
arbitrament : n, 중재(에 의한 재결)
arbitrarily : ad, 독단(전단)적으로, 제멋대로, 마음대로
arbitrary : a, 메  마음대로의, 멋대로의, 기분내키는대로의, 횡포한, 전횡의
arbitrate : vt, 중재하다, 재정한, 중재재판하다
arbitration : n, 중재
arbitress : n, 여자 중재인
arbitrtor : n, (전권)중재인, 심판자
arbor : n, 정자, 나무 그늘의 휴게소
Arbor Day : x, 식목일(4, 5월경 갈 주에서 행함)
arboreal : a, 수목의, 교목성의
arbored : n, 나무(나뭇가지)모양
arborescent : a, 나무같은, 나무가지 모양의
arboretum : n, 수목원, 산림공원
arboriculture : n, a, 수목 재배, 수목 재배의
arboriform : a, 나뭇가지 모양의
arborist : n, 수목 재배가
arborization : n, 나뭇가지 모양, 수지상 분기
arborize : vi, 수지상 분기를 나타내다
arborous : a, 수목의
arborvitae : n, 지빵나무, 소뇌함수
arbovirus : n, 아르보바이러스(뇌염 등을 일으키는 바이러스의 총칭)
arbutus : n, (북미산의)철쭉과의일종, (남유럽산의)소귀나무, 마취목(무리)
arc : n, 호, 전호, 아크
arcade : n, 아케이드(유개도로 또는 상가), 줄지은 홍예랑
arcaded : a, 아케이드를 이룬, 공랑이 있는
arcadia : n, 아르카디아(고대 그리스 산간의 목가적 전원), 순박한, 평화로운 이상향
Arcadian : a, n, 아르카디아의(같은), 전원의, 목가적인, 순박한(사람)
arcading : n, (일련의)아치(아케이드)장식
arcane : a, 비밀의, 난해한
arcanum : n, 비밀, 신비, 비방약
arch : n, vt, vi, 아치, 홍예, 아치문(a triumphal~ 개선문), 호, 궁형, 활모양으로 굽히다, 홍예를 틀다
arch(a)elogical : a, 
arch(a)eology : n, 고고학
archaeopteryx : n, 시조새(조류의 조상)
Archaeozoic : a, n, =ARCHEOZOIC
archaic : a, 고풍의, 고대의, 고문체의, 고대 그리스풍의
archaism : n, 고어, 고풍의 문장, 고풍, 의고주의
archaistic : a, 고풍한, 고체의, 의고파의
archaize : vi, vt, 고풍으로 하다, 고풍(구식)을 본뜨다
archangel : n, 대천사
archangelic : a, 대천사의, 천사장의
archaology : n, 고고학
archbishop : n, 대주교, 대감독(가톨릭, 성공회의)대주교
archbishopric : n, 위의 직(교구)
archdeacon : n, 부감독, 부주교
archdeaconry : n, 그직(교구, 저택)
archdiocese : n, archbishop의교구
archducal : a, 대공(령)의
archduchess : n, 대공비
archduke : n, 대공(구 오스트리아왕자)
Archean : n, a, 시생대(의)
arched : a, 아치형의, 궁형의, 홍예가 있는
archegonium : n, (이끼류, 양치류 등의)장란기
archenemy : n, 대적
archeo : a, 고대의, 원시의
Archeozoic : n, a, 시생대
archer : n, 사수, 궁술가, 사수자리
archeress : n, 여자 궁술가
archerfish : n, 사수어
archery : n, 궁술, 사수대
archetypal : a, 원형의, 전형적인
archetype : n, 원형
archfiend : n, 마왕
archfool : n, 큰 바보
Archibald : n, 고사포
archicarp : n, 낭자균류의 자성기관
archiepiscopal : a, archbishop의
archil : n, 자줏빛 염료의 일종, 그것을 채취하는 이끼류
archimage : n, 대마술사
archimandrite : n, 대수도원장, 관장
Archimedean : a, 아르키메데스(의 원리 응용)의
archimedes : n, 아르키메데스, 고대수학자
Archimedes principle : x, 아르키메데스의 원리
arching : n, 아치기, 궁형부, (일련의)아치
archipelago : n, 군도, 다도해
archiphoneme : n, 원음소
archiplasm : n, 미분화 원형질
architect : n, 건축가, 건축기사(a naval~ 조선기사), 제작자, 조물주(Creator)
architectonic : a, 건축의, 건축이 교묘한, 조직적인
architectural : a, 건축의
architecture : n, 건축술, 건조물, 건축양식, 건축구성
architrave : n, 평방(entablature의 최저부), 처마도리
archival : a, 기록의, 고문서의, 공문서의, 기록 보관소의
archives : n, pt, 공무서보관소, 공문서, 고기록
archivist : n, 기록(공문서)보관인
archivolt : n, 장식 홍예 창도리
archly : ad, 장난스럽게, 짓궂게
archness : n, 장난, 익살
archon : n, 집정관, 고대아테나의 집정관
archoplasm : n, 시원질
archpriest : n, 주목사
archtraitor : n, 대반역자
archway : n, 아치길
archwise : ad, 아치꼴로
arciform : a, 활모양의
arcjet : n, 아크제트 엔진(추진 연료를 전기 아크로 가열하는 로켓 엔진)
arclamp : n, 호광등
arcograph : n, 원호자
arcology : n, 완전 환경 계획
arctic : a, n, 북극의, 극한의, 북극(지방)
Arctic Ocean : x, 북빙양
Arctic Zone : x, 북극대
Arctik Circle : x, 북극권
Arcturus : n, 대각성(목동자리의 가장 큰별)
arcuate : a, 궁형의, 아치형의
arcuation : n, 활꼴로 굽음, 아치구조(사용), (일련의)아치
arcus : n, 아치운
ardency : n, 열열함
Ardennes : n, 아르덴(프랑스 북동부, 벨기에와 접한 지대, 제1, 2차 대전의 격전지)
ardent : a, 열심인, 열렬한, 불같은, 타는 듯한, 뜨거운, 빛나는
ardently : ad, 열심히, 열렬히
ardent spirits : x, 독한 술
ardor : n, 열정, 열심, 열의
arduous : a, 힘드는, 부지런한, 험악한
arduously : ad, 
are : n, 아르, be의 2인칭 단수(1, 2, 3인칭 복수)의 적설법 현재
are : v, 2인칭 단수
area : n, 면적, 공간, 지역, 지방, 영역, 공지, 범위, 지하실 출입구
area code : x, 시외국번(미국은 숫자 3자리)
areal : a, 면적의, 지역의
areaway : n, 건물 사이의 통로
areca : n, 빈랑나무
aren't : x, 단축형
aren't : x, are not의 단축
arena : n, (원형 극장의 복판의)투기장, 활동장소, 무대
arenaceous : a, 모래같은, 모래질의, 모래에자라는
arena theater : n, 원형 극장
arenicolous : a, 모래속에 사는, 모래 따에 자라는
arenite : n, 사암
arenose : a, 모래의, 모래 같은, 모래투성이의, 모래 섞인
areocentric : a, 화성 중심의
areography : n, 화성지(화성 표면의 지형 묘사)
areola : n, 그물코 틈(엽맥, 시맥 간의)소공, 유윤
areolar : n, 소공 형성
areometer : n, 액체 비중계
Areopagitca : n, Milton이 출판의 자유를 주장한 팜플렛의 제목
Areopagite : n, 아레오파고스의 재판관
Areopagus : n, 아레오파고스(아테네의 언덕), (고대 아테네의)최고 재판소(아레오파고스 언덕에 있었음)
Ares : n, 아레스(군신), 로마 신화의 Mars에 해당)
Ares : n, 아레스, 로마신화의 아레스
arete : n, 날카로운(바위)산등성이
arete : n, 험준한 산등성이(빙하 침식 등에 의한)
Arethusa : n, 아레투사(숲의 요정)
arf : int, 멍멍(개 짓는 소리)
argala : n, 대머리황새(인도산)
argali : n, 아르갈리(중앙 아시아산의 크고 구부러진 뿔을 가진 야생 양)
argent : n, a, 은, 은의
argental : a, 은의, 은 같은, 은을 함유한
argentan : n, 양은의 일종(니켈, 동, 아연의 합금)
argenteous : a, 은 같은, 은백의
argentic : a, (보통 2가의)은을 함유한, 은의
argentiferous : a, 은을 함유한
argentina : n, 아르헨티나(남아메리카 남부의 공화국)
argentine : a, n, 아르헨티나의, 아르헨티나 사람
argentite : n, 휘은광
argentous : a, 은의, 은이 섞인
argentum : n, 은
arghan : n, 아나나스속의 야생 파인애플(중미산)
Argie : n, 아르헨티나 사람
argil : n, 백점토, 도토
argillaceous : a, 점토질의
argillite : n, 규질 점토암
arginase : n, 아르기나아제(아르기닌을 요소로 분해하는 효소)
arginine : n, 아르기닌(아미노산의 일종)
Argive : n, a, 그리스의(사람)
arglebargle : n, 입씨름, 토론
argo : n, 아르고선(jason이 금 양털을 찾으러 간배), 아르고자리
argon : n, 아르곤
Argonaut : n, 그리스신화의 아르고선 승무원
Argonautic : a, 아르고선 일행의
Argos : n, 아르고스(옛그리스 남동부의 고대도시)
argosy : n, 대상선, 배
argot : n, 은어
arguable : a, 논할 수 있는
argue : vi, 논하다, 논쟁하다
arguer : n, 논쟁자, 논자
argufy : vt, vi, 귀찮게 논쟁하다
argument : n, 논의, 논증, (논문 따위의)개요
argumentation : n, 논의, 논쟁, 토의, 입톤
argumentative : a 의론의, 논쟁을 좋아하는
Arguseyed : a, 눈이 날카로운, 방심않는, 경계하는
argute : a, 날카로운, 민첩한, 예민한, 빈틈없는
argybargy : n, 입씨름(argument)
argyle : n, (편물의)마름모색무늬
argyria : n, 은 중독
Argyrol : n, 함은액, 방부용으로 사용, 상표명
arhat : n, 아라한
aria : n, 아리아, 영창
ariadne : n, minos왕의딸(Theseus를 미궁에서 탈출케 함)
Arian : a, n, 아리우스의
Arianism : n, 아리우스 주의 
ariboflavinosis : n, 비타민B  결핍(증)
arid : a, 건조한, 불모의, 무미건조한
aridity : n, 
Ariel : n, 아리엘(중세 전설의 공기의 요정)
ariel : n, 영양의 일종(아라비아산의)
Aries : n, 수양자리, 백양궁
arietta : n, 아리에타, 소영창
aright : ad, 바르게, 정확히
aril : n, 가종피
arillate : a, 가종피가 있는
Arine : n, 대형 위성 발사용 로켓, 유럽 우주 기관에서 개발
arioso : n, a, ad, 영서창(의, 으로)
arise : vi, 일어나다, 나타나다, (사건 따위가)발생하다, 부활하다, 소생하다
arisen : v, arise과거분사
arisings : n, 부산물, 잉여산물
arista : n, 까끄라기, 수염, 까끄라기 모양의 부속기관
aristocracy : n, 귀족 정치, 귀족사회
aristocrat : n, 귀족
aristocratic : a, 귀족의
aristocratism : n, 귀족주의, 귀족적 기풍(정신)
Aristophanes : n, 그리스 희극 작가
Aristophanic : n, 아리스토파네스풍(그리스 희극 작가)
Aristotelian : n, 아리스토 텔레스(파)의 (학자)
Aristotle : n, 아리스토텔레스(그리스의 철학자, Platon의 제자)
aristotype : n, 아리스토 인화법, 아리스토 인화
arithmetic : n, 산수, 계산
arithmetical : a, 산수의, 계산의
arithmetician : n, 산술가
arithmetic progression : x, 등차수열
arithmetic series : x, 등차급수
arithmometer : n, (초기의)계산기
Arius : n, 아리우스(알렉산드리아의 신학자, 그리스도의 신성을 부인)
Arizona : n, 미국 남서부의 주
ark : n, 방주, 계약의 궤(모세의 십계명을 새긴 두 개의 석판을 넣어 둔), 볼품 없는 대형의 배
arkansas : n, 미국중남부의 주
Arkansawyer : n, Arkansas주 사람(별명)
Arkie : n, Arkansas출신의 유랑 농부, 이동 농업 노동자
Arkie : n, 알칸사스주출신의 방랑농민
Arkwight : n, 아크라이트
arles : n, 예약금, 착수금, 계약금
Arlington : n, 알링턴
arlington nationalcemetery : x, 알링턴국립묘지
ARM : x, antiradiation missile 대전자파 미사일
arm : n, 팔, 팔 보양의 것, 까치발, 팔걸이, 큰 가지, 후미
arm : n, 무기, 병기, 명과, 군사, 문장
armada : n, 함대, 비행대, 스페인의 무적 함대(1588년 영국 함대에 격파된)
armadillo : n, 아르마딜로(중남미산)
Armageddon : n, 아마겟돈(세계의 종말에 있을 선과 악의 결전장
Armagh : n, 아마(북아일랜드 남부의 주)
armalcolite : n, 아말콜라이트(아폴로 11호의 우주비행사가 달에서 가져온 광물)
armament : n, 군비, 병력, 병기, (진지, 군함 등의)장비
armamentarium : n, 의료 필수품 전반(기구, 약품, 서적 포함), (특정분야에 필요한)전 설비(자료, 요인)
armature : n, 갑옷, 장갑, 방호물, 보강 철재, 발전자, 전기자
armband : n, 완장, 상장
armchair : n, 안락의자
arme blanche : n, 백병기(기병도, 기병창), 기병
armed : a, 무장한(an!robber 무장 강도)
armed forces : x, 군대(육, 해, 공의)
armed neutrality : x, 무장중립
armed peace : x, 무장평화
Armenia : n, 아르메니아(본디 아시아 서부한 한 나라, 지금은 소련, 이란, 터키 삼국에 분속됨)
Armenian : a, n, 아르메니아(사람(말)의, 아르메니아 사람, 아르메니아 말
arment : n, 죄상 인부, 비난, 힐난, 문책
armful : n, 한아름의 분량, 한 팔 그득
armhole : n, (옷의)진동
armiger : n, 기사의 종자, 대향사(문자이 달린 무기를 가질 자격이 있음)
armigerous : a, 문장을 패용할 자격이 있는
armillary : a, 원(고리)모양의, 아밀러리 천구의의
arming : n, 무장, 접극자
Arminian : a, n, 아르미니우스의(신자)
Arminius : n, Jacovus(1560-1609)네델란드의 반 Calvin파 신학자
armipotent : a, 무력이 뛰어난, 전쟁에 강한
armistice : n, 휴전
Armistice Day : x, (제 1차 대전의)휴전 기념일
armless : a, 팔이 없는, 팔걸이가 없는 (의자 등)
armlet : n, 팔찌, 좁은후미
armload : n, 한 아름(의 양)
armlock : n, (레슬링)암록(팔조르기)
armoire : n, 대형 옷장(벽장, 찬장)
armor : n, 갑옷, 투구, 갑주, 철갑, 방호복, 방호기관, 기갑부대
armored : a, 무장한, 장갑한, 외장을 한
armorer : n, 장색, 병기 제작자, 병기계
armorial : a, 문장의
armory : n, 병기고, 병기공장, 병기류, 문장학
armourbearer : n, 갑옷가지고 다니는 사람
armourclad : x, =armored
armoured cable : x, 외장케이블
armoured car : x, (군용, 현금 수송용)장갑차
armoured forces : x, 기갑부대
armourer : n, 무구장색, 병기제작자
armourer plate : x, 장갑판
armourred : a, 무장한, 장갑한, 외장을 한
armpit : n, 겨드랑이
armtwisting : n, a, 압력, 강압적인
army : n, 육군, 군대, 군대군(standing(reserve)~)
Army List : x, 육해군, 현역 자교 명부
Army Service Corps : x, 육군 병참단
armyworm : n, 거염벌레, (농작물의 해충)
Arnaut : n, (특히 터키군에 복무하는)알바니아 사람
arnica : n, 아르니카(약초), 아르니카정기(외상용)
Arno : n, 아르노 강(이탈리아 서부의 강)
Arnold : n, 영국의시인, 비평가
aroid : n, a, 토란(의)
aroint : vt, 가라, 물러가라(begone)
aroma : n, 방향, 향기, (예술품 등의)품격, 기품, 묘취
aromatic : a, 향기로운, 묘미있는
aromatize : vt, 향기롭게 하다
aromatotherapy : n, 방향 요법(피부 미용의 하나)
arose : v, 과거
around : ad, 주변에, 둘레에
aroundtheclock : a, 24 시간 꼬박의
aroundtheworld : a, 세계 일주의
arousal : n, 각성, 환기, 자극
arouse : vt, 깨우다, 자극하다, 일으키다, 격려하다, 분발시키다
arow : ad, 일렬로
arpeggio : n, 아르페지오
arpent : n, 아르팡(프랑스의 옛 면적의 단위)
arquebus : n, =harguebus
arquebusier : n, 화승총으로 무장한 병사
arrah : int, 아!, 어머!, 저런!
arraign : vt, 소환하다, 공소사실의 사실여부를 묻다, 나무라다, 문책하다
arraignment : n, 죄상 인부(의 절차), 비난, 힐난, 문책
arrange : vt, 가지런히 하다, 정돈하다, 정리하다, 배열하다, 조정하다, 미리 가지런히 하다
arrangement : n, 정돈, 정리, 배열, 배치, 준비(preparation), 화해, 각색, 편곡
arrant : a, 전적인, 악명녹은, 극악한
arras : n, (프랑스의)아라스천(벽걸이)
array : vt, n, 차리다, 성장시키다, 배열시키다, 정렬시키다, 소집하다, 정렬, 벌여세움, 군세, 의장, 치장(in prdud~ 당당히)
arrayal : n, array하기
arrear : n, (일, 지불의)밀림, 미불, 잔금, 잔무(in~(s)밀리어, 미불되다, in~lf ...에 뒤지어
arrearage : n, 영체, 부채, 잔무
arrect : a, (개, 토끼 등의 귀가)서 있는, (사람 등이)귀를 기울이고 있는, 빈틈없이 신경을 곤두세운
arrest : vt, n, 체포하다, 붙들다, 막다, 저지하다, 마음을 끌다, 저지, 체포, 구속, 구류
arrestant : n, 활동(진행)저지물, 정착물질, (해충의)이동 저지제
arrestation : n, (발달, 발전의)억지, 정지
arrestee : n, 체포된 사람
arrester hook : x, 속도제어장치(항공 모함의 비행기 착함용)
arresting : a, 주의를 끄는, 깜짝 놀라게 하는
arresting gear : x, 착함기의 속도를 늦추기위해모함갑판에 친강색
arrestive : a, 이목을 끌기 쉬운
arrestment : n, 체포, 검속, 억류
arret : n, (법원, 국왕 등의)판결, 결정, 명령
arrhythmia : n, 부정맥
arrhythmic : a, 율동적(주기적, 규칙적)이 아닌
arride : vt, 기쁘게 하다, 만족시키다
arriereban : n, (봉건 시대의 프랑스 왕이 낸)신하 소집령, (집합적)소집된 신하들
arrierepensee : n, 속마음, 저의
arris : n, 모서리, 귀퉁이
arriswise : ad, 모서리(각)를 이루어
arrival : n, 도착, 입항, 도착자, 출현, 도달, 출생, 신생아
arrive : vi, 도착하다, 달하다, 명성을얻다
arrivism : n, 악착같은 야심(출세주의)
arriviste : n, 악착같은 야심가, 벼락 출세자
arrogance : n, 건만, 건방
arrogant : a, 건만한, 건방진
arrogate : vt, 사칭하다, 멋대로 제것으로 하다, 정당한 이유 없이 남에게 돌리다
arrogation : n, 사칭, 가로챔, 참람, 월권행위
arrondissement : n, (프랑스의)군(현)의 최대 행정구, 파리의 구
arrow : n, 화살, 화살표(영국 관유품 표시), 굵은화살
arrowhead : n, 화살촉, 쇠귀나무속의 식물
arrowroot : n, 칡의 일종, 갈분
arrowwood : n, 가막살 나무속의 식무리
arrowy : a, 화살의, 빠른
arroyo : n, 시내, 마른골(보통 때는 물이 없는)
ars : n, 예술, 학예, 아르스
arse : n, 궁둥이
arsen : a, 비소를 함유한
arsenal : n, 병기고, 군수품 창고, 조병창
arsenate : n, 비산염
arsenic : n, a, 비소, 비소의
arsenical : n, 비소 화합물, 비소제
arsenide : n, 비화물
arsenious : a, 아비의
arsenious acid : x, 아비산
arsenite : n, 아비산염
arsenopyrite : n, 황비철광
arson : n, 방화
arsphenamine : n, 살바르산
arspoetica : n, 시의 기법, 시학, 시론
arsyvarsy : a, ad, 거꾸로(의), 뒤집힌(혀서)
art : x, (thou가 주어 일때)be의 2인칭 단수, 직설법 현재
art : vt, 예술, 미숙 기술, 기능, 과목, 교양 과목(liberal arts), 인공, 기교, 숙련, (영화 소설 등에)기교를 가하다
art critic : x, 미술평론가
art director : x, 미술감독
artefact : n, =ARTIFACT
artel : n, 협동저합(소련)
Artemis : n, 아르테미스, 달과 수렵의 여신
artemisia : n, 향쑥속의 식물
arterbody : n, 고물, (미사일의 nose cone 배후의)동체
arterial : a, 동맥의, 동맥혈의
arterialization : n, (폐에 의한)정맥혈의 동맥혈화
arterialize : vt, (폐가 정맥혈을)동맥혈로 변화시키다
arterio : n, 동맥
arteriography : n, (x선에 의한)동맥 촬영(법)
arteriole : n, 소동맥
arteriosclerosis : n, 동맥경화증
arteriotomy : n, 동맥 절개(술)
arteriovenous : a, 동정맥의(을 잇는)
arteritis : n, 동맥염
artery : n, 동맥, 간선 도로
artesian well : x, (물줄기 있는 데까지) 깊이판 우물
artful : a, 교활한
art gallery : x, 미술관
arthistorical : a, 예술사의, 미술사의
arthralgia : n, 관절통
arthralgic : a, 관절통의
arthritic : a, n, 관절염의(에 걸린), 관절염 환자
arthritis : n, 관절염
arthropathy : n, 관절중
arthropod : n, 절지 동물(새우, 게, 거미, 지네 등)
Arthropoda : n, 절지 동물문
arthrosis : n, 관절
Arthur : n, 아더, 남자이름, 고대 영국의 전설적인 왕
Arthurian : a, n, 아서와의(에 관한), 아서왕 전설
artichoke : n, 힌꽃엉겅퀴(껑의 일부는 식용)
article : n, vt, (신문, 잡지의)논설, 기사, (같은 종류의 물건의)한 품목, 물품, 조목, 조항, 계약, 규약, 조목별로 쓰다
articled : a, 도제(살이)계약의
articular : a, 관절의
articulation : n, 마디, 관절, 분절, 접합, 똑똑히 발음함
articulator : n, 발음이 또렷한 사람, 조음기관
articulatory : n, 유음절의 조음(상)의 발음을 또렷하게하는 사람
artifact : n, 가공품, 고기물
artifice : n, 책략, 모략, 개교, 고안
artificer : n, 기술가, 장색, 장인, 제작가
artificial : a, 인공의, 인조의, 부자연스러운, 일부러 꾸민 것 같은
artificial : a, 인공의, 부자연스러운
artificial flowers : x, 조화
artificial horizon : x, 인공수정
artificial insemination : n, 인공수정
artificiality : n, 인공물
artificialize : vt, 인위적으로 하다, 부자연스럽게 하다
artificial leather : x, 인조피혁
artificially : ad, 인위적으로, 부자연하게
artificial person : x, 법인
artificial respiration : x, 인공호흡
artificial satellite : x, 인공위성
artificial selection : x, 인위도태
artificial silk : x, 인조견
artillerist : n, 포병
artillery : n, 대포, 포병, 포술, 포학
artilleryman : n, 포병, 포사수
Artiodactyla : n, 우제류(소, 염소, 양등)
artisan : n, 장색
artist : n, 예술가, 화가
artiste : n, 예느인
artistic : a, 예술의, 미술의, 예술적인, 미술적인, 멋있는
artistically : ad, 예술(미술)적으로, (문장 전체를 수식하여)예술적으로 보아서(보면)
artistry : n, 예술적기교, 예술품
artless : a, 무기교의, 단순한, 천진스러운
artmobile : n, 이동(순회)미술관, 이동 화랑
artotype : n, =COLLOTYPE
art paper : x, 아트지
artrological : a, 
artsycraftsy : a, =ARTYANDCRAFTY
artwork : n, 수공예품, 예술적 제작 활동, (본문에 대하여)삽화, 도판 제작
arty : a, 예술가연하는
arum : n, 천남성과의 식물(calla 따위)
Aryan : a, n, 아리아족
aryballos : n, (고대 그리스의)향유 병(목이 짧고 공 모양임)
aryl : n, 아릴기
arytenoid : a, n, 피열의, 피열, 연골, 피열근
as : ad, 같을만큼, 그 만큼, 처럼, 같이, 로서, 하면서, 함에따라
asafetida : n, 아위, 그 진으로 만든 약(경련 진통제, 구충제)
asbestine : a, 석면의, 불연성
asbestos : n, 석면, 돌솜
asbestosis : n, 아스베스토증, 석면(침착)증
ascariasis : n, 회충증
ascarid : n, 외충
ascend : vi, 올라가다, 오르다, 오르막이되다, 시대가 거슬러 올라가다
ascendance : n, =ASCENDANCY
ascendancy : n, 욱일승천의 세력, 우세, 패권, 지배권
ascendant : a, n, 상승하는, 우세한, 우월한, 우의, 세력
ascender : n, ascend 하는 사람(사물)
ascending : a, 오르는, 상승적인, 위를 향한
ascension : n, 상승, 즉위, 예수의 승천
ascensional : a, 상승의(하는)
Ascension Day : x, 예수 승천일(Easter후 40일째의 목요일)
Ascensiontide : n, 승천절(예수 승천일로부터 성령 강림제 까지의 10일간)
ascensive : a, 상승하는, 진보적인, 강조의, 강의적인
ascent : n, 상승, 오름, 등산, 오르막
ascent propulsion system : x, 우주 정거장 귀환용 로켓 엔진
ascertain : vt, 확인하다, 알아내다
ascetic : n, a, 고행자, 금욕생활자, 고행의, 금욕적인
asceticism : n, 금욕주의, 고행(생활), 수덕주의
ascidian : n, a, 해초류의
ascidium : n, 배엽, 낭상엽
ascites : n, 복수(증)
Asclepius : n, 아스클레피오스
ascocarp : n, 자낭과
ascomycete : n, 자낭균류
ascorbate : n, 아스코르브 산염
ascorbic acid : x, 아스코르빈산(비타민 c의 별명)
ascospore : n, 자낭포자
Ascot : n, 영국의 경마장, 에티켓경마(6월 제 3주에 행함)
ascribable : a, 돌릴 수 있는
ascribe : vt, 돌리다, 탓으로 하다
ascription : n, 탓으로 함, 귀속시킴, 설교자가 설교 끝에 신을 찬미하는 말
ascription : n, 돌림, 이유붙임
ascus : n, 자낭
asdic : n, 수중(음파)탐지기
asdic : n, 잠수함탐지기
aseasonal : a, 계절적이 아닌, 계절에 관계 없는, 비계절상의
aseismatic : a, 내진의
aseity : n, 자존성
asentee landlord : x, 부재지수
asepsis : n, 무균상태, 무균법
aseptic : a, 균이없는, 방부성
ases : n, AXIS의 복수형
asexual : a, 성별이없는, 무성의
asexuality : n, 무성
Asgarde : n, 아스가르드(신들의 천상의 거처)
ash : n, 양풀푸레나무
ash : n, 재, 유골, 폐허, 유골, 회색, 창백
ashamed : a, 부끄러이 여겨, 낯을 붉히어, 부끄러워하여
Ashanti : n, 아샨티(아프리카 서부의 구 왕국, 현재는 가나의 한 주)
ash can : x, 재 담는 통, 쓰레기통, 폭뢰
ashen : a, 양물푸레나무(제의, 재의, 회색의, 창백한)
Asher : n, 남자 이름, 아셀(야곱의 여덟째 아들), 아셀족
ashiver : a, 몸을 떠는, 떨고 있는
Ashkenazi : n, 아시케나지(독일, 폴란드 지방에 사는 유대인)
ashkey : n, 물푸레나무의 익과
ashlar : n, 떠 내어 다듬은 돌
ashlaring : n, 마름돌 기, 지붕 밑의 칸막이
ashman : n, 쓰레기청소부
ashore : ad, 해변에, 물가에
ashpale : a, 회백색의, 창백한
ashpan : n, (난로의)재받이
ashpit : n, (난로 안의)재 떨어지는 구멍
ashram : n, (힌두교의)은둔자의 암자, 하패의 집(부락)
Ashtoreth : n, (구약 성서의)아스다롯
ashtray : n, 재떨이
Ash Wednesday : x, 성회 수요일(Lent의 첫날)
ashy : a, 재의, 회색의, 재투성이의
Asia : n, 아시아, 아시아주
Asiadollar : n, 아시아 달러
Asia Minor : x, 소아시아
Asian : a, n, 아시아풍의, 아시아의, 아시아사람
Asianization : n, 아시아화
asiatic : a, n, 아시아사의
asicism : n, 금욕주의, 고행
asinine : a, 나귀의, 어리석은
asininity : n, 고집(센 언행), 어리석음, 우둔한 행실(성질)
ask : vt, vi, 묻다, 물어보다, 부탁하다, 청구하다, 초청하다, 필요로하다, 결혼예고를발표하다
askance : ad, 모으로, 비스듬듬히, 곁눈질로(look askance at ...을 곁눈질로 흘기다, 으심쩍게 보다
askant : ad, 곁눈질로, 비스듬히
askari : n, (유럽 사람이 훈련한)아프리카 원주민병
asker : n, 묻는 사람, 구하는 사람, 기지
askew : ad, 한쪽에, 반대로뒤틀리어, 일그러져, 모으로, 비스듬히
asking : n, 질문, 의뢰, 부탁, 청구
aslant : ad, 비스듬히, 기울어져
asleep : ad, 잠들어, 영면하여, 활발치않아서, 마비되어, 팽이가서서
aslope : ad, a, 경사져서, 비탈(언덕)져서
asnamedly : ad, 부끄러워서
asocial : a, 비사교적인, 이기적인
asp : n, 독사, 특히 이집트의 독사
asparagine : n, 아스파라긴(식물에 많은   아미노산의 일종)
asparagus : n, 아스파라거스, 
aspartame : n, 강력한 인공감미료의 일종
aspartokinase : n, 아스파르토키나제, 아스파르트산 키나제
Aspasia : n, 아스파샤
aspect : n, 국면, 양상, 광경, 모습, 얼굴생김새, 방향, 방위
aspectual : a, aspect의
aspen : n, a, 사시나무, 사시나무의, (와들와들)떠는
asperge : vt, 성수를 뿌리다(살포하다)
Asperges : n, (주일 High Mass 전의)살수식, 살수식의 성가
aspergillosis : n, 아스페르길루스증
aspergillum : n, 성수채
asperity : n, 꺼칠꺼칠함, 격렬함, 퉁명스러움
asperse : vt, 나쁜 소문을 퍼뜨리다, 중상하다, 세례의 물을 뿌리다
aspersion : n, 비방, 중상
aspersorium : n, 성수반
asphalt : n, 아스팔트
asphaltic : a, 아스팔트(질)의
asphaltite : n, 아스팔트광(천연 아스팔트)
asphalt jungle : x, 도시의 밀림(약육 강식장으로서의 대도시)
aspheric : a, 비구면의
aspherics : n, 비구면 렌즈
asphodel : n, 아스포델(백합과의식물, 남 유럽산)
asphyxia : n, 질식, 가사
asphyxiate : vt, 질식시키다
asphyxiation : n, 질식, 기절, 가사상태
asphyxiator : n, 질식체, 질식 장치, 동물 질식시험기, 소화기(탄산가스를 응용한)
aspic : n, 고기젤리
aspidistra : n, 엽란
aspirant : a, n, (넝은 지위등을)갈망하는, 갈망하는사람, 지망자
aspirate : n, a, 기음의, 기식음의, 기식음으로 발음하다, (h)음을 넣어 발음하다
aspirated : a, 음의
aspiration : n, 갈망, 대망, 빨아냄, 기음, 포부
aspirator : n, 아스퍼레이터, 흡인기
aspiratory : a, 흡기(호흡, 흡인)의(에 알맞은)
aspire : vi, 갈망하다, 올라가다, 치솟다, 동경하다
aspirin : n, 아스피린
aspiring : a, 열망하는, 큰뜻이 있는, 갈망하는
asprawl : ad, a, (팔다리를 쭉 뻗고)누워서
asquint : ad, 곁눈질로, 흘긋, 비스듬히
asrea bombing : x, 전지역폭격
ass : n, 당나귀, 마보, 외집쟁이
assafetida : n, =asafetida
assai : ad, 매우
assail : vt, 습격하다, 엄습하다, 논란하다, 감연히 에 부탁치다
assailable : a, 공격할 수 있는
assailant : n, 공격의, 공격자
Assam : n, 아삼(인도 북동부의 주, 주의 수도 Shillong)
Assamese : a, 아삼 지방의, 아삼 사람(말)의
assart : n, vt, 개간(지), 개간하다
assassin : n, 암살자, 자객
assassinate : vt, 암살하다
assassination : n, 암살
assassinator : n, 암살자
assault : n, 습격, 강습, 돌격, 강간, 폭행, 협박, 강습하다, ...에게 폭행을 가다다, 공격하다
assaultive : a, 공격적인
assay : n, vt, 시금, 시금하다, 분석, 분석하다, 시험, 시험하다, 분석물
assegai : n, (남아프리카 원주민이 사용하는)가느다란 창(으로 찌르다)
assemblage : n, 모임, 집합, 집회, 조립, 회음
assemblagist : n, 아상블라지스트
assemble : vt, vi, 모으다, 모이다, 집합하다, 짜맞추다, 조립하다, 컴퓨터 언어로 변역하다
assembled : a, 집합된, 결집한, 합성 보석의
assembler : n, 조립자, 어셈블러, 기호변환 프로그램
assembly : n, 집합, 집회, 무도회, 회의, 입법의회, (주의회의)하원, 집합 신호, (자도차 등 부품의)조립, 조립 부품
assembly : n, 집회, 무도회, 회의, 집합, 입법회의, 집합신호, 조립
assembly hall : x, 회의장, 조립공장
assembly language : x, 어셈블리언어
assembly line : x, 일관작업조직
assemblyman : x, 의원
assembly plant : x, 조립공장
assembly room : x, 집회실, 회의실
assent : n, vi, 승낙하다, 동의하다
assentation : n, 동의, (특히)영합, 부화 뇌동
assentient : a, n, 동의의, 찬성자의, 동의자, 찬성자
assentor : n, 동의자, 찬성자
assert : vt, 단언하다, 주장하다
assertion : n, 주장, 단언, 독단
assertive : a, 단정적인, 고집하는, 독단적인
assess : vt, 과세하다, 시정하다, 평가하다, 할당하다
assessable : a, 시정할 수 있는, 평가할 수 있는
assessment : n, 수입사정, 부과, 재산평가, 할당액
assessor : n, 재산평가인, 과세평가인
asset : n, 자산, 자산의 한 항목, 재산, 가치있는것
asseverate : vt, 서언하다, 단언하다(state positively)
asseveration : n, 서언, 단언
asshead : n, 바보
asshole : n, 가장 싫은 장소, 지겨운 녀석, 친구
assibilate : vt, 치찰음으로 발음하다, 치찰음화 하다
assiduity : n, 근면, 배려
assiduous : a, 근면한, 빈틈없이 손이 미치는
assign : vt, 할당하다, 배당하다, 명하다, 맡기다, 지정하다, 돌리다, 양도하다
assignable : a, 할당할 수 있는, 지정(지시)할 수 있는, (...에)돌려야 할, 돌릴수 있는, 양도할 수 있는
assignation : n, 할당, 지정, 밀회의약속, 재산의 양도
assignee : n, 양수인, 수탁자, 관재인
assignment : n, a, 할당, 임명, 서임, 할당된, (임명된)직, 지위
assignor : n, 양도인
assimilability : n, 동화성, 동화할 수 있음
assimilable : a, 동화할 수 있는
assimilate : vt, vi, n, 동화하다, 흡수하다, 소화하다, 이해하다, 비교하다, 동화하다, 비슷해지다, 동화된 물건
assimilation : n, 동화
assimilative : a, 동화의
assimilator : n, 동화하는 사람(것)
assimilatory : a, =ASSIMILATIVE
assist : vt, vi, n, 돕다, 거들다, 참석하다조력, 포살
assistance : n, 조력, 원조, 참석자
assistant : a, 보조의, 보좌의
assistant : a, n, 조수, 보조의, 점원
assistant professor : x, 조교수
assistor : n, 방조자
assize : n, 재판, 순회재판
asskisser : n, 아첨쟁이, 굽실거리는 사람
associability : n, 연상 되기 쉬운 것(성질), 교감성
associable : a, 연상되는, 교감성의
associate : vt, vi, n, a, 연합시키다, 공동시키다, 연상하다, 교제하다, 동료, 한동아리, 준회원, 연상되는것
associated : a, 연합한, 조합의, 합동의
associate judge : x, 배심판사
associate professor : x, 부교수
association : n, 연합, 합동, 결합, 조합, 연상, 관념연합, 교제, 친밀
associational : a, 사단의, 연상의
association football : x, 축구, 사커(soccer)
associationism : n, 관념 연합설, 관념 연합론자
associative : a, 연합의, 결합하는, 연상의
associator : n, 동료, 조합원
assoil : vt, 사면하다, 석방하다, 속하다, 보상하다
assonance : a, 유음, 협음, 모운(반복되는 모음으로 만들어지는 운율)
assonant : a, 유사음(유음)의, 유운의, 모운(반복되는 모음으로 만들어지는 운율)의
assonate : vi, 음(모음)이 일치하다, 모음운을 밟다
assort : vt, 분류하다, 갖추다, 짝 맞추다
assorted : a, 유별한
assortment : n, 종별, 유별
assuage : vt, 누그러지게하다, 가라앉히다
assuagement : n, 경감, 완화
assuasive : a, 누그러지게하는, 진정시키는
assumable : a, 미루어 헤아릴 수 있는, 생각할 수 있는
assumabled : a, 짐짓꾸민
assume : vt, 떠맡다, 책음을지다, 짐짓     가장을하다, 가로채다, 생각하다, 가정하다, 몸에차리다
assumedly : ad, 아마, 필시
assuming : a, 주제넘는, 건방진
assumption : n, 떠맡음, 횡령, 가정, 상상, 건방짐, 주제넘음
assumptive : a, 가정의, 가설의, 건방지, 짐짓 꾸민
assurance : n, 보증, 확신, 자신, 철면피
assure : vt, 보증하다, 확신시키다, 납득시키다, 안심시키다, 보험에 넣다, 확실히하다
assured : a, 확실한, 자신있게, 보험에 부친
assuredly : ad, 확실하게, 자신있게, 대담히
assuredness : n, 확실, 확신, 철면피, 대담 무쌍
Assyria : n, 아시리아
Assyriology : n, 아시리아학
astatic : a, 불안정한, 무정위의
astaticism : n, 무정위
astatine : n, 아스타틴(방사성 원소, 기호)
aster : n, 과꽃, 탱알, 핵분열의 성상체
asteria : n, 성채석(보석)
asterisk : n, vt, 별표, 별표를달다
asterism : n, 3 별표, 성군, 별자리
astern : ad, 고물에, 뒤에
asteroid : a, n, 별모양의(화성과 목성 궤도간의), 작은유성의, 불가사리
asteroidal : a, 소행성의, 불가사리(무리)의
asthenia : n, 무력증, 쇠약
asthenic : a, 무력증의, 허약한, 쇠약한, 무기력형의
asthenopia : n, 안정피로
asthenosphere : n, (지표에 가까운)암류권, 취약권, 약대
asthma : n, 천식
asthmatic : a, n, 천식의
astigmatic : a, 난시의, 난시교정의
astigmatism : n, 난시, 비점수차
astir : ad, a, 움직여, 일어나, 술렁거려, 활동하여
astoldto : a, 담화에 의거하여 전문 저작자가 쓴
astomatous : a, 입이 없는, 기공이 없는
astonied : a, 얼마 동안 움직이는 힘을 잃고, 깜짝 놀라
astonish : vt, 놀라게하다
astonished : a, (깜짝)놀란
astonishing : a, 놀라운
astonishingly : ad, 놀랍게
astonishment : n, 놀라움, 경악
astound : vt, 놀라게하다
astounded : ad, 몹시 놀라
astounding : a, 몹시 놀라게 하는, 어안이 벙벙하게 하는
ASTP : x, Army Specialized Training Program
astraddle : ad, 걸치어, 걸친
Astraea : n, 아스트라이아(정의의 여신)
astragal : n, 염주쇠시리
astragalus : n, 복사뼈, 거골(anklebone), 자운영
astrakhan : n, 아스트라칸(소련Astradhan 지방산 새끼양의 털가죽), 아스트라칸을 모조한 직물
astral : a, 별의, 별이 많은, 별로부터의
astral lamp : n, 무영등
astration : n, 제한, 속박, 변비, 수렴
astray : a, ad, 길을잃어, 타락하여(g0~기을 잃다, 잘못하다, 타락하다)
astrictive : a, n, 제한적인, 변비성의, 수렴제
astride : ad, 걸터앉아, 걸치어
astringe : vt, 수축(수렴)시키다, 변비증을 일으키다
astringency : n, 수렴성
astringent : a, n, 수렴성의, 엄격한, 수렴제
astrionics : n, 우주전자공학
astro : a, =ASTRONAUTICAL
astro : x, , =ASTR
astrobiology : n, 천체생물학
astrobleme : n, (지표의)운석공
astrobotany : n, 우주(천체) 식물학
astrochemistry : n, 우주(천체)화학
astrocompass : n, 천측 컴퍼스, 성측 나침반
astrocyte : n, 성상 세포
astrodome : n, 천체관측실
astrodynamics : n, 천체역학
astrogate : vt, vi, (우주선, 로켓의)우주 항행을 유도하다, 우주를 항행하다
astrogation : n, 우주 항행(특히 행성간의)
astrogation : n, 우주여행
astrogeology : n, 천체지질학
astrogony : n, 천체 진화론
astrograph : n, 천체 항법도
astrolabe : n, 천체관측의
astrologer : n, 점성가
astrologic : a, 점성술의
astrology : n, 점성학, 점성술
astromerty : n, 천체 측정학, 측정 천문학
astrometeorology : n, 천체 기상학
astrometer : n, 천체 광도 측정기
astronaut : n, 우주비행사
astronautess : n, 여류 우주 비행사
astronautical : a, 우주 비행(항행)의, 우주 비행사의
astronautics : n, 항주학, 우주비행술(항행학)
astronavigation : n, 천측항법, 우주 비행
astronette : n, 여류 우주 비행사, 여류 우주 항법 연구가
astronomer : n, 천문학자
astronomical : a, 천문학상의, 천문학적인, 거대한
astronomical observatory : x, 천문대
astronomical tiom : x, 천문시(년)
astronomy : n, 천문학
astrophotograph : n, 천체 사진
astrophotography : n, 천체사진술
astrophotometer : n, 천체 광도계(측정기)
astrophysicist : n, 천체 물리학
astrophysics : a, 천체 물리학의
astrosphere : n, 중심구, (세포의 중심체를 뺀)성상체
Astroturf : n, 인공잔디
astrut : a, 뽐내며, 의기양양하게, 뽐내는, 빈틈없는, 교활한
astute : a, 기민한, 눈치 빠른, 빈틈없는, 교활한
astute : a, 날카로운, 기민한, 교활한
Astyanax : n, 아스티아낙스
astylar : a, 무주식의
ASU : x, Arab Socialist Union
Asuncion : n, 아순시온(남미 파라과이의 수도)
asunder : n, 파라광이의 수도
Aswan : n, 이집트 남동부의 도시
aswarm : ad, (장소, 건물 등이 ....으로)충만하여, 득실거려, 우글우글하여, 혼잡하여
aswirl : a, 소용돌이 쳐서
aswoon : a, 졸도(기절)하여
asylum : n, 수용소, 양육권, 정신병원, 도피처
asymmetric : a, 비대칭의
asymmetry : n, 비대칭, 불균정
asymptomatic : a, 징조(조짐, 징후)가 없는, 자각 증상이 없는
asymptote : n, 점근선
asynchronism : n, 비동시성
asynchronous : a, 비동시성의, 비동기의
asynchrony : n, AHYNCHRONISM
asyndetic : a, 뒤락의 맥락이 없는, 접속사를 생략한
asyndeton : n, 연결사 생략
asyntactic : a, 통사법에 의거하지 않은, 비문법적인
at : ad, 에, 때에, 하는중에, 하여, 을 향하여, 을 통하여, 에접하여, 하게, 으로
Atabrine : n, 아타브린(말라리아 예방약)
Atalanta : n, 그리스신화에서 걸음이 빠른미녀
atamaaco : n, (수선화과의)달래꽃무릇속의 각종 다년초
ataman : n, HETMAN
ataractic : n, a, 정신안정제의
atarxy : n, 무감동, 냉정, 태연
atavism : n, 격세유전
atavist : n, 격세 유전에  의한 형질을 가진 개체
atavistic : a, 격세 유전적인
ataxia : x, 운동 실조(특히 손발의)
atbat : n, 타수
ate : v, cat의 과거
atelier : n, 아틀리에, 화가나 조각가의 작업실
atempo : ad, 보통도로
atemporal : a, 시간에 영향을 받지 않는, 특정한 시간을 내세우지 않는
Aterian : n, a, (북아프리카 구석기시대 중기의)아테리아 문화(기)(의)
atersia : n, (관, 공, 강 등의)폐쇄(증)
Atest : n, 원폭 실험
athanasia : n, 불사, 불멸(immortality)
Athanasian : a, 아타나시우스의
Athanasius : n, 아리우스교의 반대자
athanasy : n, ATHANASIA
atheism : n, 무신론
atheismist : n, 무신론자
atheistic : a, 무신론의
atheling : n, 왕자, 귀족, (특히)황태자
Athelstan : n, 남자 이름
Athena : n, 여자이름, =ATHENE
Athene : n, 여자 이름, 아테네(아테네의 수호신, 지혜, 예술, 전술의 여신
Atheneum : n, 아테나 신전
Athenian : n, a, 아테네의(사람)
Athens : n, 아테네(그리스의 수도)
atheoretical : a, 비논리적인
athermancy : n, 불투열성
athermanous : a, 불투열성의
atherogenic : a, (동맥)아테롬 발생성의 (식사)
atheroma : n, (피부에 생기는)분류, 아테롬
atherosclerosis : n, 아테롬(동맥 내벽에의 지방 침적)
athirst : pred, 목이타서, 갈망하여
athlete : n, 운동가, 경기자
athlete's foot : x, 무좀
athletic : a, 운동의, 운동경기의, 운동가 같은, 장장한
athleticism : n, 운동 경기(스포츠)열, 집중적(정열적)인 활동성
athletics : n, (각종의)운동경기, 스포츠, 필드 종목, 육상 경기, 체육 이론, 체육 실기
athodyd : n, 도관제트(엔진)
athome : n, 면회, 가정초대
athrill : ad, 흥분하여
athwart : ad, 을 가로질러, 에거슬러
athwartship : a, 선측에서 선측으로 선체를 가로지르는
athwartships : ad, 선체를 가로질러서
atichoo : int, n, =ATISHOO
aticulate : a, vt, vi, 분명한, (언어가)음절이 있는, 또렷한, 의견을 분명히 말할 수 있똑똑히 발음하다
atingle : ad, 얼얼하여, 쑤시어, 흥분하여
ation : n, 동작, 결과, 상태를 나타냄
atiptoe : ad, 발끝으로, 발돋움하여, 이제나저제나 하고 기다려
atishoo : int, 에취
atit : ad, a, (마상 시합에서)창을 겨누고, 기울어져(tilted)
ative : suf, 경향, 성질, 관계 등을 나타냄
Atkins : n, 영국 육군 병사, =Tommy Atkins
Atl. : n, 대서양 수송 기선(회사)
Atlantean : a, ATLAS같은, 힘이 센(strong), ATLANTIS섬의
atlantes : n, 남상기둥
Atlantic : n, a, 대서양의
Atlantica : n, 대서양 세계
atlanticism : n, 범대서양주의
atlantic ocean : x, 대서양
Atlantis : n, 신의 벌을받아 바다밑으로 가라앉았다는 전설의 대서양섬
atlarge : a, 전주 대표의(의원에 의해서)
Atlas : n, 지도책, 아라스(신의 벌로 하늘을 어깨에 짊어졌다는 거인), 수폭 탄두를 적재한 대륙간 탄도 유도탄
atlatl : n, (고대 멕시코의)창(화살)발사기
atm : n, 공기, 증기
atman : n, 생명의본원, 영혼
atmology : n, 증발학
atmometer : n, 증발계
atmosphere : n, 대기, 공기, 분위기, 주위의정황, 기분, 기압, 전체를 싸고 있는 가스체, (예술 작품의)풍격, 운치
atmospheric : a, 대기의, 대기중의
atmospherics : n, 공전
atmospherium : n, 기상변화 투영 장치(를 설비한 방(건물)
atoll : n, 환초
atom : n, 원자, 미진, 미량
atom(ic) bomb : x, 원자 폭탄
atomarium : n, 전시용 소형 원자로, 원자로 전시관
atomic : a, 원자의
atomic age : x, 원자력 시대
atomic airplane : x, 원자력 비행기
atomic carrier : x, 원자력 항공 모함
atomic clock : x, 원자 시계
atomic cocktail : x, (암 치료용의)방사성 내복약
atomic control : x, 원자력 관리
atomic disease : x, 원자병
atomic disintegration : x, 원자
atomic dust : x, 원자진
atomic electricity : x, 원자력 전기
atomic energy : x, 원자력 전기
Atomic Energy Commission : x, 원자력 위원회
atomic fissom : x, 원자핵 분열
atomic formula : x, 원자식설
atomic fusion : x, 원자핵 융합
atomic gun : x, 원자포
atomic mass : x, 원자 질량
atomic number : x, 원자 번호
atomic pile : x, 원자로(NUCLEAR REACTOR의 구칭)
atomic plant : x, 원자력 공장
atomic power : x, 원자력, 원자력 발전
atomic power plant : x, 원자력 발전소
atomic propulsion : x, 원자력 추진
atomic reaction : x, 원핵 반응
atomics : n, 원자 물리학
atomic ship : x, 원자력 함선
atomic submarine : x, 원자력 잠수함
atomic theory : x, 원자론
atomic time clock : x, 원자 연대 시계
atomic value : x, 원자가
atomic warfare : x, 원자력 전쟁
atomic warhead : x, 원자 탄두
atomic weapon : x, 원자 병기
atomic weight : x, 원자량
atomism : n, 원자론
atomistic : a, 원자로, 별개의 독립군으로 이루어진
atomistics : n, 원자 과학(특히 원자력의 개발, 이용을 취급)
atomization : n, 원자화, 분무 작용, 안개 모양으로 뿌림, 원자 폭탄(병기에 의한 파괴)
atomize : vt, 원자로만들다, 분무하다
atomizer : n, 분무기, 향수뿌리개
atom smasher : x, 원자핵 파괴 장치
atomy : n, 원자, 난쟁이
aton : vi, vt, 보상하다, 벌충하다, 속죄하다(make amends), 보상하다, 화해시키다
atonable : a, 보상할 수 있는
atonal : a, 무조의
atonalism : n, (작곡상의)무조주의, 무조 음악의 악곡(이론)
atonality : n, 무조성
atone : vt, vi, 보상하다, 배상하다, 속쇠하다
atonement : n, 보상, 죄값, 그리스도의 속죄
atonic : a, 악센트없는, 무강세의
atonic age : x, 원자력시대
atonic airplane : x, 원자력비행기
atonic bomg : x, 원자폭탄
atonic carrier : x, 원자력 항공모함
atonic clock : x, 원자시계
atonic control : x, 원자력관리
atonic cooktail : x, 방사성내복약
atonic disease : x, 원자병
atonic disintegration : x, 원자붕괴
atonic dust : x, 원자진
atonic electricity : x, 원자력전기
atonic energy : x, 원자력
atonic energy commission : x, 원자력위원회
atonic fission : x, 원자핵분열
atonic formula : x, 원자식
atonic fusion : x, 원자핵융합
atonic gun : x, 원자포
atonic mass : x, 원자질량
atonic number : x, 원자번호
atonic pile : x, 원자로
atonic plant : x, 원자력공장
atonic power : x, 원자력발전
atonic power plant : x, 원자력발전소
atonic propulsion : x, 원자력추진
atonic reaction : x, 원자핵반응
atonic ship : x, 원자력함선
atonic submarine : x, 원자력잠수함
atonic theory : x, 원자론
atonic time clock : x, 원자연대
atonic value : x, 원자가
atonic warfare : x, 원자력전쟁
atonic warhead : x, 원자탄두
atonic weapon : x, 원자병기
atonic weight : x, 원자량
atony : n, (수축성 기관의)아토니, 이완, 무강세
atop : ad, 꼭대기에
atopy : n, 아토피성(태생이 천식, 습진 등에 걸리기 위운 일종의 알레르기 체질)
ator : n, ...하는 사람(것)
atory : a, ...의, ...에 관계있는, ...같은, ...에 도움이 되는, ...에 의해 생기는
atoxic : a, 독이 없는
atrabiliar : a, =ATRABILIOUS
atrabilious : a, 우울증의, 침울한, 까다로운
atrazine : n, 아트가진(제초제)
Atreus : n, 아트레우스
atrioventricular : a, 심방(심실)의, 방실계의
atrip : ad, (닻이)막 해저를 떠나, (돛이)막 펴지게 되어
atrium : n, (로마 건축의)중앙 홀, 안뜰, 심방, 심이, 고실, 강(cavity, chamber)
atrocious : a, 흉악한, 흉포한, 잔학한, 지독한, 지겨운, 서투른
atrocity : n, 극악, 지독함
atrophia : ad, a, 셋이서(하는), 3자 사이에서
atrophic : a, 위축성의
atrophy : n, vi, vt, 쇠약, 쇠약하다, 위축하다
atropine : n, 아트러핀(진경제로 쓰이는 독약)
atropism : n, 아트로핀 중독
attaboy : int, 좋아, 됐어, 잘한다
attach : vt, 붙이다, 달다, 부착하다, 애정으로맺다, 구속하다, 소속시키다, 압류하다
attache : n, 수행원, 대사관
attachment : n, 부착, 붙임, 애착
attack : vt, 공격하다, 습격하다, 침범하다, 착수하다
attackman : n, 공격 위치의 선수
attain : vt, vi, 이루다, 달성하다, 이르다, 도달하다
attainable : a, 달성할 수 있는
attainder : n, 공권상실
attainment : n, 달성, 터득, 학식
attaint : vt, 공권을상실케하다, 더럽히다
attanhable : a, 붙일 수 있는, 압류할 수 있는, 구속할 수 있는
attar : n, 꽃의 정, 장미향수
attched : a, 붙여진, 덧붙여진, 첨부된, 부속의, 소속하여, 가입하고
Attcize : vt, vi, 아테네식으로 하다, 아테네인을 좋아하다
attemper : vt, (섞어서)완화(가감)하다, ...의 온도를 조절하다, 맞추다
attempt : vt, n, 시도하다, 해보다, 꾀하다, 노리다, 시도, 노력, 습격
attempted : a, 기도한, 미수의
attend : vt, vi, 출석하다, 다니다, 모시다, 섬기다, 간호하다, 주의하여듣다, 수행하다
attendance : n, 출석, 시중, 참석, 돌봄, 간호, 출근
attendant : a, n, 부수의, 시중드는, 수행의, 출석의, 곁에 따르는 사람, 수행원, 수반물, 출석(참석)자
attendee : n, 출석자
attending : a, (어떤 환자의)주치의인, 대학  부속병원에 의사로서 근무하는
attention : n, 주의, 고려, 주의력, 배려, 보살핌, 친절, 정중, 정중한, 응급치료
attentiongetter : n, 주목을 끄는 것
attentive : a, 주의깊은, 경청하는, 정중한, 친절한
attenuant : a, n, 희석하는, (혈액의)희석제
attenuate : vt, vi, 얇게하다, 묽게하다, 약화하다
attenuation : n, 회박화, (전류, 전압 등의)감쇠, 저하
attenuator : n, (소리, 크기등의)멸쇄기
attest : vt, vi, 증명하다, 증언하다, 맹세시키다, 선서시키다
attestation : n, 증명, 선서, 증거
attested : a, 증명(입증)된, (소, 우유가)무병(무균)보증된, 공정 기준 합격의
attester : n, (증서 작성의)입회 증인
attic : n, 다락방
attic : a, 아테네풍의, 고전풍의, Attica어(Plato나 Sophocles의 일상어)
Attica : n, 고대그리스의 한지방
Attic faith : x, 굳은 신의
Atticism : n, 아테네인 애호, 아테네 문학의 특질, 아테네 특유의 말, 간결하고 우아한 표현
Attic order : x, 아티카식(각주식)
Attic salt : x, 기지, 점잖은 익살
attila : n, 훈족의왕
attire : n, 옷차림새, 의복, 복장
attirement : n, 의복, 복장
attitude : n, 자세, 태도, 몸가짐, 배행자세
attitudinal : a, 태도의(에 관한), 개인적인 의견에 관한(기초를 둔)
attitudinarian : n, 점잔빼는(젠체하는)사람
attitudinize : vi, 짐짓빼다, 점잔빼다
attorn : vi, vt, (양도의 결과)새 지주를 승인한다, (새 지주에게)양도하다
attorney : n, 대리인, 변호사
attorney general : x, 법무장관
attorneyship : n, attorney의 직(신분), 대리권
attornment : n, 양도, 새 지주승인
attract : vt, 끌다, 끌어당기다, 매혹하다, 유혹하다
attractant : n, a, 유인하는, 잡아끄는것
attraction : n, 끄는 힘, 인력, 흡인(력)
attractive : a, 사람의마음을끄는, 관심을 끄는, 인력이있는
attributable : a, 에 돌릴 수 있는
attribute : vt, n 에 돌리다, 탓으로돌리다, 속성, 특질, 불어다니는 것(neptune이 갖고 있는 trident 따위), 표지, 한정사
attributive : a, n, 속성의, 한정적인, 관형적인, 한정사
attrition : vt, 마찰, 마손
attune : vt, 가락을 맞추다, 맞추다
atwitter : a, 안절부절못하여
atyical : a, 전형적이 아닌, 부정형의, 불규칙적인
aubade : n, 아침의
auberge : n, 주막, 여인숙(inn)
aubergine : n, 가지(열매), 가지색, 암자색
aubrietia : n, 평지과의 관상 식물
auburn : n, a, 적갈색, 적갈색의
auction : n, 경매하다
auction bridge : x, 으뜸패를 경락시키는 브리지
auctioneer : n, 경매인
auctorial : a, 저자의, 저자에 의한
audacious : a, 대담한, 뻔뻔스러운
audacity : n, 대담, 뻔뻔스러움
audial : a, 청각의(에 관한)(aurla)
audibility : n, 들을 수 있음, 가청도
audible : a, 들리는, 들을 수 있는
audibly : ad, 들리도록, 들을 수 있게
audience : n, 청중, 과객, 청취자, 독자, 알현, 들음
audience chamber : x, 접견실
audience rating : x, 시청률
audience rating : x, 으뜸패를 경락시키는 브리지
audient : a, n, 청취의, 경청하는, 듣는 사람
audile : n, 청각형의 사람(cf.MOTILE, VISUALIZER)
auding : n, 청해(말을 듣고 이해하는 작용)
audio : a, 저주파의
audiocassette : n, 녹음 카세트, 카세트 녹음
audiodontics : n, 청치과학(청각과 치아와의 관계에 대한 연구)
audio frequency : x, 저주파
audiogenic : a, (발작 등이)고주파음에 의한
audiogram : n, 오디오 그램, 청력도
audiolingual : a, (언어 학습에서)귀와 입을 사용하는, 청각 구두의
audiology : n, 청각 과학, 청력(청각)학, 청능학
audiometer : n, 청력계, 음향측정기
audiometry : n, 청력 측정(법)
audion : n, 진공관 검파기
audiophile : n, 고급하디오, 하이파이애호가
audiospectrograph : n, (사운드 패턴을 기록하는)분음 기록 장치
audiotactile : a, 청각 및 촉각의
audiotape : n, 음성녹음테이프
audiotypist : n, 녹음 테이프에서 직접 타자하는 타이피스트
audiovisual : a, 시청각의, 시청각 교재의(를 사용한)
audiphone : n, 보청기
audit : n, 회계검사, 감사, 결산보고
auditing : n, 회계 감사(학)
audition : n, 들음, 청력, 청각, 오디션
auditive : a, 귀의, 청각의
auditor : n, 방청자, 회계검사관, 감사, 청강생
auditorial : n, a, 회계 감사원(의)
auditorily : ad, 청각(청력)에 의하여
auditorium : n, 청중석, 관중석, 강당, 공회당
auditory : a, 귀의, 청각의
auditress : n, auditor의 여성형
Audrey : n, 여자 이름
au fait : x, 수련하여, 정통하여
Aufklarung : n, 계몽, (18세기 독일의)계몽 사조(운동)
aufond : ad, 근본적으로는, 실제는
auf wiedersehen : x, 안녕
Augean : a, 아우게이아스(Augeas), 왕의, 지극히 불결한(filthy)
augend : n, 피가산수
auger : n, 큰 송곳, 타래송곳
aught : n, ad, for~i care 내게는 관심 없다, 아무래도 상관 없다, for~i know 내가 알고 있는 한, 아마
augite : n, 보통 휘석
augment : vt, vi, 늘다, 늘리다, 증대하다, 증가하다
augmentation : n, 증대, 증대물, 증가율
augmentative : a, n, 느는, 증대하는, 증가하는, 확대의, 확대사
augmented : a, 증가된, 증음된
augmenter : n, 증대시키는 사람(것), 오그멘터(로켓 엔진의 추진 보조 장치), 위험한 일을 하는 로봇
augur : n, vt, vi, 복점관, 예언자, 점치다, 예언 조짐이 되다
augural : a, 점의, 예언의, 전조의
augury : n, 점, 전조
August : n, 8월
august : a, 당당한, 존귀한
Augusta : n, 여자 이름
Augustan Age : x, 아우구스투스 시대(라틴 문장의 황금 시대), 문웅 융성시대
Augustine : n, 성아우구스티누스
Augustinian : n, St.Augustine의 (교의 신봉자)
Augusttan : a, n, 로마 황제 Augustus(시대)의작가
augustus : x, 로마최초의 황제
aujtomorphism : n, 자기 동형, 자형
au jus : n, (고기 요리에서)고깃국물을 부은
auk : n, 바다쇠오리
auklet : n, 작은바다쇠오리
auld : a, =OLD
auld lang syne : x, 그리운 예날
aulic : a, 궁정의
AUM : x, air-to-underwater missile a.u.n.
aunt : n, 아주머니, 숙모, 백모, 고모
auntie : n, 아줌마, 미사일 요격용 미사일
Aunt Sally : x, 파이프를 떨어뜨리는 놀이, 표적
au pair : x, 상호원조의
au pair girl : x, 영어공부를 목적으로 영국에서 가사일을 돕는 외국인 여학생
aupied de la lettre : x, 문자(그)대로
aura : a, (사람이나 물체로부터의)발기체, 미묘한 분위기
aural : a, 귀의, 청력의, 청각의
auralize : vt, ...을 마음으로 듣다, ...의 음을 상상하다, 청각화 하다
auraloral : a, (외국어 교수법이)귀와 입에 의한
auramine : n, 오러민(황색 물감)
aureate : a, 금빛의
Aurelia : n, 여자 이름
aurelia : n, (특히 나비의)번데기, 무럼해파리속
aurelian : n, aurelia의, 나비, 나방 연구가, 곤충 채집가
Aurelius : n, 로마황제, 스토아파의철학자
aureo;a : n, =AUREOLE
aureole : n, 후광, 무리
Aureomycin : n, 오레오마이신
aureus : n, 아우레우스(옛로마의 금화)
au revoir : n, 안녕
auric : a, 금의
auricle : n, 외이, 귓바퀴, (심장의)심이, 이상부, 이상물
auricle : n, 귓바퀴, 외이, 심이, 귀 비슷한 것
auricula : n, 앵초의 일종(노란 꽃이 피는)=AURICLE
auricular : a, 귀의, 청각의, 귓속말의, 가만히 말한
auriferous : a, 금을 산출하는
auriform : a, 귀 모양의
aurify : vt, 금으로 바꾸다, 금빛으로 물들이다
Auriga : n, 마차꾼자리
Aurignacian : n, a, 오리냑 문화(기) (의)
auriscope : n, 검이경
aurist : n, 이과의사
aurochs : n, (유럽산의)들소
Aurora : n, 오로라, 서광
aurora : n, 서광, 여명(dawn), 오로라, 극광
aurora borealis : x, 북극광
auroral : a, 극광의, 새벽의, 빛나는
aurous : a, 금의, 금을 함유한, 제 1금의
aurum : n, 금(Au)
Auschwitz : n, 아우슈비츠(폴란드의 도시, 2차 대전중 유대인을 대량 학살한 곳)
auscultate : vt, 청진하다
auscultation : n, 청진, 들음
auscultator : n, 청진자, 청진기(stethoscope)
auscultatory : a, 청진의
Ausgleich : n, 협정, 타협
auslander : n, 외국인
auspicate : vt, 행운을 빈 다음(택일하여)시작하다(inaugurate)
auspice : n, (새의 나는 모양으로 판단하는)점, 후원, 조짐, 길조, 유리한정세, 후원, 찬조
auspicious : a, 길조의, 상서로운, 행운의
Aussie : n, 오스트레일리아
Aust : x, Australia(n), Austria(n)
Austen : n, 영국의 여류 소설가
austere : a, 엄격한, 가혹한, 극도로간결한, 신, 떫은
austerity : n, 엄격, 엄숙, 간결, 내핍 생활
austerity program : x, 내핍계획(국내 소비 억제, 수출 증대로 국민 경제를 개조하려는 계획)
Austin : n, 남자 이름(Augustine의 변형), 미국 Tesas 주의 주도, 영국제 소형 자동차의 명칭
Austin : n, 영국제자동차
austral : a, 남쪽의, 오스트레일리아의
Australasia : n, 오스트랄라시아
Australasian : a, n, 오스트랄라시아의 (사람)
Australia : n, 호주
Australian : a, 호주의(사람)
Australianism : n, 오스트레일리아 사람의 기질(국민성, 국민 정신), 오스트레일리아 영어
Australian Rules : x, 18명이 하는 럭비 비슷한 구기
Australoid : n, 오스트랄로이드(의)(호주 원주민 및 그들과 인종적 특징이 같은 호주 주변의 여러민족)
australopithecine : a, 오스트랄로피테쿠스계의 (화석인)(가장 오래된 화석 인류)
australopithecus : n, 오스트랄로 피테쿠스
Australorp : n, 오스트랄로프종(닭)(호주에서 개량된 흑색 산란 닭)
Austria : n, 오스트리아
AustriaHumgary : n, 오스트리아헝가리(옛 연합 왕국)
Austrian : a, n, 오스트리아의, 오스트리아사의사람
Austro : x, , Austria, Austrian, Australian
Austroasiatic : a, 오스트로아시아 어족의
Austronesia : n, 오스트로네시아(태평양 중남부의 여러 섬)
austronesia : n, 오스트로네시아(태평양 중남부의 제도)
Austronesian : a, n, 오스토로네시아의, 오스트로네시아 어족
aut : x, =AUTO
autacoid : n, 자가약물
autarch : n, 독재자
autarchic : a, 독재의, 전제의
autarchical : a, 독재의, 전제의
autarchy : n, 절대주권, 전제정치, 자치
autarkist : n, 경제 자립 주의자
autarky : n, 경제적자급자족, 경제자립정책
autecology : n, 개체 (종)생태학
auteur : n, (독창적, 개성적)영화 감독, 작자, 저작자
auteurism : n, =AUTEURTHEORY
auth : x, authentic, author, authority, authorized
authentic : a, 믿을만한, 확실한, 진짜의, 전정한, 권위있는
authentically : ad, 확실히
authenticate : vt, 확증하다, 증명하다
authentication : n, 확증, 증명
authenticator : n, 입증자, 인증자
authenticity : n, 진실성
author : n, 저자, 창시자, 하수인, 저작, 본인
authoress : n, 여류(규수)작가(다소 경멸적으로 쓰임)
authorial : a, 저자(작자)의
authoritarian : a, n, 권위주의의, 독재주의의, 권위주의자
authoritative : a, 권위있는, 믿을만한, 관현의, 당국의, 명령적인
authoritatively : ad, 엄연하게, 명령적으로
authority : n, 권위, 권력, 권능, 권위자, 당국, 관례, 대가, 권한
authorization : n, 위임, 인가
authorize : vt, 권한을주다, 권능을주다, 위임하다, 인가하다, 정당하다고인정하다
authorized : a, 권한을 부여받은, 공인된, 검정필의
Authorized Version : x, 성서(1611년 영국왕 Jamesl의 명령으로 발행된 영역 성경)
authorless : a, 저자 불명의
authorling : n, 서투른 글장이
authorpublisher : n, 자저 발행자
authorship : n, 저작자임, 저술업, (저작물의)원작자, 저자, (소문 등의)출처, 근원
autism : n, 자폐증
autistic : a, 자폐성(자폐증)의
auto : n, 자동차
autoaggressive : a, =AUTOIMMUNE
autoalarm : n, (선박등의)자동 경보기(장치)
autoanalysis : n, (심리학적)자기 분석, 자동 분석
autoanalyzer : n, 자동분석기
autoantibody : n, 자기 항체
autobahn : n, (독일의)고속차 전용 도로
autoball : n, 오토볼(자동차에 의한 축구 시합, 브라질에서 시작됨)
autobiographer : n, 자서작가
autobiographic : a, 자서전의
autobiographical : a, 자서전(체)의
autobiography : n, 자서전
autoboat : n, 발동기선
autobus : n, 버스
autocade : n, 자동차행렬
autocamp : n, 자동차
autocatalysis : n, 자촉매 작용
autocatharsis : n, 자기 정화(법)(자기의 경험을 글로 적음으로써 마음의 불안을 고침)
autocephalous : a, 독립한, (교회 따위가)독립한
autochanger : n, (레코드를 자동적으로 바꾸는)자동연속연주장치(달린 플레이어)
autochrome : n, 컬러용건판
autochthon : n, 토착민의, 토착동물
autochthonism : n, 토착, 토지 원산
autochthonous : a, 토생의, 토착의
autocidal : a, (해충을)자멸 유도하는
autocide : n, (충돌을 일으켜서 하는)자동차 자살
autoclave : n, 압력가마
auto court : x, =motel
autocracy : n, 독재정치, 전제정치
autocrat : n, 독재자, 독재군주
autocratic : a, 독재자의
autocue : n, 텔레프롬프터
autocycle : n, 오토바이
autodafe : n, 종교재판소의판결, 그처형(보통 화형)
autodidact : n, 독학(독습자)
autodrome : n, 자동차 경주 트랙
autodyne : n, a, 오토다인 수신 방식(의)
autoerotic : a, 자기 발정(색정)적인
autoeroticism : n, =AUTOEROTISM
autoerotism : n, 자기색정, 자기발정
autogamous : a, 자기 생식의, 자화 수정의
autogamy : n, 자가 생식, 자화 수정
autogenesis : n, 자연(우연)발생(설)(abiogenesis)
autogenous : a, 자생의, 내생의, 내인적인
autogeny : n, 자생, 자기 발생(self-generation)
autogiro : n, 오토자이로
autograft : n, 자가이식편
autograph : n, a, 자필서명한, 자필원고, 자필의, 자필로 쓰다, 자서하다
autographic : a, 자필서명의
autography : n, 자서, 자필, (집합적)자필 문서, 육필 인쇄술(석판, 등사판 등)
autogravure : n, 오토그라비어(사진판 조각법의 일종)
autogyro : n, =AUTOGIRO
autohypnosis : n, 자기최면
autoignition : n, (내연 기관의)자기 점화, 자기 착화, 자연 발화
autoimmune : a, 자기(자가)면역의
autoinfection : n, 자기 감염
autoinjector : n, (신경가스 등에 대해 사용하는)자기(피하)주사기
autoinoculation : n, 자기접종
autointoxication : n, 자가중독
autoist : n, =MOTORIST
autokinesis : n, 자발 행동, 자동 운동
autokinetic : a, 자동 적인
autoland : n, 자동착륙
autoloading : a, (총기가)자동 장전식의
autologous : a, 자가 이식한, 자가 조직의
autolysin : n, (동식물 조직을 파괴하는)자기 분해제
autolysis : n, 자기 분해(소화)
autolyze : vt, vi, 자기 분해 시키다(하다)
automaker : n, 자동차 제조업자(회사)
automan : n, 자동차 제조업자
automanipulation : n, 자위
automat : n, 자동판매기, 자동판매식음식점
automata : n, automation의 복수
automate : vt, 오토메이션화하다, 자동화하다, 자동장치를 갖추다
automatic : a, n, 자동식의, 기계적인, 무의식적인, 습관적인, 자동 기계(장치, 권총)
automatical : a, 자동적인
automatically : ad, 자동식으로
automatic calling : x, 자동호출
automatic data processing : x, 자동 정보 처리
automatic drive : x, 자동 변속 장치
automatic interplanetary : x, 자동 혹성간 스테이션(우주 로켓에 대한 소련 호칭)
automaticity : n, 자동성
automatic operation : x, 자동조작
automatic pilot : x, 자동조종장치
automatic telephone : x, 자동전화
automatic train control : x, 열차자동제어장치
automatic train stop : x, 열차자동정지장치
automation : n, 오토메이션, 자동조작
automatism : n, 자동, 자동현상, 작용
automatization : n, 자동화, 오토메이션
automatize : vt, 자동화하다, 오토메이션화하다
automatograph : n, 자동 운동 기록기
automaton : n, 자동인형, 기계적으로행동하는사람
automobile : n, 자동차
automobilism : n, 자동차 사용(운전, 여행)
automobilist : n, 자동차 운전자, 자동차 소유자(상용자)
automotive : a, 자동차의, 자동적인
autonetics : n, 자동 유도 제어학, 자동 제어론
autonomic : a, 자치적인, 자율적인
autonomist : n, 자치론자, 자치주의자
autonomous : a, 자치적인, 독립된
autonomy : n, 자치, 자치권, 자치제
autonym : n, 본명, 실제이름, 본명으로낸저서
autopen : n, 자동 서명기
autophagy : n, 자기 소모, 자식 작용
autophone : n, 자동전화
autopilot : n, 자동조정장치
autopista : n, (스페인어권의)고속 도로
autoplasty : n, 자기조직이식술(피부의 이식 따위)
autopolo : n, 자동차 폴로 경기(자동차를 타고 있는)
autopsy : n, 검시
autopsychosis : n, 자의식 장애성 정신병
autoptic : a, 실지 검증의, 검시의, 시체 해부의
autoradiograph : n, 방사선사진
autoregulation : n, (장기, 생물, 생태계 등의)자기 조절
autoreverse : n, 오토리버스(테이프 녹음(재생)중, 한 면이 끝나면 자동 역전하여 녹음(재생)을 계속하는 기능)
autoroute : n, (프랑스, 벨기에의)고속도로
autosdage : n, AUTODATE의 복수
autosexing : a, 태어날(부화할)때 자웅 별로 각기 특징을 나타내는
autoshape : vi, (자극에 대하여)자기 반응을 형성하다
autosled : n, 자동 썰매
autosome : n, 상염색체(성염색체 이외의 염색체)
autostability : n, 자율 안정, 자동 조종(제어)안정
autostrada : n, (이탈리아의)고속 도로(experssway)
autosuggestion : n, 자기암시
autotelic : a, 자기 목적적인, 그 자체에 목적이 있는
autotimer : n, (전기 조리기 등의)자동 타이머
autotomize : vi, vt, (도마뱀 등이)자절하다
autotomy : n, (도마뱀 등의)자기 절단, 자절
autotoxic : n, 자가 중독(증)
autotoxin : n, 자가 독소
autotrain : n, 오토트레인(일정 구간을 승객과 자동차를 동시에 수송하는 열차)
autotransformer : n, 단권 변압기
autotransplant : n, vt, =AUTOGRAFT
autotronic : a, (엘리베이터가)자동전자장치의
autotroph : n, 독립(자가 무기)영양 생물
autotrophic : a, 자가(독립, 자급)영양의
autotruck : n, 화물자동차, 트럭
autotype : n, vt, 오토타이프(단색 사진판), 복사, 모사, 오토타이프 복사를 하다
autotypography : n, 단색 사진판법
autoworker : n, 자동차 제조 노동자
autoxidation : n, 자동 산화
autumn : n, 가을
autumnal : a, 가을의
autunite : n, 인회
auxiliary : a, 보조의, 추가의, 보조사, 외인 부대, 조동사
auxiliary verb : x, 조동사
auxin : n, 옥신(식물 성장 물질의 총칭)
auxo : n, 생장, 증대, 촉진, 자극
auxotroph : n, 영양 요구체(영양 합성이 불가한 균주)
auxotrophic : a, 영양 요구성의
avail : vt, vi, n, 도움이되다, 소용이되다, 이롭다, 이익, 효용, 
availability : n, 유효, 유익, 도움, 쓸모
available : a, 이용할 수 있는, 손에넣을수있는, 전심할수있는, 여가가있는, 유효한
avalanche : n, vi, 눈사태, 쇄도, 쇄도하다, 눈이나산 사태나다
avalanchine : a, 사태 같은
avalement : n, 아발망(활강, 회전에서 허리를 낮추어 속도를 올리는 방법)
avantcourier : n, 선구자, 전위, 선봉(advance guard)
avantgarde : n, (예술상의)전위, 아방가르드
avarice : n, 탐욕
avaricious : a, 탐욕스러운
avast : int, 그만, 멈춰
avatar : n, 화신, 권화
avaunt : int, 가라, 물러가라
ave : int, 어서 오세요!, 안녕!, 자 그럼!-=AVEMARIA
avenge : vt, vi, 원수를갑다, 복수하다, 대응하다
avenger : n, 복수자, 원수를 갑는 사람
avenging : a, 복수의, 복수의
avens : n, 뱀무속의 식물
aventurine : n, a, (구리 가루를 넣은)갈색의 유리, 사금석, 반짝반짝 빛나는
avenue : n, 가로수 길, 가로, 큰거리, (성공 따위에의)
aver : vt, 단언하다, 주장하다
average : n, a, vt, 평균의, 표준의, 보통의, 해손-평균하다, 평균 ...이 되다, (증권 따위를 매매하여)평균값을 내리다
averager : n, 해손 천산인
averment : n, 주장, 단언
Avernus : n, 에버너스, 이탈리아의 나폴리 부근의 호수(지옥의 입구로 불려졌음)
averse : a, 싫어하다, 반대하여
aversion : n, 혐오, 반감
aversive : a, 혐오의, (불쾌, 고통 등을)피하려고 하는, 회피적인
avert : vt, 돌리다, 피하다, 막다
avertible : a, 피할 수 있는, 말을 수 있는
Avery : n, 남자 이름
Aves : n, 조류
Avesta : n, 아베스타(조로아스터교의 경전)
Avestan : n, a, 아베스타 말, 아베스타 말(경전)의
avgas : n, =AVIATION GASOLINE
avian : a, 새의, 조류의
aviarist : n, 애조가, 새 기르는 사람
aviary : n, 새장, 양금사
aviate : vi, 비행하다, (특히)항공기를 조종하다
aviation : n, 비행술
aviation badge : x, 항공기장
aviation corps : x, 항공대
aviation ground : x, 비행장
aviation medicine : x, 항공의학
aviation spirit : x, 항공용경유
aviator : n, 비행사
aviator's ear : x, 고공비행성 중이염
aviatress : n, =AVIATRIX
aviatrix : n, 여류 비행가
aviculture : n, 조류사육
avid : a, 탐욕스러운, 갈망하는
avidity : n, 갈망, 탐욕
avifauna : n, (한 지방 또는 한 나라의)조류
aviform : a, 새 모양의
avigation : n, 항공(학), 항법
Avignon : n, 아비뇽(남프랑스의 도시, 교황청 소재지(1309-77)
avion : n, 비행기
avionics : n, pl, 항공 전자 공학
avionics : n, 항공전자공학
avirdupois : n, 상형(16온스를 1파운드로 정한 형량)
avirulent : a, (생물체가)독성이 없는, 악성이 아닌
aviso : n, 통보함
avitaminosis : n, 비타민 결핍증
avocado : n, 애보카도
avocation : n, 부업, 여기, 취미, 직업, 본직
avocatory : a, 호출하는, 소환하는
avocet : n, 됫부리장다리떼새
Avogadro : n, 아보가드로 Count Amedeo ~ (1776-1856)(이탈리아의 화학자, 물리학자)
avoid : vt, 피하다, 회피하다
avoidable : a, 피할 수 있는
avoidance : n, 도피, 회피, 무효
avoir : x, , avoirdupois
Avon : n, 영국중부의 강, 잉글랜드 남서부의 주(1974년 신설)
Avon : n, 에이번강(영국 중부의 강, Shakespeare의 출생지 Stratford는 이 강가에 있음), 에이번주(1974년 신설된 잉글랜드 중부의 주)
avoset : n, =AVOCET
avouch : vt, 공언하다, 단언하다, 확언하다, 보증하다, 인정하다, 자백하다
avow : vt, 공언하다, 시인하다
avowal : n, 공언, 자백, 시인
avowed : a, 스스로 인정한(언명한), 공공연한(open)
avowedly : ad, 공공연히, 명백히
avulse : vt, 무리하게 떼어놓다, (조직을)벗겨 내다
avulsion : n, 무리하게 떼어냄(벗겨냄), (홍수 등에 의한)토지의 전위(자연 분리), 떼어 낸 부분, 분열지
avuncular : a, 아저씨, 백부 또는 숙부
await : vt, 기다리다
awake : vt, vi, a, 깨우다, 일으키다, 자각시키다, 눈뜨다, 깨다, 깨닫다, 분기하다(to), 깨어서, 방심 않는, 잘 알아채서
awaken : vt, vi, =awake
awakening : a, n, 눈뜨게한는, 깨우치는, 눈뜸, 각성
award : vt, 수여하다, 심사하여주다, 재정하다
awardee : n, 수상자, 판정(장학금 등)을 받은 사람
aware : a, 깨닫고, 알아차리고
awareness : n, 알아채고(깨닫고)있음, 자각, 인식
awash : a, (암초, 침몰선 등이)수면과 거의 같은 높이로, 파도에 씻기어, 파도에 시달려, (장소가)...으로 가득하여
away : ad, 떨어져서, 부재하여, 점점 소멸하여, 없어져, 끊임없이
awe : n, 외경(stand in~of ...을 외경(두려워)하다
Aweapon : n, 원자병기
aweary : a, =WEARY
aweather : ad, 바람 불어오는 쪽에
awed : a, 경외심을 나타낸(가지고 있는)
aweigh : ad, a, 닻이 해저에서 떨어져
aweinspiring : a, 엄숙한, 두려운마음이일게하는, 옷깃을 바로 잡게 하는, 엄숙한
awesome : a, 두려운, 무서운
awestricken : a, 두려운감이들어, 두려워하여
awestruck : a, 위엄에 눌린, 두려운 생각이 든, 위압당한
awful : a, 두려운, 장엄한, 대단한, 무서운, 굉장한
awfully : ad, 무섭게
awfulness : n, 두려운 일, 장엄, 지독함, 굉장함
AWG : x, American Wire Gauge
awheel : ad, a, 자동차(자전거)를 타고
awhile : ad, 잠시
awhirl : ad, a, 소용돌이쳐서, 빙빙돌고
awkward : a, 보기흉한, 섣부른, 서투른, 약 빠르지 못한, ...하기 어려운(to do), 어색한, 사용하기 거북한
awkwardly : ad, 
awkwardness : n, 
awl : n, (구둣방 따위의)송곳
awless : a, =AWELESS
awn : n, 꺼끄러기, 보리따위의 꺼끄러기
awned : a, 까끄라기가 있는
awning : n, 차일, 비막이, 천막
awoke : v, 깨우다의 과거분사
awry : pred, a, ad, 뒤틀린, 뒤틀리어, 일러진, 잘못되어(go(run)~ 시패하다, look~ 스처(곁눈질로)보다
ax : n, 도끼, 삭감, 면직(have an~ to grind 속 배포가 있다, 생각하는 바가 있다, put the~in the helve 수수께끼를 풀다
axal : a, =AXIAL
axe : n, =AX
axedarach : n, 단향목(chinaberry tree)
axegrinding : a, 딴마음이 있는
axel : (스케이트에서)액슬, 점프하여 공중에서 1회전 반 함
axeman : n, =AXMAN
axenic : a, 무균의, 무기생물의
axgrinder : n, 음모가, 속배포가 있는 사람
axhammer : n, (돌 등을 깨거나 다듬는 데 쓰는)도끼처럼 생긴 메
axial : a, 굴대의, 축의
axil : n, 엽액
axile : a, 굴대의, 축의, 굴대에 있는
axilla : n, 겨드랑이
axillar : n, 겨드랑이 부분(혈관, 신경, 깃 등)
axillary : a, 
axillary : a, 엽액의, 겨드랑이의
axinite : n, 부석
axiology : n, 가치론, 가치철학
axiom : n, 공리, 자명한이치
axiomatic : n, 굴대, 축, 추축
axis : n, 굴대, 축, 추축
axisymmetric : a, 선대칭의
axle : n, 축, 굴대, 차축
axletree : n, (마차 등의)굴대, 차축
axlplasm : n, 축삭 원형질
axman : n, 도끼질하는 사람, 나무꾼(woodman)
Axminster : n, (영국산의)부드러운 털융단
axolotl : n, 액솔로틀(멕시코산 도롱뇽의 유생)
axolotl : n, 아홀로틀, 멕시코산 도룡뇽의 총칭
axon : n, (신경 세포의)축삭
axonometry : n, 축측 투상법
axstone : n, 도끼돌남미에서 돌도끼를 만드는 재료)
ayah : n, 하녀, 유모
ayatollah : n, 아야톨라, 이란의 이슬람 최고 지도자의 호칭
aye : int, n, =yes-찬성, 찬성자
aye : ad, 언제나, 늘, 영구히, 영원히
aye : int, 찬성, 찬성자
ayeaye : n, 다람쥐원숭이
Aylesbury : n, 에일즈베리(잉글랜드 Buckinghamshire 주의 주도)
Aylmer : n, 남자 이름
Aymara : n, 아이마라족(볼리비아와 페루의 인디오)
Ayr : n, =AYRSHIRE, 에어(aYSHIRE의 주도로 항구 도시)
Ayrshire : n, 에어셔주(스코틀랜드 남서부의 옛주), 그 주 원산의 젖소
aza : a, 탄소 대신에 질소를 함유하는
azalea : n, 진달래
azan : n, (회교국의 교당에서 하루에 5번 울리는)기도의종
Azania : n, 아자니아(민족주의자의 용어로서 남아프리카 공화국의 호친)
azarole : n, 아자롤(지중해 지방에 나는 산사나무류의 관목), 그 열매
azeotrope : n, 공비 혼합물
Azerbaijan : n, 독립국 연합의 공화국의 하나(카스피해 연안에 있음)
azide : n, 아지드, 아지화물(폭발하기 쉬운 화합물)
Azilian : a, 아질 문화(기)의(서유럽 중석기 시대의)
Azilian : a, 아질기, 구석기시대와 신석기시대의 중간
azimuth : n, 방위, 방위각
azimuthal : a, 방위각의
azioc : a, 무생의, 무생물시대의
azo : a, (화합물이)질소를 함유하는, 아조의
azo : n, 질소(nitrogen)
azobenzene : n, 아조벤젠
azoic : a, 무생의, 무생물 시대의
azonic : a, 특정 지대에 한정되지 않는, 지역적이 아닌
Azores : x, 북대서양의 군도(포르투갈령)
azote : n, 질소(nitrogen)n, 
azoth : n, (연금술에서 모든 금속의 원소로 생각되었던)수은, 만능약
azotic : a, 질소의
azotize : vt, ...을 질소와 화합시키다
Azov : n, 아즈라엘(죽음에 순간에 영혼을 육체에서 분리시키는 천사)
Aztec : n, 아즈텍인(1519년 스페인에 정복되 멕시코 토인)
Aztecan : a, 멕시코 원주민, =AZTEC
azure : n, 푸른하늘, 하늘빛
azurine : a, 청색의(blue), 엷은 청색의(pale blue)
azurite : n, 남동광
azygous : a, 쌍(짝)을 이루지 않는
azyme : n, 무교병(유대교가 유월절에 씀)
